Date,Room Number,Bed Number,Total Beds,Available Beds,Busy Bees
2006-01-01,1,Bed Number 1,54,38,16
2006-01-01,2,Bed Number 2,65,34,31
2006-01-01,3,Bed Number 3,63,39,24
2006-01-02,1,Bed Number 1,77,75,2
2006-01-02,2,Bed Number 2,38,22,16
2006-01-02,3,Bed Number 3,29,28,1
2006-01-03,1,Bed Number 1,49,44,5
2006-01-03,2,Bed Number 2,97,27,70
2006-01-03,3,Bed Number 3,56,15,41
2006-01-04,1,Bed Number 1,34,11,23
2006-01-04,2,Bed Number 2,65,0,65
2006-01-04,3,Bed Number 3,30,22,8
2006-01-05,1,Bed Number 1,45,5,40
2006-01-05,2,Bed Number 2,11,7,4
2006-01-05,3,Bed Number 3,77,29,48
2006-01-06,1,Bed Number 1,72,15,57
2006-01-06,2,Bed Number 2,49,28,21
2006-01-06,3,Bed Number 3,94,36,58
2006-01-07,1,Bed Number 1,50,12,38
2006-01-07,2,Bed Number 2,74,57,17
2006-01-07,3,Bed Number 3,74,36,38
2006-01-08,1,Bed Number 1,86,32,54
2006-01-08,2,Bed Number 2,27,16,11
2006-01-08,3,Bed Number 3,36,8,28
2006-01-09,1,Bed Number 1,70,49,21
2006-01-09,2,Bed Number 2,77,47,30
2006-01-09,3,Bed Number 3,26,26,0
2006-01-10,1,Bed Number 1,66,58,8
2006-01-10,2,Bed Number 2,97,0,97
2006-01-10,3,Bed Number 3,34,11,23
2006-01-11,1,Bed Number 1,77,17,60
2006-01-11,2,Bed Number 2,54,46,8
2006-01-11,3,Bed Number 3,99,68,31
2006-01-12,1,Bed Number 1,33,7,26
2006-01-12,2,Bed Number 2,41,18,23
2006-01-12,3,Bed Number 3,58,41,17
2006-01-13,1,Bed Number 1,56,14,42
2006-01-13,2,Bed Number 2,83,24,59
2006-01-13,3,Bed Number 3,91,14,77
2006-01-14,1,Bed Number 1,31,31,0
2006-01-14,2,Bed Number 2,43,16,27
2006-01-14,3,Bed Number 3,94,59,35
2006-01-15,1,Bed Number 1,28,27,1
2006-01-15,2,Bed Number 2,75,53,22
2006-01-15,3,Bed Number 3,85,47,38
2006-01-16,1,Bed Number 1,86,9,77
2006-01-16,2,Bed Number 2,39,21,18
2006-01-16,3,Bed Number 3,18,9,9
2006-01-17,1,Bed Number 1,96,49,47
2006-01-17,2,Bed Number 2,48,35,13
2006-01-17,3,Bed Number 3,26,13,13
2006-01-18,1,Bed Number 1,20,15,5
2006-01-18,2,Bed Number 2,39,23,16
2006-01-18,3,Bed Number 3,51,1,50
2006-01-19,1,Bed Number 1,85,65,20
2006-01-19,2,Bed Number 2,71,18,53
2006-01-19,3,Bed Number 3,84,51,33
2006-01-20,1,Bed Number 1,15,0,15
2006-01-20,2,Bed Number 2,39,7,32
2006-01-20,3,Bed Number 3,95,53,42
2006-01-21,1,Bed Number 1,66,14,52
2006-01-21,2,Bed Number 2,56,52,4
2006-01-21,3,Bed Number 3,72,58,14
2006-01-22,1,Bed Number 1,32,0,32
2006-01-22,2,Bed Number 2,64,10,54
2006-01-22,3,Bed Number 3,28,24,4
2006-01-23,1,Bed Number 1,71,43,28
2006-01-23,2,Bed Number 2,20,4,16
2006-01-23,3,Bed Number 3,80,42,38
2006-01-24,1,Bed Number 1,82,53,29
2006-01-24,2,Bed Number 2,22,11,11
2006-01-24,3,Bed Number 3,48,12,36
2006-01-25,1,Bed Number 1,32,3,29
2006-01-25,2,Bed Number 2,12,3,9
2006-01-25,3,Bed Number 3,93,44,49
2006-01-26,1,Bed Number 1,87,67,20
2006-01-26,2,Bed Number 2,81,53,28
2006-01-26,3,Bed Number 3,56,10,46
2006-01-27,1,Bed Number 1,33,9,24
2006-01-27,2,Bed Number 2,58,33,25
2006-01-27,3,Bed Number 3,29,19,10
2006-01-28,1,Bed Number 1,26,1,25
2006-01-28,2,Bed Number 2,96,6,90
2006-01-28,3,Bed Number 3,32,2,30
2006-01-29,1,Bed Number 1,95,52,43
2006-01-29,2,Bed Number 2,80,67,13
2006-01-29,3,Bed Number 3,45,7,38
2006-01-30,1,Bed Number 1,86,2,84
2006-01-30,2,Bed Number 2,56,39,17
2006-01-30,3,Bed Number 3,86,27,59
2006-01-31,1,Bed Number 1,40,37,3
2006-01-31,2,Bed Number 2,91,24,67
2006-01-31,3,Bed Number 3,47,18,29
2006-02-01,1,Bed Number 1,54,18,36
2006-02-01,2,Bed Number 2,14,5,9
2006-02-01,3,Bed Number 3,87,54,33
2006-02-02,1,Bed Number 1,84,4,80
2006-02-02,2,Bed Number 2,34,27,7
2006-02-02,3,Bed Number 3,52,31,21
2006-02-03,1,Bed Number 1,42,35,7
2006-02-03,2,Bed Number 2,18,4,14
2006-02-03,3,Bed Number 3,29,16,13
2006-02-04,1,Bed Number 1,15,9,6
2006-02-04,2,Bed Number 2,93,78,15
2006-02-04,3,Bed Number 3,47,42,5
2006-02-05,1,Bed Number 1,23,5,18
2006-02-05,2,Bed Number 2,14,5,9
2006-02-05,3,Bed Number 3,75,6,69
2006-02-06,1,Bed Number 1,51,32,19
2006-02-06,2,Bed Number 2,65,32,33
2006-02-06,3,Bed Number 3,73,62,11
2006-02-07,1,Bed Number 1,92,73,19
2006-02-07,2,Bed Number 2,63,39,24
2006-02-07,3,Bed Number 3,47,12,35
2006-02-08,1,Bed Number 1,53,29,24
2006-02-08,2,Bed Number 2,24,13,11
2006-02-08,3,Bed Number 3,33,2,31
2006-02-09,1,Bed Number 1,48,39,9
2006-02-09,2,Bed Number 2,43,20,23
2006-02-09,3,Bed Number 3,29,26,3
2006-02-10,1,Bed Number 1,46,4,42
2006-02-10,2,Bed Number 2,80,19,61
2006-02-10,3,Bed Number 3,79,55,24
2006-02-11,1,Bed Number 1,41,9,32
2006-02-11,2,Bed Number 2,61,40,21
2006-02-11,3,Bed Number 3,58,3,55
2006-02-12,1,Bed Number 1,29,24,5
2006-02-12,2,Bed Number 2,65,18,47
2006-02-12,3,Bed Number 3,34,15,19
2006-02-13,1,Bed Number 1,24,5,19
2006-02-13,2,Bed Number 2,85,79,6
2006-02-13,3,Bed Number 3,57,44,13
2006-02-14,1,Bed Number 1,43,39,4
2006-02-14,2,Bed Number 2,19,3,16
2006-02-14,3,Bed Number 3,66,3,63
2006-02-15,1,Bed Number 1,71,68,3
2006-02-15,2,Bed Number 2,16,4,12
2006-02-15,3,Bed Number 3,67,51,16
2006-02-16,1,Bed Number 1,28,1,27
2006-02-16,2,Bed Number 2,11,7,4
2006-02-16,3,Bed Number 3,29,15,14
2006-02-17,1,Bed Number 1,26,14,12
2006-02-17,2,Bed Number 2,72,2,70
2006-02-17,3,Bed Number 3,59,30,29
2006-02-18,1,Bed Number 1,59,26,33
2006-02-18,2,Bed Number 2,89,77,12
2006-02-18,3,Bed Number 3,43,5,38
2006-02-19,1,Bed Number 1,70,49,21
2006-02-19,2,Bed Number 2,25,19,6
2006-02-19,3,Bed Number 3,67,46,21
2006-02-20,1,Bed Number 1,47,33,14
2006-02-20,2,Bed Number 2,99,59,40
2006-02-20,3,Bed Number 3,31,25,6
2006-02-21,1,Bed Number 1,10,6,4
2006-02-21,2,Bed Number 2,48,36,12
2006-02-21,3,Bed Number 3,79,51,28
2006-02-22,1,Bed Number 1,69,16,53
2006-02-22,2,Bed Number 2,73,42,31
2006-02-22,3,Bed Number 3,66,22,44
2006-02-23,1,Bed Number 1,61,8,53
2006-02-23,2,Bed Number 2,54,32,22
2006-02-23,3,Bed Number 3,64,56,8
2006-02-24,1,Bed Number 1,31,27,4
2006-02-24,2,Bed Number 2,20,1,19
2006-02-24,3,Bed Number 3,75,22,53
2006-02-25,1,Bed Number 1,50,20,30
2006-02-25,2,Bed Number 2,94,32,62
2006-02-25,3,Bed Number 3,74,19,55
2006-02-26,1,Bed Number 1,59,56,3
2006-02-26,2,Bed Number 2,77,35,42
2006-02-26,3,Bed Number 3,99,65,34
2006-02-27,1,Bed Number 1,55,16,39
2006-02-27,2,Bed Number 2,58,36,22
2006-02-27,3,Bed Number 3,18,16,2
2006-02-28,1,Bed Number 1,24,15,9
2006-02-28,2,Bed Number 2,26,8,18
2006-02-28,3,Bed Number 3,66,24,42
2006-03-01,1,Bed Number 1,22,22,0
2006-03-01,2,Bed Number 2,37,26,11
2006-03-01,3,Bed Number 3,16,12,4
2006-03-02,1,Bed Number 1,33,19,14
2006-03-02,2,Bed Number 2,40,19,21
2006-03-02,3,Bed Number 3,63,9,54
2006-03-03,1,Bed Number 1,54,1,53
2006-03-03,2,Bed Number 2,61,27,34
2006-03-03,3,Bed Number 3,54,41,13
2006-03-04,1,Bed Number 1,39,1,38
2006-03-04,2,Bed Number 2,38,1,37
2006-03-04,3,Bed Number 3,45,35,10
2006-03-05,1,Bed Number 1,67,54,13
2006-03-05,2,Bed Number 2,40,28,12
2006-03-05,3,Bed Number 3,41,33,8
2006-03-06,1,Bed Number 1,69,9,60
2006-03-06,2,Bed Number 2,80,63,17
2006-03-06,3,Bed Number 3,11,2,9
2006-03-07,1,Bed Number 1,14,6,8
2006-03-07,2,Bed Number 2,11,7,4
2006-03-07,3,Bed Number 3,20,7,13
2006-03-08,1,Bed Number 1,96,4,92
2006-03-08,2,Bed Number 2,35,15,20
2006-03-08,3,Bed Number 3,62,8,54
2006-03-09,1,Bed Number 1,97,11,86
2006-03-09,2,Bed Number 2,71,36,35
2006-03-09,3,Bed Number 3,55,46,9
2006-03-10,1,Bed Number 1,91,35,56
2006-03-10,2,Bed Number 2,12,8,4
2006-03-10,3,Bed Number 3,75,33,42
2006-03-11,1,Bed Number 1,10,8,2
2006-03-11,2,Bed Number 2,18,5,13
2006-03-11,3,Bed Number 3,39,30,9
2006-03-12,1,Bed Number 1,17,9,8
2006-03-12,2,Bed Number 2,46,4,42
2006-03-12,3,Bed Number 3,46,38,8
2006-03-13,1,Bed Number 1,47,11,36
2006-03-13,2,Bed Number 2,98,91,7
2006-03-13,3,Bed Number 3,53,49,4
2006-03-14,1,Bed Number 1,52,42,10
2006-03-14,2,Bed Number 2,89,23,66
2006-03-14,3,Bed Number 3,76,59,17
2006-03-15,1,Bed Number 1,11,2,9
2006-03-15,2,Bed Number 2,39,9,30
2006-03-15,3,Bed Number 3,50,26,24
2006-03-16,1,Bed Number 1,50,33,17
2006-03-16,2,Bed Number 2,18,18,0
2006-03-16,3,Bed Number 3,92,54,38
2006-03-17,1,Bed Number 1,92,56,36
2006-03-17,2,Bed Number 2,96,81,15
2006-03-17,3,Bed Number 3,25,16,9
2006-03-18,1,Bed Number 1,31,21,10
2006-03-18,2,Bed Number 2,26,18,8
2006-03-18,3,Bed Number 3,13,7,6
2006-03-19,1,Bed Number 1,46,38,8
2006-03-19,2,Bed Number 2,71,70,1
2006-03-19,3,Bed Number 3,44,23,21
2006-03-20,1,Bed Number 1,16,13,3
2006-03-20,2,Bed Number 2,39,19,20
2006-03-20,3,Bed Number 3,76,49,27
2006-03-21,1,Bed Number 1,60,22,38
2006-03-21,2,Bed Number 2,30,0,30
2006-03-21,3,Bed Number 3,91,51,40
2006-03-22,1,Bed Number 1,10,2,8
2006-03-22,2,Bed Number 2,57,40,17
2006-03-22,3,Bed Number 3,27,17,10
2006-03-23,1,Bed Number 1,62,22,40
2006-03-23,2,Bed Number 2,33,30,3
2006-03-23,3,Bed Number 3,68,22,46
2006-03-24,1,Bed Number 1,43,22,21
2006-03-24,2,Bed Number 2,37,22,15
2006-03-24,3,Bed Number 3,45,9,36
2006-03-25,1,Bed Number 1,24,8,16
2006-03-25,2,Bed Number 2,71,65,6
2006-03-25,3,Bed Number 3,10,3,7
2006-03-26,1,Bed Number 1,64,44,20
2006-03-26,2,Bed Number 2,53,5,48
2006-03-26,3,Bed Number 3,95,18,77
2006-03-27,1,Bed Number 1,74,21,53
2006-03-27,2,Bed Number 2,25,11,14
2006-03-27,3,Bed Number 3,25,14,11
2006-03-28,1,Bed Number 1,72,25,47
2006-03-28,2,Bed Number 2,25,25,0
2006-03-28,3,Bed Number 3,89,19,70
2006-03-29,1,Bed Number 1,15,3,12
2006-03-29,2,Bed Number 2,70,24,46
2006-03-29,3,Bed Number 3,30,12,18
2006-03-30,1,Bed Number 1,10,3,7
2006-03-30,2,Bed Number 2,39,0,39
2006-03-30,3,Bed Number 3,26,3,23
2006-03-31,1,Bed Number 1,77,12,65
2006-03-31,2,Bed Number 2,45,26,19
2006-03-31,3,Bed Number 3,16,0,16
2006-04-01,1,Bed Number 1,78,24,54
2006-04-01,2,Bed Number 2,66,1,65
2006-04-01,3,Bed Number 3,30,25,5
2006-04-02,1,Bed Number 1,96,65,31
2006-04-02,2,Bed Number 2,99,49,50
2006-04-02,3,Bed Number 3,47,29,18
2006-04-03,1,Bed Number 1,32,27,5
2006-04-03,2,Bed Number 2,62,33,29
2006-04-03,3,Bed Number 3,57,29,28
2006-04-04,1,Bed Number 1,52,43,9
2006-04-04,2,Bed Number 2,88,52,36
2006-04-04,3,Bed Number 3,42,30,12
2006-04-05,1,Bed Number 1,52,23,29
2006-04-05,2,Bed Number 2,30,13,17
2006-04-05,3,Bed Number 3,34,2,32
2006-04-06,1,Bed Number 1,72,47,25
2006-04-06,2,Bed Number 2,13,6,7
2006-04-06,3,Bed Number 3,19,1,18
2006-04-07,1,Bed Number 1,37,20,17
2006-04-07,2,Bed Number 2,12,4,8
2006-04-07,3,Bed Number 3,30,6,24
2006-04-08,1,Bed Number 1,30,25,5
2006-04-08,2,Bed Number 2,48,5,43
2006-04-08,3,Bed Number 3,86,65,21
2006-04-09,1,Bed Number 1,38,35,3
2006-04-09,2,Bed Number 2,35,35,0
2006-04-09,3,Bed Number 3,50,24,26
2006-04-10,1,Bed Number 1,25,0,25
2006-04-10,2,Bed Number 2,17,10,7
2006-04-10,3,Bed Number 3,17,16,1
2006-04-11,1,Bed Number 1,43,18,25
2006-04-11,2,Bed Number 2,24,12,12
2006-04-11,3,Bed Number 3,54,2,52
2006-04-12,1,Bed Number 1,52,23,29
2006-04-12,2,Bed Number 2,74,31,43
2006-04-12,3,Bed Number 3,49,35,14
2006-04-13,1,Bed Number 1,84,78,6
2006-04-13,2,Bed Number 2,37,36,1
2006-04-13,3,Bed Number 3,14,2,12
2006-04-14,1,Bed Number 1,18,4,14
2006-04-14,2,Bed Number 2,14,13,1
2006-04-14,3,Bed Number 3,28,10,18
2006-04-15,1,Bed Number 1,10,9,1
2006-04-15,2,Bed Number 2,50,27,23
2006-04-15,3,Bed Number 3,53,25,28
2006-04-16,1,Bed Number 1,40,23,17
2006-04-16,2,Bed Number 2,49,27,22
2006-04-16,3,Bed Number 3,37,37,0
2006-04-17,1,Bed Number 1,52,19,33
2006-04-17,2,Bed Number 2,87,84,3
2006-04-17,3,Bed Number 3,31,26,5
2006-04-18,1,Bed Number 1,43,7,36
2006-04-18,2,Bed Number 2,26,5,21
2006-04-18,3,Bed Number 3,72,47,25
2006-04-19,1,Bed Number 1,61,24,37
2006-04-19,2,Bed Number 2,77,2,75
2006-04-19,3,Bed Number 3,79,18,61
2006-04-20,1,Bed Number 1,53,33,20
2006-04-20,2,Bed Number 2,67,6,61
2006-04-20,3,Bed Number 3,89,12,77
2006-04-21,1,Bed Number 1,90,77,13
2006-04-21,2,Bed Number 2,85,84,1
2006-04-21,3,Bed Number 3,24,6,18
2006-04-22,1,Bed Number 1,88,59,29
2006-04-22,2,Bed Number 2,82,1,81
2006-04-22,3,Bed Number 3,64,12,52
2006-04-23,1,Bed Number 1,29,27,2
2006-04-23,2,Bed Number 2,12,2,10
2006-04-23,3,Bed Number 3,80,57,23
2006-04-24,1,Bed Number 1,57,9,48
2006-04-24,2,Bed Number 2,86,40,46
2006-04-24,3,Bed Number 3,48,32,16
2006-04-25,1,Bed Number 1,95,76,19
2006-04-25,2,Bed Number 2,78,67,11
2006-04-25,3,Bed Number 3,37,11,26
2006-04-26,1,Bed Number 1,95,14,81
2006-04-26,2,Bed Number 2,52,36,16
2006-04-26,3,Bed Number 3,81,56,25
2006-04-27,1,Bed Number 1,57,3,54
2006-04-27,2,Bed Number 2,87,53,34
2006-04-27,3,Bed Number 3,40,38,2
2006-04-28,1,Bed Number 1,56,25,31
2006-04-28,2,Bed Number 2,44,27,17
2006-04-28,3,Bed Number 3,67,54,13
2006-04-29,1,Bed Number 1,36,36,0
2006-04-29,2,Bed Number 2,47,9,38
2006-04-29,3,Bed Number 3,83,79,4
2006-04-30,1,Bed Number 1,35,22,13
2006-04-30,2,Bed Number 2,17,7,10
2006-04-30,3,Bed Number 3,36,31,5
2006-05-01,1,Bed Number 1,10,1,9
2006-05-01,2,Bed Number 2,42,35,7
2006-05-01,3,Bed Number 3,89,75,14
2006-05-02,1,Bed Number 1,85,54,31
2006-05-02,2,Bed Number 2,78,60,18
2006-05-02,3,Bed Number 3,97,70,27
2006-05-03,1,Bed Number 1,90,2,88
2006-05-03,2,Bed Number 2,76,68,8
2006-05-03,3,Bed Number 3,90,83,7
2006-05-04,1,Bed Number 1,65,10,55
2006-05-04,2,Bed Number 2,33,5,28
2006-05-04,3,Bed Number 3,52,41,11
2006-05-05,1,Bed Number 1,45,17,28
2006-05-05,2,Bed Number 2,15,1,14
2006-05-05,3,Bed Number 3,22,16,6
2006-05-06,1,Bed Number 1,33,11,22
2006-05-06,2,Bed Number 2,46,20,26
2006-05-06,3,Bed Number 3,41,23,18
2006-05-07,1,Bed Number 1,82,29,53
2006-05-07,2,Bed Number 2,81,64,17
2006-05-07,3,Bed Number 3,44,35,9
2006-05-08,1,Bed Number 1,54,41,13
2006-05-08,2,Bed Number 2,28,10,18
2006-05-08,3,Bed Number 3,37,37,0
2006-05-09,1,Bed Number 1,36,30,6
2006-05-09,2,Bed Number 2,80,53,27
2006-05-09,3,Bed Number 3,48,44,4
2006-05-10,1,Bed Number 1,15,12,3
2006-05-10,2,Bed Number 2,24,17,7
2006-05-10,3,Bed Number 3,34,32,2
2006-05-11,1,Bed Number 1,37,23,14
2006-05-11,2,Bed Number 2,44,0,44
2006-05-11,3,Bed Number 3,48,33,15
2006-05-12,1,Bed Number 1,36,7,29
2006-05-12,2,Bed Number 2,61,16,45
2006-05-12,3,Bed Number 3,18,13,5
2006-05-13,1,Bed Number 1,44,30,14
2006-05-13,2,Bed Number 2,58,22,36
2006-05-13,3,Bed Number 3,61,21,40
2006-05-14,1,Bed Number 1,39,11,28
2006-05-14,2,Bed Number 2,82,38,44
2006-05-14,3,Bed Number 3,90,46,44
2006-05-15,1,Bed Number 1,60,49,11
2006-05-15,2,Bed Number 2,30,11,19
2006-05-15,3,Bed Number 3,57,54,3
2006-05-16,1,Bed Number 1,96,87,9
2006-05-16,2,Bed Number 2,23,8,15
2006-05-16,3,Bed Number 3,12,0,12
2006-05-17,1,Bed Number 1,13,11,2
2006-05-17,2,Bed Number 2,71,35,36
2006-05-17,3,Bed Number 3,67,46,21
2006-05-18,1,Bed Number 1,65,42,23
2006-05-18,2,Bed Number 2,36,3,33
2006-05-18,3,Bed Number 3,99,40,59
2006-05-19,1,Bed Number 1,52,19,33
2006-05-19,2,Bed Number 2,73,52,21
2006-05-19,3,Bed Number 3,71,48,23
2006-05-20,1,Bed Number 1,39,13,26
2006-05-20,2,Bed Number 2,47,3,44
2006-05-20,3,Bed Number 3,78,12,66
2006-05-21,1,Bed Number 1,89,51,38
2006-05-21,2,Bed Number 2,45,10,35
2006-05-21,3,Bed Number 3,85,14,71
2006-05-22,1,Bed Number 1,85,40,45
2006-05-22,2,Bed Number 2,66,15,51
2006-05-22,3,Bed Number 3,41,3,38
2006-05-23,1,Bed Number 1,43,37,6
2006-05-23,2,Bed Number 2,12,9,3
2006-05-23,3,Bed Number 3,51,48,3
2006-05-24,1,Bed Number 1,26,5,21
2006-05-24,2,Bed Number 2,15,2,13
2006-05-24,3,Bed Number 3,19,8,11
2006-05-25,1,Bed Number 1,62,42,20
2006-05-25,2,Bed Number 2,40,28,12
2006-05-25,3,Bed Number 3,19,3,16
2006-05-26,1,Bed Number 1,89,13,76
2006-05-26,2,Bed Number 2,10,0,10
2006-05-26,3,Bed Number 3,30,7,23
2006-05-27,1,Bed Number 1,23,8,15
2006-05-27,2,Bed Number 2,28,16,12
2006-05-27,3,Bed Number 3,47,37,10
2006-05-28,1,Bed Number 1,21,11,10
2006-05-28,2,Bed Number 2,22,10,12
2006-05-28,3,Bed Number 3,41,0,41
2006-05-29,1,Bed Number 1,39,30,9
2006-05-29,2,Bed Number 2,11,3,8
2006-05-29,3,Bed Number 3,99,42,57
2006-05-30,1,Bed Number 1,55,11,44
2006-05-30,2,Bed Number 2,60,36,24
2006-05-30,3,Bed Number 3,94,10,84
2006-05-31,1,Bed Number 1,67,34,33
2006-05-31,2,Bed Number 2,26,14,12
2006-05-31,3,Bed Number 3,71,62,9
2006-06-01,1,Bed Number 1,42,42,0
2006-06-01,2,Bed Number 2,34,34,0
2006-06-01,3,Bed Number 3,57,27,30
2006-06-02,1,Bed Number 1,73,10,63
2006-06-02,2,Bed Number 2,74,14,60
2006-06-02,3,Bed Number 3,39,38,1
2006-06-03,1,Bed Number 1,35,16,19
2006-06-03,2,Bed Number 2,34,25,9
2006-06-03,3,Bed Number 3,96,3,93
2006-06-04,1,Bed Number 1,23,6,17
2006-06-04,2,Bed Number 2,50,23,27
2006-06-04,3,Bed Number 3,48,33,15
2006-06-05,1,Bed Number 1,90,84,6
2006-06-05,2,Bed Number 2,38,17,21
2006-06-05,3,Bed Number 3,60,51,9
2006-06-06,1,Bed Number 1,93,34,59
2006-06-06,2,Bed Number 2,35,0,35
2006-06-06,3,Bed Number 3,71,20,51
2006-06-07,1,Bed Number 1,21,13,8
2006-06-07,2,Bed Number 2,81,68,13
2006-06-07,3,Bed Number 3,82,59,23
2006-06-08,1,Bed Number 1,59,58,1
2006-06-08,2,Bed Number 2,53,0,53
2006-06-08,3,Bed Number 3,95,89,6
2006-06-09,1,Bed Number 1,42,17,25
2006-06-09,2,Bed Number 2,65,21,44
2006-06-09,3,Bed Number 3,71,69,2
2006-06-10,1,Bed Number 1,96,13,83
2006-06-10,2,Bed Number 2,39,30,9
2006-06-10,3,Bed Number 3,52,10,42
2006-06-11,1,Bed Number 1,32,30,2
2006-06-11,2,Bed Number 2,24,22,2
2006-06-11,3,Bed Number 3,18,16,2
2006-06-12,1,Bed Number 1,80,6,74
2006-06-12,2,Bed Number 2,67,18,49
2006-06-12,3,Bed Number 3,26,15,11
2006-06-13,1,Bed Number 1,71,71,0
2006-06-13,2,Bed Number 2,71,51,20
2006-06-13,3,Bed Number 3,67,65,2
2006-06-14,1,Bed Number 1,89,71,18
2006-06-14,2,Bed Number 2,26,8,18
2006-06-14,3,Bed Number 3,13,13,0
2006-06-15,1,Bed Number 1,80,72,8
2006-06-15,2,Bed Number 2,73,20,53
2006-06-15,3,Bed Number 3,48,35,13
2006-06-16,1,Bed Number 1,46,17,29
2006-06-16,2,Bed Number 2,69,42,27
2006-06-16,3,Bed Number 3,25,25,0
2006-06-17,1,Bed Number 1,22,2,20
2006-06-17,2,Bed Number 2,71,7,64
2006-06-17,3,Bed Number 3,96,58,38
2006-06-18,1,Bed Number 1,40,19,21
2006-06-18,2,Bed Number 2,31,9,22
2006-06-18,3,Bed Number 3,87,80,7
2006-06-19,1,Bed Number 1,32,7,25
2006-06-19,2,Bed Number 2,22,3,19
2006-06-19,3,Bed Number 3,39,3,36
2006-06-20,1,Bed Number 1,29,15,14
2006-06-20,2,Bed Number 2,10,6,4
2006-06-20,3,Bed Number 3,68,19,49
2006-06-21,1,Bed Number 1,18,6,12
2006-06-21,2,Bed Number 2,80,50,30
2006-06-21,3,Bed Number 3,61,24,37
2006-06-22,1,Bed Number 1,92,28,64
2006-06-22,2,Bed Number 2,55,6,49
2006-06-22,3,Bed Number 3,95,76,19
2006-06-23,1,Bed Number 1,93,56,37
2006-06-23,2,Bed Number 2,92,68,24
2006-06-23,3,Bed Number 3,19,1,18
2006-06-24,1,Bed Number 1,62,62,0
2006-06-24,2,Bed Number 2,79,65,14
2006-06-24,3,Bed Number 3,93,65,28
2006-06-25,1,Bed Number 1,93,66,27
2006-06-25,2,Bed Number 2,71,70,1
2006-06-25,3,Bed Number 3,70,20,50
2006-06-26,1,Bed Number 1,12,1,11
2006-06-26,2,Bed Number 2,47,8,39
2006-06-26,3,Bed Number 3,74,63,11
2006-06-27,1,Bed Number 1,94,2,92
2006-06-27,2,Bed Number 2,63,31,32
2006-06-27,3,Bed Number 3,94,11,83
2006-06-28,1,Bed Number 1,89,51,38
2006-06-28,2,Bed Number 2,51,3,48
2006-06-28,3,Bed Number 3,19,2,17
2006-06-29,1,Bed Number 1,86,42,44
2006-06-29,2,Bed Number 2,12,9,3
2006-06-29,3,Bed Number 3,11,9,2
2006-06-30,1,Bed Number 1,84,57,27
2006-06-30,2,Bed Number 2,100,59,41
2006-06-30,3,Bed Number 3,85,41,44
2006-07-01,1,Bed Number 1,54,26,28
2006-07-01,2,Bed Number 2,38,25,13
2006-07-01,3,Bed Number 3,92,56,36
2006-07-02,1,Bed Number 1,68,1,67
2006-07-02,2,Bed Number 2,10,9,1
2006-07-02,3,Bed Number 3,68,2,66
2006-07-03,1,Bed Number 1,50,44,6
2006-07-03,2,Bed Number 2,49,13,36
2006-07-03,3,Bed Number 3,43,17,26
2006-07-04,1,Bed Number 1,78,33,45
2006-07-04,2,Bed Number 2,38,11,27
2006-07-04,3,Bed Number 3,75,48,27
2006-07-05,1,Bed Number 1,20,20,0
2006-07-05,2,Bed Number 2,34,19,15
2006-07-05,3,Bed Number 3,21,9,12
2006-07-06,1,Bed Number 1,45,42,3
2006-07-06,2,Bed Number 2,82,28,54
2006-07-06,3,Bed Number 3,90,32,58
2006-07-07,1,Bed Number 1,80,39,41
2006-07-07,2,Bed Number 2,18,14,4
2006-07-07,3,Bed Number 3,66,14,52
2006-07-08,1,Bed Number 1,16,13,3
2006-07-08,2,Bed Number 2,13,11,2
2006-07-08,3,Bed Number 3,66,36,30
2006-07-09,1,Bed Number 1,99,81,18
2006-07-09,2,Bed Number 2,85,44,41
2006-07-09,3,Bed Number 3,72,41,31
2006-07-10,1,Bed Number 1,18,16,2
2006-07-10,2,Bed Number 2,47,32,15
2006-07-10,3,Bed Number 3,24,10,14
2006-07-11,1,Bed Number 1,47,10,37
2006-07-11,2,Bed Number 2,43,23,20
2006-07-11,3,Bed Number 3,58,31,27
2006-07-12,1,Bed Number 1,56,31,25
2006-07-12,2,Bed Number 2,33,8,25
2006-07-12,3,Bed Number 3,80,16,64
2006-07-13,1,Bed Number 1,94,82,12
2006-07-13,2,Bed Number 2,34,4,30
2006-07-13,3,Bed Number 3,37,29,8
2006-07-14,1,Bed Number 1,61,9,52
2006-07-14,2,Bed Number 2,67,24,43
2006-07-14,3,Bed Number 3,11,9,2
2006-07-15,1,Bed Number 1,16,8,8
2006-07-15,2,Bed Number 2,48,3,45
2006-07-15,3,Bed Number 3,28,20,8
2006-07-16,1,Bed Number 1,50,24,26
2006-07-16,2,Bed Number 2,58,49,9
2006-07-16,3,Bed Number 3,36,27,9
2006-07-17,1,Bed Number 1,52,45,7
2006-07-17,2,Bed Number 2,36,29,7
2006-07-17,3,Bed Number 3,27,1,26
2006-07-18,1,Bed Number 1,14,8,6
2006-07-18,2,Bed Number 2,12,12,0
2006-07-18,3,Bed Number 3,37,9,28
2006-07-19,1,Bed Number 1,71,49,22
2006-07-19,2,Bed Number 2,52,37,15
2006-07-19,3,Bed Number 3,73,51,22
2006-07-20,1,Bed Number 1,82,8,74
2006-07-20,2,Bed Number 2,84,38,46
2006-07-20,3,Bed Number 3,23,21,2
2006-07-21,1,Bed Number 1,11,4,7
2006-07-21,2,Bed Number 2,81,41,40
2006-07-21,3,Bed Number 3,13,12,1
2006-07-22,1,Bed Number 1,82,44,38
2006-07-22,2,Bed Number 2,46,16,30
2006-07-22,3,Bed Number 3,74,54,20
2006-07-23,1,Bed Number 1,61,59,2
2006-07-23,2,Bed Number 2,56,52,4
2006-07-23,3,Bed Number 3,60,24,36
2006-07-24,1,Bed Number 1,74,23,51
2006-07-24,2,Bed Number 2,82,23,59
2006-07-24,3,Bed Number 3,72,49,23
2006-07-25,1,Bed Number 1,77,71,6
2006-07-25,2,Bed Number 2,68,58,10
2006-07-25,3,Bed Number 3,95,75,20
2006-07-26,1,Bed Number 1,34,28,6
2006-07-26,2,Bed Number 2,83,2,81
2006-07-26,3,Bed Number 3,47,19,28
2006-07-27,1,Bed Number 1,98,16,82
2006-07-27,2,Bed Number 2,80,30,50
2006-07-27,3,Bed Number 3,97,48,49
2006-07-28,1,Bed Number 1,49,6,43
2006-07-28,2,Bed Number 2,43,9,34
2006-07-28,3,Bed Number 3,32,32,0
2006-07-29,1,Bed Number 1,93,73,20
2006-07-29,2,Bed Number 2,80,67,13
2006-07-29,3,Bed Number 3,75,28,47
2006-07-30,1,Bed Number 1,99,20,79
2006-07-30,2,Bed Number 2,49,44,5
2006-07-30,3,Bed Number 3,37,0,37
2006-07-31,1,Bed Number 1,58,53,5
2006-07-31,2,Bed Number 2,78,52,26
2006-07-31,3,Bed Number 3,66,60,6
2006-08-01,1,Bed Number 1,78,60,18
2006-08-01,2,Bed Number 2,26,15,11
2006-08-01,3,Bed Number 3,98,35,63
2006-08-02,1,Bed Number 1,66,2,64
2006-08-02,2,Bed Number 2,37,35,2
2006-08-02,3,Bed Number 3,94,45,49
2006-08-03,1,Bed Number 1,86,53,33
2006-08-03,2,Bed Number 2,21,11,10
2006-08-03,3,Bed Number 3,50,26,24
2006-08-04,1,Bed Number 1,30,13,17
2006-08-04,2,Bed Number 2,90,88,2
2006-08-04,3,Bed Number 3,85,78,7
2006-08-05,1,Bed Number 1,72,21,51
2006-08-05,2,Bed Number 2,26,9,17
2006-08-05,3,Bed Number 3,98,22,76
2006-08-06,1,Bed Number 1,71,0,71
2006-08-06,2,Bed Number 2,36,36,0
2006-08-06,3,Bed Number 3,11,3,8
2006-08-07,1,Bed Number 1,77,51,26
2006-08-07,2,Bed Number 2,31,3,28
2006-08-07,3,Bed Number 3,100,20,80
2006-08-08,1,Bed Number 1,77,64,13
2006-08-08,2,Bed Number 2,42,8,34
2006-08-08,3,Bed Number 3,84,47,37
2006-08-09,1,Bed Number 1,80,50,30
2006-08-09,2,Bed Number 2,43,27,16
2006-08-09,3,Bed Number 3,62,49,13
2006-08-10,1,Bed Number 1,82,8,74
2006-08-10,2,Bed Number 2,96,25,71
2006-08-10,3,Bed Number 3,71,6,65
2006-08-11,1,Bed Number 1,59,10,49
2006-08-11,2,Bed Number 2,38,30,8
2006-08-11,3,Bed Number 3,92,72,20
2006-08-12,1,Bed Number 1,93,86,7
2006-08-12,2,Bed Number 2,20,17,3
2006-08-12,3,Bed Number 3,13,8,5
2006-08-13,1,Bed Number 1,58,23,35
2006-08-13,2,Bed Number 2,23,14,9
2006-08-13,3,Bed Number 3,90,50,40
2006-08-14,1,Bed Number 1,10,2,8
2006-08-14,2,Bed Number 2,56,49,7
2006-08-14,3,Bed Number 3,43,36,7
2006-08-15,1,Bed Number 1,53,39,14
2006-08-15,2,Bed Number 2,81,59,22
2006-08-15,3,Bed Number 3,55,13,42
2006-08-16,1,Bed Number 1,58,56,2
2006-08-16,2,Bed Number 2,68,0,68
2006-08-16,3,Bed Number 3,84,71,13
2006-08-17,1,Bed Number 1,87,12,75
2006-08-17,2,Bed Number 2,26,5,21
2006-08-17,3,Bed Number 3,75,11,64
2006-08-18,1,Bed Number 1,87,50,37
2006-08-18,2,Bed Number 2,51,28,23
2006-08-18,3,Bed Number 3,78,21,57
2006-08-19,1,Bed Number 1,30,28,2
2006-08-19,2,Bed Number 2,37,18,19
2006-08-19,3,Bed Number 3,31,7,24
2006-08-20,1,Bed Number 1,16,3,13
2006-08-20,2,Bed Number 2,19,4,15
2006-08-20,3,Bed Number 3,13,6,7
2006-08-21,1,Bed Number 1,31,30,1
2006-08-21,2,Bed Number 2,68,4,64
2006-08-21,3,Bed Number 3,36,5,31
2006-08-22,1,Bed Number 1,90,85,5
2006-08-22,2,Bed Number 2,30,10,20
2006-08-22,3,Bed Number 3,83,66,17
2006-08-23,1,Bed Number 1,37,13,24
2006-08-23,2,Bed Number 2,92,75,17
2006-08-23,3,Bed Number 3,67,25,42
2006-08-24,1,Bed Number 1,60,17,43
2006-08-24,2,Bed Number 2,85,18,67
2006-08-24,3,Bed Number 3,39,29,10
2006-08-25,1,Bed Number 1,60,56,4
2006-08-25,2,Bed Number 2,93,52,41
2006-08-25,3,Bed Number 3,42,10,32
2006-08-26,1,Bed Number 1,55,22,33
2006-08-26,2,Bed Number 2,29,2,27
2006-08-26,3,Bed Number 3,12,1,11
2006-08-27,1,Bed Number 1,88,31,57
2006-08-27,2,Bed Number 2,38,14,24
2006-08-27,3,Bed Number 3,32,0,32
2006-08-28,1,Bed Number 1,80,22,58
2006-08-28,2,Bed Number 2,77,13,64
2006-08-28,3,Bed Number 3,98,97,1
2006-08-29,1,Bed Number 1,47,20,27
2006-08-29,2,Bed Number 2,90,4,86
2006-08-29,3,Bed Number 3,85,48,37
2006-08-30,1,Bed Number 1,63,33,30
2006-08-30,2,Bed Number 2,71,69,2
2006-08-30,3,Bed Number 3,53,33,20
2006-08-31,1,Bed Number 1,23,5,18
2006-08-31,2,Bed Number 2,84,42,42
2006-08-31,3,Bed Number 3,36,24,12
2006-09-01,1,Bed Number 1,79,6,73
2006-09-01,2,Bed Number 2,17,2,15
2006-09-01,3,Bed Number 3,46,18,28
2006-09-02,1,Bed Number 1,17,5,12
2006-09-02,2,Bed Number 2,26,17,9
2006-09-02,3,Bed Number 3,25,23,2
2006-09-03,1,Bed Number 1,17,11,6
2006-09-03,2,Bed Number 2,43,9,34
2006-09-03,3,Bed Number 3,99,76,23
2006-09-04,1,Bed Number 1,56,56,0
2006-09-04,2,Bed Number 2,36,11,25
2006-09-04,3,Bed Number 3,47,18,29
2006-09-05,1,Bed Number 1,97,42,55
2006-09-05,2,Bed Number 2,85,69,16
2006-09-05,3,Bed Number 3,80,25,55
2006-09-06,1,Bed Number 1,89,26,63
2006-09-06,2,Bed Number 2,58,25,33
2006-09-06,3,Bed Number 3,31,8,23
2006-09-07,1,Bed Number 1,33,16,17
2006-09-07,2,Bed Number 2,32,26,6
2006-09-07,3,Bed Number 3,25,7,18
2006-09-08,1,Bed Number 1,58,49,9
2006-09-08,2,Bed Number 2,20,10,10
2006-09-08,3,Bed Number 3,52,40,12
2006-09-09,1,Bed Number 1,68,51,17
2006-09-09,2,Bed Number 2,63,52,11
2006-09-09,3,Bed Number 3,14,5,9
2006-09-10,1,Bed Number 1,46,39,7
2006-09-10,2,Bed Number 2,10,10,0
2006-09-10,3,Bed Number 3,90,1,89
2006-09-11,1,Bed Number 1,50,7,43
2006-09-11,2,Bed Number 2,96,89,7
2006-09-11,3,Bed Number 3,54,33,21
2006-09-12,1,Bed Number 1,32,2,30
2006-09-12,2,Bed Number 2,42,36,6
2006-09-12,3,Bed Number 3,58,55,3
2006-09-13,1,Bed Number 1,12,4,8
2006-09-13,2,Bed Number 2,17,10,7
2006-09-13,3,Bed Number 3,53,29,24
2006-09-14,1,Bed Number 1,67,10,57
2006-09-14,2,Bed Number 2,30,25,5
2006-09-14,3,Bed Number 3,29,22,7
2006-09-15,1,Bed Number 1,56,53,3
2006-09-15,2,Bed Number 2,70,60,10
2006-09-15,3,Bed Number 3,10,1,9
2006-09-16,1,Bed Number 1,86,7,79
2006-09-16,2,Bed Number 2,37,35,2
2006-09-16,3,Bed Number 3,79,30,49
2006-09-17,1,Bed Number 1,62,33,29
2006-09-17,2,Bed Number 2,69,30,39
2006-09-17,3,Bed Number 3,66,49,17
2006-09-18,1,Bed Number 1,76,63,13
2006-09-18,2,Bed Number 2,36,30,6
2006-09-18,3,Bed Number 3,71,16,55
2006-09-19,1,Bed Number 1,25,21,4
2006-09-19,2,Bed Number 2,71,22,49
2006-09-19,3,Bed Number 3,33,2,31
2006-09-20,1,Bed Number 1,43,12,31
2006-09-20,2,Bed Number 2,91,52,39
2006-09-20,3,Bed Number 3,52,23,29
2006-09-21,1,Bed Number 1,35,33,2
2006-09-21,2,Bed Number 2,32,21,11
2006-09-21,3,Bed Number 3,60,31,29
2006-09-22,1,Bed Number 1,87,10,77
2006-09-22,2,Bed Number 2,61,52,9
2006-09-22,3,Bed Number 3,77,14,63
2006-09-23,1,Bed Number 1,56,3,53
2006-09-23,2,Bed Number 2,41,3,38
2006-09-23,3,Bed Number 3,68,23,45
2006-09-24,1,Bed Number 1,22,1,21
2006-09-24,2,Bed Number 2,10,5,5
2006-09-24,3,Bed Number 3,66,13,53
2006-09-25,1,Bed Number 1,98,17,81
2006-09-25,2,Bed Number 2,94,18,76
2006-09-25,3,Bed Number 3,65,64,1
2006-09-26,1,Bed Number 1,27,22,5
2006-09-26,2,Bed Number 2,69,20,49
2006-09-26,3,Bed Number 3,80,15,65
2006-09-27,1,Bed Number 1,27,6,21
2006-09-27,2,Bed Number 2,64,26,38
2006-09-27,3,Bed Number 3,13,0,13
2006-09-28,1,Bed Number 1,60,24,36
2006-09-28,2,Bed Number 2,13,10,3
2006-09-28,3,Bed Number 3,28,9,19
2006-09-29,1,Bed Number 1,89,78,11
2006-09-29,2,Bed Number 2,53,11,42
2006-09-29,3,Bed Number 3,55,1,54
2006-09-30,1,Bed Number 1,60,3,57
2006-09-30,2,Bed Number 2,83,61,22
2006-09-30,3,Bed Number 3,53,11,42
2006-10-01,1,Bed Number 1,66,19,47
2006-10-01,2,Bed Number 2,63,35,28
2006-10-01,3,Bed Number 3,40,10,30
2006-10-02,1,Bed Number 1,27,18,9
2006-10-02,2,Bed Number 2,53,35,18
2006-10-02,3,Bed Number 3,48,31,17
2006-10-03,1,Bed Number 1,19,12,7
2006-10-03,2,Bed Number 2,44,32,12
2006-10-03,3,Bed Number 3,50,27,23
2006-10-04,1,Bed Number 1,44,28,16
2006-10-04,2,Bed Number 2,70,55,15
2006-10-04,3,Bed Number 3,94,56,38
2006-10-05,1,Bed Number 1,14,14,0
2006-10-05,2,Bed Number 2,51,38,13
2006-10-05,3,Bed Number 3,22,13,9
2006-10-06,1,Bed Number 1,93,49,44
2006-10-06,2,Bed Number 2,54,27,27
2006-10-06,3,Bed Number 3,63,26,37
2006-10-07,1,Bed Number 1,97,24,73
2006-10-07,2,Bed Number 2,96,92,4
2006-10-07,3,Bed Number 3,65,31,34
2006-10-08,1,Bed Number 1,73,29,44
2006-10-08,2,Bed Number 2,21,15,6
2006-10-08,3,Bed Number 3,65,53,12
2006-10-09,1,Bed Number 1,40,17,23
2006-10-09,2,Bed Number 2,28,13,15
2006-10-09,3,Bed Number 3,44,8,36
2006-10-10,1,Bed Number 1,85,80,5
2006-10-10,2,Bed Number 2,95,0,95
2006-10-10,3,Bed Number 3,40,18,22
2006-10-11,1,Bed Number 1,72,21,51
2006-10-11,2,Bed Number 2,88,86,2
2006-10-11,3,Bed Number 3,47,38,9
2006-10-12,1,Bed Number 1,48,8,40
2006-10-12,2,Bed Number 2,93,19,74
2006-10-12,3,Bed Number 3,82,23,59
2006-10-13,1,Bed Number 1,52,10,42
2006-10-13,2,Bed Number 2,65,18,47
2006-10-13,3,Bed Number 3,68,17,51
2006-10-14,1,Bed Number 1,59,48,11
2006-10-14,2,Bed Number 2,66,30,36
2006-10-14,3,Bed Number 3,36,9,27
2006-10-15,1,Bed Number 1,24,19,5
2006-10-15,2,Bed Number 2,72,8,64
2006-10-15,3,Bed Number 3,26,15,11
2006-10-16,1,Bed Number 1,11,11,0
2006-10-16,2,Bed Number 2,56,52,4
2006-10-16,3,Bed Number 3,73,6,67
2006-10-17,1,Bed Number 1,44,17,27
2006-10-17,2,Bed Number 2,25,4,21
2006-10-17,3,Bed Number 3,52,38,14
2006-10-18,1,Bed Number 1,77,55,22
2006-10-18,2,Bed Number 2,41,20,21
2006-10-18,3,Bed Number 3,45,7,38
2006-10-19,1,Bed Number 1,64,60,4
2006-10-19,2,Bed Number 2,53,49,4
2006-10-19,3,Bed Number 3,67,7,60
2006-10-20,1,Bed Number 1,46,8,38
2006-10-20,2,Bed Number 2,19,16,3
2006-10-20,3,Bed Number 3,64,48,16
2006-10-21,1,Bed Number 1,47,25,22
2006-10-21,2,Bed Number 2,100,83,17
2006-10-21,3,Bed Number 3,32,12,20
2006-10-22,1,Bed Number 1,52,33,19
2006-10-22,2,Bed Number 2,65,19,46
2006-10-22,3,Bed Number 3,99,61,38
2006-10-23,1,Bed Number 1,83,72,11
2006-10-23,2,Bed Number 2,48,28,20
2006-10-23,3,Bed Number 3,99,31,68
2006-10-24,1,Bed Number 1,80,5,75
2006-10-24,2,Bed Number 2,46,24,22
2006-10-24,3,Bed Number 3,13,5,8
2006-10-25,1,Bed Number 1,74,69,5
2006-10-25,2,Bed Number 2,54,31,23
2006-10-25,3,Bed Number 3,17,16,1
2006-10-26,1,Bed Number 1,22,7,15
2006-10-26,2,Bed Number 2,90,71,19
2006-10-26,3,Bed Number 3,85,50,35
2006-10-27,1,Bed Number 1,28,15,13
2006-10-27,2,Bed Number 2,96,51,45
2006-10-27,3,Bed Number 3,75,66,9
2006-10-28,1,Bed Number 1,89,38,51
2006-10-28,2,Bed Number 2,85,54,31
2006-10-28,3,Bed Number 3,81,62,19
2006-10-29,1,Bed Number 1,59,7,52
2006-10-29,2,Bed Number 2,43,8,35
2006-10-29,3,Bed Number 3,24,16,8
2006-10-30,1,Bed Number 1,18,6,12
2006-10-30,2,Bed Number 2,91,6,85
2006-10-30,3,Bed Number 3,26,17,9
2006-10-31,1,Bed Number 1,24,23,1
2006-10-31,2,Bed Number 2,26,23,3
2006-10-31,3,Bed Number 3,69,61,8
2006-11-01,1,Bed Number 1,59,31,28
2006-11-01,2,Bed Number 2,65,38,27
2006-11-01,3,Bed Number 3,88,43,45
2006-11-02,1,Bed Number 1,29,18,11
2006-11-02,2,Bed Number 2,45,1,44
2006-11-02,3,Bed Number 3,83,30,53
2006-11-03,1,Bed Number 1,54,49,5
2006-11-03,2,Bed Number 2,87,40,47
2006-11-03,3,Bed Number 3,52,8,44
2006-11-04,1,Bed Number 1,25,17,8
2006-11-04,2,Bed Number 2,80,75,5
2006-11-04,3,Bed Number 3,56,55,1
2006-11-05,1,Bed Number 1,27,14,13
2006-11-05,2,Bed Number 2,57,10,47
2006-11-05,3,Bed Number 3,37,20,17
2006-11-06,1,Bed Number 1,17,0,17
2006-11-06,2,Bed Number 2,71,10,61
2006-11-06,3,Bed Number 3,64,7,57
2006-11-07,1,Bed Number 1,94,17,77
2006-11-07,2,Bed Number 2,82,20,62
2006-11-07,3,Bed Number 3,10,7,3
2006-11-08,1,Bed Number 1,10,8,2
2006-11-08,2,Bed Number 2,18,8,10
2006-11-08,3,Bed Number 3,69,11,58
2006-11-09,1,Bed Number 1,31,26,5
2006-11-09,2,Bed Number 2,97,55,42
2006-11-09,3,Bed Number 3,82,13,69
2006-11-10,1,Bed Number 1,37,16,21
2006-11-10,2,Bed Number 2,99,36,63
2006-11-10,3,Bed Number 3,72,55,17
2006-11-11,1,Bed Number 1,61,40,21
2006-11-11,2,Bed Number 2,82,59,23
2006-11-11,3,Bed Number 3,45,34,11
2006-11-12,1,Bed Number 1,44,37,7
2006-11-12,2,Bed Number 2,51,41,10
2006-11-12,3,Bed Number 3,22,2,20
2006-11-13,1,Bed Number 1,42,14,28
2006-11-13,2,Bed Number 2,70,49,21
2006-11-13,3,Bed Number 3,72,0,72
2006-11-14,1,Bed Number 1,86,83,3
2006-11-14,2,Bed Number 2,53,23,30
2006-11-14,3,Bed Number 3,21,21,0
2006-11-15,1,Bed Number 1,81,42,39
2006-11-15,2,Bed Number 2,56,56,0
2006-11-15,3,Bed Number 3,37,19,18
2006-11-16,1,Bed Number 1,79,60,19
2006-11-16,2,Bed Number 2,35,14,21
2006-11-16,3,Bed Number 3,94,11,83
2006-11-17,1,Bed Number 1,57,49,8
2006-11-17,2,Bed Number 2,100,10,90
2006-11-17,3,Bed Number 3,79,27,52
2006-11-18,1,Bed Number 1,82,33,49
2006-11-18,2,Bed Number 2,98,86,12
2006-11-18,3,Bed Number 3,31,19,12
2006-11-19,1,Bed Number 1,25,5,20
2006-11-19,2,Bed Number 2,45,32,13
2006-11-19,3,Bed Number 3,86,33,53
2006-11-20,1,Bed Number 1,70,39,31
2006-11-20,2,Bed Number 2,13,8,5
2006-11-20,3,Bed Number 3,39,21,18
2006-11-21,1,Bed Number 1,20,16,4
2006-11-21,2,Bed Number 2,81,39,42
2006-11-21,3,Bed Number 3,72,66,6
2006-11-22,1,Bed Number 1,92,72,20
2006-11-22,2,Bed Number 2,74,6,68
2006-11-22,3,Bed Number 3,87,30,57
2006-11-23,1,Bed Number 1,59,36,23
2006-11-23,2,Bed Number 2,65,10,55
2006-11-23,3,Bed Number 3,40,34,6
2006-11-24,1,Bed Number 1,38,28,10
2006-11-24,2,Bed Number 2,42,19,23
2006-11-24,3,Bed Number 3,62,3,59
2006-11-25,1,Bed Number 1,67,48,19
2006-11-25,2,Bed Number 2,92,65,27
2006-11-25,3,Bed Number 3,50,50,0
2006-11-26,1,Bed Number 1,48,31,17
2006-11-26,2,Bed Number 2,65,63,2
2006-11-26,3,Bed Number 3,40,12,28
2006-11-27,1,Bed Number 1,72,11,61
2006-11-27,2,Bed Number 2,98,18,80
2006-11-27,3,Bed Number 3,64,15,49
2006-11-28,1,Bed Number 1,63,6,57
2006-11-28,2,Bed Number 2,95,60,35
2006-11-28,3,Bed Number 3,25,16,9
2006-11-29,1,Bed Number 1,99,78,21
2006-11-29,2,Bed Number 2,54,47,7
2006-11-29,3,Bed Number 3,11,2,9
2006-11-30,1,Bed Number 1,61,12,49
2006-11-30,2,Bed Number 2,29,14,15
2006-11-30,3,Bed Number 3,73,52,21
2006-12-01,1,Bed Number 1,52,4,48
2006-12-01,2,Bed Number 2,56,47,9
2006-12-01,3,Bed Number 3,21,16,5
2006-12-02,1,Bed Number 1,13,13,0
2006-12-02,2,Bed Number 2,22,10,12
2006-12-02,3,Bed Number 3,29,6,23
2006-12-03,1,Bed Number 1,51,37,14
2006-12-03,2,Bed Number 2,98,64,34
2006-12-03,3,Bed Number 3,23,17,6
2006-12-04,1,Bed Number 1,60,41,19
2006-12-04,2,Bed Number 2,31,8,23
2006-12-04,3,Bed Number 3,84,53,31
2006-12-05,1,Bed Number 1,98,27,71
2006-12-05,2,Bed Number 2,76,29,47
2006-12-05,3,Bed Number 3,42,39,3
2006-12-06,1,Bed Number 1,100,56,44
2006-12-06,2,Bed Number 2,46,22,24
2006-12-06,3,Bed Number 3,76,53,23
2006-12-07,1,Bed Number 1,23,21,2
2006-12-07,2,Bed Number 2,75,45,30
2006-12-07,3,Bed Number 3,24,6,18
2006-12-08,1,Bed Number 1,15,4,11
2006-12-08,2,Bed Number 2,74,7,67
2006-12-08,3,Bed Number 3,92,20,72
2006-12-09,1,Bed Number 1,40,12,28
2006-12-09,2,Bed Number 2,24,3,21
2006-12-09,3,Bed Number 3,14,9,5
2006-12-10,1,Bed Number 1,63,40,23
2006-12-10,2,Bed Number 2,28,21,7
2006-12-10,3,Bed Number 3,53,40,13
2006-12-11,1,Bed Number 1,64,37,27
2006-12-11,2,Bed Number 2,41,23,18
2006-12-11,3,Bed Number 3,69,24,45
2006-12-12,1,Bed Number 1,74,7,67
2006-12-12,2,Bed Number 2,61,61,0
2006-12-12,3,Bed Number 3,69,68,1
2006-12-13,1,Bed Number 1,72,51,21
2006-12-13,2,Bed Number 2,57,13,44
2006-12-13,3,Bed Number 3,97,83,14
2006-12-14,1,Bed Number 1,54,51,3
2006-12-14,2,Bed Number 2,71,55,16
2006-12-14,3,Bed Number 3,76,58,18
2006-12-15,1,Bed Number 1,29,20,9
2006-12-15,2,Bed Number 2,72,71,1
2006-12-15,3,Bed Number 3,69,4,65
2006-12-16,1,Bed Number 1,19,15,4
2006-12-16,2,Bed Number 2,30,11,19
2006-12-16,3,Bed Number 3,47,23,24
2006-12-17,1,Bed Number 1,73,3,70
2006-12-17,2,Bed Number 2,13,6,7
2006-12-17,3,Bed Number 3,29,0,29
2006-12-18,1,Bed Number 1,19,10,9
2006-12-18,2,Bed Number 2,48,36,12
2006-12-18,3,Bed Number 3,16,7,9
2006-12-19,1,Bed Number 1,58,31,27
2006-12-19,2,Bed Number 2,17,4,13
2006-12-19,3,Bed Number 3,38,3,35
2006-12-20,1,Bed Number 1,61,24,37
2006-12-20,2,Bed Number 2,83,26,57
2006-12-20,3,Bed Number 3,22,15,7
2006-12-21,1,Bed Number 1,50,24,26
2006-12-21,2,Bed Number 2,11,4,7
2006-12-21,3,Bed Number 3,63,37,26
2006-12-22,1,Bed Number 1,55,2,53
2006-12-22,2,Bed Number 2,25,21,4
2006-12-22,3,Bed Number 3,87,54,33
2006-12-23,1,Bed Number 1,90,38,52
2006-12-23,2,Bed Number 2,75,59,16
2006-12-23,3,Bed Number 3,68,37,31
2006-12-24,1,Bed Number 1,63,17,46
2006-12-24,2,Bed Number 2,73,35,38
2006-12-24,3,Bed Number 3,13,7,6
2006-12-25,1,Bed Number 1,71,14,57
2006-12-25,2,Bed Number 2,57,45,12
2006-12-25,3,Bed Number 3,47,29,18
2006-12-26,1,Bed Number 1,39,36,3
2006-12-26,2,Bed Number 2,32,24,8
2006-12-26,3,Bed Number 3,11,2,9
2006-12-27,1,Bed Number 1,49,43,6
2006-12-27,2,Bed Number 2,95,67,28
2006-12-27,3,Bed Number 3,64,6,58
2006-12-28,1,Bed Number 1,34,6,28
2006-12-28,2,Bed Number 2,76,21,55
2006-12-28,3,Bed Number 3,67,25,42
2006-12-29,1,Bed Number 1,23,0,23
2006-12-29,2,Bed Number 2,35,31,4
2006-12-29,3,Bed Number 3,33,7,26
2006-12-30,1,Bed Number 1,51,51,0
2006-12-30,2,Bed Number 2,49,16,33
2006-12-30,3,Bed Number 3,17,14,3
2006-12-31,1,Bed Number 1,60,16,44
2006-12-31,2,Bed Number 2,27,19,8
2006-12-31,3,Bed Number 3,87,67,20
2007-01-01,1,Bed Number 1,34,26,8
2007-01-01,2,Bed Number 2,83,74,9
2007-01-01,3,Bed Number 3,32,21,11
2007-01-02,1,Bed Number 1,21,8,13
2007-01-02,2,Bed Number 2,34,21,13
2007-01-02,3,Bed Number 3,29,8,21
2007-01-03,1,Bed Number 1,49,33,16
2007-01-03,2,Bed Number 2,67,47,20
2007-01-03,3,Bed Number 3,69,25,44
2007-01-04,1,Bed Number 1,91,73,18
2007-01-04,2,Bed Number 2,99,98,1
2007-01-04,3,Bed Number 3,23,23,0
2007-01-05,1,Bed Number 1,90,86,4
2007-01-05,2,Bed Number 2,31,5,26
2007-01-05,3,Bed Number 3,22,21,1
2007-01-06,1,Bed Number 1,50,13,37
2007-01-06,2,Bed Number 2,78,69,9
2007-01-06,3,Bed Number 3,95,49,46
2007-01-07,1,Bed Number 1,64,9,55
2007-01-07,2,Bed Number 2,100,67,33
2007-01-07,3,Bed Number 3,80,2,78
2007-01-08,1,Bed Number 1,84,0,84
2007-01-08,2,Bed Number 2,67,50,17
2007-01-08,3,Bed Number 3,64,35,29
2007-01-09,1,Bed Number 1,88,29,59
2007-01-09,2,Bed Number 2,75,1,74
2007-01-09,3,Bed Number 3,32,3,29
2007-01-10,1,Bed Number 1,80,9,71
2007-01-10,2,Bed Number 2,84,80,4
2007-01-10,3,Bed Number 3,34,22,12
2007-01-11,1,Bed Number 1,75,21,54
2007-01-11,2,Bed Number 2,89,38,51
2007-01-11,3,Bed Number 3,25,0,25
2007-01-12,1,Bed Number 1,55,54,1
2007-01-12,2,Bed Number 2,35,17,18
2007-01-12,3,Bed Number 3,70,35,35
2007-01-13,1,Bed Number 1,95,18,77
2007-01-13,2,Bed Number 2,17,8,9
2007-01-13,3,Bed Number 3,48,25,23
2007-01-14,1,Bed Number 1,11,9,2
2007-01-14,2,Bed Number 2,13,1,12
2007-01-14,3,Bed Number 3,51,22,29
2007-01-15,1,Bed Number 1,61,17,44
2007-01-15,2,Bed Number 2,61,31,30
2007-01-15,3,Bed Number 3,42,11,31
2007-01-16,1,Bed Number 1,43,26,17
2007-01-16,2,Bed Number 2,92,49,43
2007-01-16,3,Bed Number 3,13,12,1
2007-01-17,1,Bed Number 1,69,24,45
2007-01-17,2,Bed Number 2,81,44,37
2007-01-17,3,Bed Number 3,35,0,35
2007-01-18,1,Bed Number 1,35,5,30
2007-01-18,2,Bed Number 2,42,4,38
2007-01-18,3,Bed Number 3,11,6,5
2007-01-19,1,Bed Number 1,71,42,29
2007-01-19,2,Bed Number 2,61,54,7
2007-01-19,3,Bed Number 3,84,65,19
2007-01-20,1,Bed Number 1,77,34,43
2007-01-20,2,Bed Number 2,81,11,70
2007-01-20,3,Bed Number 3,94,30,64
2007-01-21,1,Bed Number 1,28,2,26
2007-01-21,2,Bed Number 2,66,27,39
2007-01-21,3,Bed Number 3,51,15,36
2007-01-22,1,Bed Number 1,61,24,37
2007-01-22,2,Bed Number 2,52,25,27
2007-01-22,3,Bed Number 3,100,22,78
2007-01-23,1,Bed Number 1,21,13,8
2007-01-23,2,Bed Number 2,11,2,9
2007-01-23,3,Bed Number 3,17,10,7
2007-01-24,1,Bed Number 1,45,5,40
2007-01-24,2,Bed Number 2,49,7,42
2007-01-24,3,Bed Number 3,35,28,7
2007-01-25,1,Bed Number 1,22,18,4
2007-01-25,2,Bed Number 2,30,19,11
2007-01-25,3,Bed Number 3,51,23,28
2007-01-26,1,Bed Number 1,13,8,5
2007-01-26,2,Bed Number 2,75,59,16
2007-01-26,3,Bed Number 3,50,12,38
2007-01-27,1,Bed Number 1,58,37,21
2007-01-27,2,Bed Number 2,37,28,9
2007-01-27,3,Bed Number 3,90,89,1
2007-01-28,1,Bed Number 1,82,68,14
2007-01-28,2,Bed Number 2,32,31,1
2007-01-28,3,Bed Number 3,46,17,29
2007-01-29,1,Bed Number 1,42,0,42
2007-01-29,2,Bed Number 2,10,10,0
2007-01-29,3,Bed Number 3,73,39,34
2007-01-30,1,Bed Number 1,16,2,14
2007-01-30,2,Bed Number 2,93,42,51
2007-01-30,3,Bed Number 3,13,8,5
2007-01-31,1,Bed Number 1,45,21,24
2007-01-31,2,Bed Number 2,95,6,89
2007-01-31,3,Bed Number 3,38,16,22
2007-02-01,1,Bed Number 1,44,3,41
2007-02-01,2,Bed Number 2,98,75,23
2007-02-01,3,Bed Number 3,50,1,49
2007-02-02,1,Bed Number 1,16,15,1
2007-02-02,2,Bed Number 2,44,21,23
2007-02-02,3,Bed Number 3,90,17,73
2007-02-03,1,Bed Number 1,60,7,53
2007-02-03,2,Bed Number 2,24,4,20
2007-02-03,3,Bed Number 3,96,1,95
2007-02-04,1,Bed Number 1,100,66,34
2007-02-04,2,Bed Number 2,93,30,63
2007-02-04,3,Bed Number 3,54,2,52
2007-02-05,1,Bed Number 1,56,38,18
2007-02-05,2,Bed Number 2,82,78,4
2007-02-05,3,Bed Number 3,70,61,9
2007-02-06,1,Bed Number 1,63,0,63
2007-02-06,2,Bed Number 2,16,12,4
2007-02-06,3,Bed Number 3,13,6,7
2007-02-07,1,Bed Number 1,62,26,36
2007-02-07,2,Bed Number 2,91,58,33
2007-02-07,3,Bed Number 3,39,18,21
2007-02-08,1,Bed Number 1,41,2,39
2007-02-08,2,Bed Number 2,74,38,36
2007-02-08,3,Bed Number 3,60,22,38
2007-02-09,1,Bed Number 1,75,4,71
2007-02-09,2,Bed Number 2,26,14,12
2007-02-09,3,Bed Number 3,21,7,14
2007-02-10,1,Bed Number 1,59,11,48
2007-02-10,2,Bed Number 2,62,52,10
2007-02-10,3,Bed Number 3,72,68,4
2007-02-11,1,Bed Number 1,39,33,6
2007-02-11,2,Bed Number 2,35,34,1
2007-02-11,3,Bed Number 3,80,79,1
2007-02-12,1,Bed Number 1,79,38,41
2007-02-12,2,Bed Number 2,98,51,47
2007-02-12,3,Bed Number 3,50,43,7
2007-02-13,1,Bed Number 1,92,60,32
2007-02-13,2,Bed Number 2,52,43,9
2007-02-13,3,Bed Number 3,63,10,53
2007-02-14,1,Bed Number 1,35,21,14
2007-02-14,2,Bed Number 2,13,4,9
2007-02-14,3,Bed Number 3,86,26,60
2007-02-15,1,Bed Number 1,91,88,3
2007-02-15,2,Bed Number 2,48,2,46
2007-02-15,3,Bed Number 3,30,11,19
2007-02-16,1,Bed Number 1,10,1,9
2007-02-16,2,Bed Number 2,10,1,9
2007-02-16,3,Bed Number 3,17,10,7
2007-02-17,1,Bed Number 1,46,8,38
2007-02-17,2,Bed Number 2,35,18,17
2007-02-17,3,Bed Number 3,81,71,10
2007-02-18,1,Bed Number 1,68,66,2
2007-02-18,2,Bed Number 2,24,23,1
2007-02-18,3,Bed Number 3,82,62,20
2007-02-19,1,Bed Number 1,54,41,13
2007-02-19,2,Bed Number 2,31,18,13
2007-02-19,3,Bed Number 3,55,1,54
2007-02-20,1,Bed Number 1,74,34,40
2007-02-20,2,Bed Number 2,78,15,63
2007-02-20,3,Bed Number 3,34,1,33
2007-02-21,1,Bed Number 1,28,0,28
2007-02-21,2,Bed Number 2,14,14,0
2007-02-21,3,Bed Number 3,95,33,62
2007-02-22,1,Bed Number 1,37,24,13
2007-02-22,2,Bed Number 2,74,15,59
2007-02-22,3,Bed Number 3,66,22,44
2007-02-23,1,Bed Number 1,57,21,36
2007-02-23,2,Bed Number 2,54,49,5
2007-02-23,3,Bed Number 3,35,34,1
2007-02-24,1,Bed Number 1,97,61,36
2007-02-24,2,Bed Number 2,13,0,13
2007-02-24,3,Bed Number 3,59,37,22
2007-02-25,1,Bed Number 1,85,50,35
2007-02-25,2,Bed Number 2,26,9,17
2007-02-25,3,Bed Number 3,95,63,32
2007-02-26,1,Bed Number 1,10,4,6
2007-02-26,2,Bed Number 2,48,12,36
2007-02-26,3,Bed Number 3,25,9,16
2007-02-27,1,Bed Number 1,24,5,19
2007-02-27,2,Bed Number 2,98,82,16
2007-02-27,3,Bed Number 3,74,4,70
2007-02-28,1,Bed Number 1,21,8,13
2007-02-28,2,Bed Number 2,67,17,50
2007-02-28,3,Bed Number 3,35,14,21
2007-03-01,1,Bed Number 1,62,5,57
2007-03-01,2,Bed Number 2,84,67,17
2007-03-01,3,Bed Number 3,16,15,1
2007-03-02,1,Bed Number 1,46,18,28
2007-03-02,2,Bed Number 2,67,12,55
2007-03-02,3,Bed Number 3,60,46,14
2007-03-03,1,Bed Number 1,52,2,50
2007-03-03,2,Bed Number 2,27,24,3
2007-03-03,3,Bed Number 3,34,20,14
2007-03-04,1,Bed Number 1,37,0,37
2007-03-04,2,Bed Number 2,35,9,26
2007-03-04,3,Bed Number 3,22,15,7
2007-03-05,1,Bed Number 1,71,1,70
2007-03-05,2,Bed Number 2,85,8,77
2007-03-05,3,Bed Number 3,57,32,25
2007-03-06,1,Bed Number 1,96,10,86
2007-03-06,2,Bed Number 2,14,10,4
2007-03-06,3,Bed Number 3,10,5,5
2007-03-07,1,Bed Number 1,86,84,2
2007-03-07,2,Bed Number 2,22,17,5
2007-03-07,3,Bed Number 3,43,19,24
2007-03-08,1,Bed Number 1,38,3,35
2007-03-08,2,Bed Number 2,43,34,9
2007-03-08,3,Bed Number 3,87,22,65
2007-03-09,1,Bed Number 1,54,4,50
2007-03-09,2,Bed Number 2,84,27,57
2007-03-09,3,Bed Number 3,92,67,25
2007-03-10,1,Bed Number 1,22,11,11
2007-03-10,2,Bed Number 2,98,74,24
2007-03-10,3,Bed Number 3,23,11,12
2007-03-11,1,Bed Number 1,37,30,7
2007-03-11,2,Bed Number 2,98,2,96
2007-03-11,3,Bed Number 3,26,1,25
2007-03-12,1,Bed Number 1,54,6,48
2007-03-12,2,Bed Number 2,31,5,26
2007-03-12,3,Bed Number 3,22,6,16
2007-03-13,1,Bed Number 1,64,27,37
2007-03-13,2,Bed Number 2,33,23,10
2007-03-13,3,Bed Number 3,70,18,52
2007-03-14,1,Bed Number 1,11,3,8
2007-03-14,2,Bed Number 2,81,5,76
2007-03-14,3,Bed Number 3,74,32,42
2007-03-15,1,Bed Number 1,94,51,43
2007-03-15,2,Bed Number 2,10,3,7
2007-03-15,3,Bed Number 3,18,0,18
2007-03-16,1,Bed Number 1,10,5,5
2007-03-16,2,Bed Number 2,94,32,62
2007-03-16,3,Bed Number 3,67,10,57
2007-03-17,1,Bed Number 1,38,3,35
2007-03-17,2,Bed Number 2,18,10,8
2007-03-17,3,Bed Number 3,86,72,14
2007-03-18,1,Bed Number 1,85,47,38
2007-03-18,2,Bed Number 2,50,9,41
2007-03-18,3,Bed Number 3,85,3,82
2007-03-19,1,Bed Number 1,38,7,31
2007-03-19,2,Bed Number 2,92,19,73
2007-03-19,3,Bed Number 3,67,52,15
2007-03-20,1,Bed Number 1,48,25,23
2007-03-20,2,Bed Number 2,99,4,95
2007-03-20,3,Bed Number 3,40,21,19
2007-03-21,1,Bed Number 1,21,6,15
2007-03-21,2,Bed Number 2,85,17,68
2007-03-21,3,Bed Number 3,61,14,47
2007-03-22,1,Bed Number 1,86,64,22
2007-03-22,2,Bed Number 2,52,32,20
2007-03-22,3,Bed Number 3,63,30,33
2007-03-23,1,Bed Number 1,76,37,39
2007-03-23,2,Bed Number 2,50,3,47
2007-03-23,3,Bed Number 3,27,21,6
2007-03-24,1,Bed Number 1,53,37,16
2007-03-24,2,Bed Number 2,27,24,3
2007-03-24,3,Bed Number 3,24,7,17
2007-03-25,1,Bed Number 1,37,6,31
2007-03-25,2,Bed Number 2,13,4,9
2007-03-25,3,Bed Number 3,45,44,1
2007-03-26,1,Bed Number 1,32,2,30
2007-03-26,2,Bed Number 2,71,42,29
2007-03-26,3,Bed Number 3,39,14,25
2007-03-27,1,Bed Number 1,47,42,5
2007-03-27,2,Bed Number 2,86,55,31
2007-03-27,3,Bed Number 3,70,67,3
2007-03-28,1,Bed Number 1,67,4,63
2007-03-28,2,Bed Number 2,56,45,11
2007-03-28,3,Bed Number 3,90,17,73
2007-03-29,1,Bed Number 1,25,15,10
2007-03-29,2,Bed Number 2,56,36,20
2007-03-29,3,Bed Number 3,91,0,91
2007-03-30,1,Bed Number 1,52,23,29
2007-03-30,2,Bed Number 2,93,4,89
2007-03-30,3,Bed Number 3,19,6,13
2007-03-31,1,Bed Number 1,89,32,57
2007-03-31,2,Bed Number 2,10,7,3
2007-03-31,3,Bed Number 3,46,38,8
2007-04-01,1,Bed Number 1,98,0,98
2007-04-01,2,Bed Number 2,38,11,27
2007-04-01,3,Bed Number 3,99,80,19
2007-04-02,1,Bed Number 1,41,41,0
2007-04-02,2,Bed Number 2,46,41,5
2007-04-02,3,Bed Number 3,38,33,5
2007-04-03,1,Bed Number 1,29,12,17
2007-04-03,2,Bed Number 2,45,25,20
2007-04-03,3,Bed Number 3,54,2,52
2007-04-04,1,Bed Number 1,88,80,8
2007-04-04,2,Bed Number 2,20,20,0
2007-04-04,3,Bed Number 3,57,52,5
2007-04-05,1,Bed Number 1,81,57,24
2007-04-05,2,Bed Number 2,72,51,21
2007-04-05,3,Bed Number 3,20,12,8
2007-04-06,1,Bed Number 1,55,9,46
2007-04-06,2,Bed Number 2,60,48,12
2007-04-06,3,Bed Number 3,82,60,22
2007-04-07,1,Bed Number 1,73,35,38
2007-04-07,2,Bed Number 2,21,3,18
2007-04-07,3,Bed Number 3,30,6,24
2007-04-08,1,Bed Number 1,20,1,19
2007-04-08,2,Bed Number 2,64,13,51
2007-04-08,3,Bed Number 3,68,33,35
2007-04-09,1,Bed Number 1,96,37,59
2007-04-09,2,Bed Number 2,53,14,39
2007-04-09,3,Bed Number 3,46,34,12
2007-04-10,1,Bed Number 1,60,28,32
2007-04-10,2,Bed Number 2,94,39,55
2007-04-10,3,Bed Number 3,88,66,22
2007-04-11,1,Bed Number 1,50,34,16
2007-04-11,2,Bed Number 2,11,4,7
2007-04-11,3,Bed Number 3,46,20,26
2007-04-12,1,Bed Number 1,55,19,36
2007-04-12,2,Bed Number 2,49,35,14
2007-04-12,3,Bed Number 3,62,50,12
2007-04-13,1,Bed Number 1,86,3,83
2007-04-13,2,Bed Number 2,97,46,51
2007-04-13,3,Bed Number 3,78,4,74
2007-04-14,1,Bed Number 1,37,22,15
2007-04-14,2,Bed Number 2,10,1,9
2007-04-14,3,Bed Number 3,58,40,18
2007-04-15,1,Bed Number 1,93,68,25
2007-04-15,2,Bed Number 2,14,4,10
2007-04-15,3,Bed Number 3,20,16,4
2007-04-16,1,Bed Number 1,47,21,26
2007-04-16,2,Bed Number 2,28,17,11
2007-04-16,3,Bed Number 3,44,30,14
2007-04-17,1,Bed Number 1,78,15,63
2007-04-17,2,Bed Number 2,96,70,26
2007-04-17,3,Bed Number 3,23,20,3
2007-04-18,1,Bed Number 1,20,10,10
2007-04-18,2,Bed Number 2,34,31,3
2007-04-18,3,Bed Number 3,69,24,45
2007-04-19,1,Bed Number 1,76,59,17
2007-04-19,2,Bed Number 2,87,53,34
2007-04-19,3,Bed Number 3,45,23,22
2007-04-20,1,Bed Number 1,38,38,0
2007-04-20,2,Bed Number 2,57,14,43
2007-04-20,3,Bed Number 3,41,13,28
2007-04-21,1,Bed Number 1,30,8,22
2007-04-21,2,Bed Number 2,25,12,13
2007-04-21,3,Bed Number 3,55,25,30
2007-04-22,1,Bed Number 1,33,10,23
2007-04-22,2,Bed Number 2,42,35,7
2007-04-22,3,Bed Number 3,78,58,20
2007-04-23,1,Bed Number 1,54,8,46
2007-04-23,2,Bed Number 2,46,20,26
2007-04-23,3,Bed Number 3,49,35,14
2007-04-24,1,Bed Number 1,30,3,27
2007-04-24,2,Bed Number 2,27,7,20
2007-04-24,3,Bed Number 3,41,28,13
2007-04-25,1,Bed Number 1,72,54,18
2007-04-25,2,Bed Number 2,37,34,3
2007-04-25,3,Bed Number 3,95,26,69
2007-04-26,1,Bed Number 1,53,9,44
2007-04-26,2,Bed Number 2,19,13,6
2007-04-26,3,Bed Number 3,94,3,91
2007-04-27,1,Bed Number 1,24,11,13
2007-04-27,2,Bed Number 2,56,24,32
2007-04-27,3,Bed Number 3,21,10,11
2007-04-28,1,Bed Number 1,62,0,62
2007-04-28,2,Bed Number 2,48,25,23
2007-04-28,3,Bed Number 3,21,4,17
2007-04-29,1,Bed Number 1,67,54,13
2007-04-29,2,Bed Number 2,54,0,54
2007-04-29,3,Bed Number 3,11,8,3
2007-04-30,1,Bed Number 1,100,74,26
2007-04-30,2,Bed Number 2,66,55,11
2007-04-30,3,Bed Number 3,48,38,10
2007-05-01,1,Bed Number 1,32,14,18
2007-05-01,2,Bed Number 2,14,0,14
2007-05-01,3,Bed Number 3,74,56,18
2007-05-02,1,Bed Number 1,22,20,2
2007-05-02,2,Bed Number 2,52,4,48
2007-05-02,3,Bed Number 3,34,14,20
2007-05-03,1,Bed Number 1,64,22,42
2007-05-03,2,Bed Number 2,72,56,16
2007-05-03,3,Bed Number 3,20,8,12
2007-05-04,1,Bed Number 1,23,5,18
2007-05-04,2,Bed Number 2,80,5,75
2007-05-04,3,Bed Number 3,27,17,10
2007-05-05,1,Bed Number 1,47,38,9
2007-05-05,2,Bed Number 2,23,11,12
2007-05-05,3,Bed Number 3,27,15,12
2007-05-06,1,Bed Number 1,16,3,13
2007-05-06,2,Bed Number 2,28,2,26
2007-05-06,3,Bed Number 3,53,30,23
2007-05-07,1,Bed Number 1,39,37,2
2007-05-07,2,Bed Number 2,77,2,75
2007-05-07,3,Bed Number 3,40,30,10
2007-05-08,1,Bed Number 1,46,38,8
2007-05-08,2,Bed Number 2,27,5,22
2007-05-08,3,Bed Number 3,29,6,23
2007-05-09,1,Bed Number 1,62,44,18
2007-05-09,2,Bed Number 2,73,30,43
2007-05-09,3,Bed Number 3,92,55,37
2007-05-10,1,Bed Number 1,21,5,16
2007-05-10,2,Bed Number 2,69,5,64
2007-05-10,3,Bed Number 3,72,70,2
2007-05-11,1,Bed Number 1,70,32,38
2007-05-11,2,Bed Number 2,72,5,67
2007-05-11,3,Bed Number 3,54,30,24
2007-05-12,1,Bed Number 1,11,9,2
2007-05-12,2,Bed Number 2,56,55,1
2007-05-12,3,Bed Number 3,45,35,10
2007-05-13,1,Bed Number 1,55,6,49
2007-05-13,2,Bed Number 2,96,20,76
2007-05-13,3,Bed Number 3,43,34,9
2007-05-14,1,Bed Number 1,69,63,6
2007-05-14,2,Bed Number 2,85,75,10
2007-05-14,3,Bed Number 3,80,70,10
2007-05-15,1,Bed Number 1,15,1,14
2007-05-15,2,Bed Number 2,75,28,47
2007-05-15,3,Bed Number 3,73,40,33
2007-05-16,1,Bed Number 1,64,11,53
2007-05-16,2,Bed Number 2,72,55,17
2007-05-16,3,Bed Number 3,15,14,1
2007-05-17,1,Bed Number 1,17,1,16
2007-05-17,2,Bed Number 2,29,10,19
2007-05-17,3,Bed Number 3,50,28,22
2007-05-18,1,Bed Number 1,39,18,21
2007-05-18,2,Bed Number 2,15,13,2
2007-05-18,3,Bed Number 3,33,13,20
2007-05-19,1,Bed Number 1,62,34,28
2007-05-19,2,Bed Number 2,54,34,20
2007-05-19,3,Bed Number 3,75,62,13
2007-05-20,1,Bed Number 1,48,48,0
2007-05-20,2,Bed Number 2,77,16,61
2007-05-20,3,Bed Number 3,43,29,14
2007-05-21,1,Bed Number 1,73,1,72
2007-05-21,2,Bed Number 2,23,5,18
2007-05-21,3,Bed Number 3,68,42,26
2007-05-22,1,Bed Number 1,37,16,21
2007-05-22,2,Bed Number 2,31,0,31
2007-05-22,3,Bed Number 3,85,80,5
2007-05-23,1,Bed Number 1,10,1,9
2007-05-23,2,Bed Number 2,45,28,17
2007-05-23,3,Bed Number 3,20,3,17
2007-05-24,1,Bed Number 1,45,39,6
2007-05-24,2,Bed Number 2,23,7,16
2007-05-24,3,Bed Number 3,74,61,13
2007-05-25,1,Bed Number 1,93,28,65
2007-05-25,2,Bed Number 2,24,5,19
2007-05-25,3,Bed Number 3,79,19,60
2007-05-26,1,Bed Number 1,49,16,33
2007-05-26,2,Bed Number 2,52,36,16
2007-05-26,3,Bed Number 3,59,16,43
2007-05-27,1,Bed Number 1,35,3,32
2007-05-27,2,Bed Number 2,54,7,47
2007-05-27,3,Bed Number 3,89,28,61
2007-05-28,1,Bed Number 1,47,40,7
2007-05-28,2,Bed Number 2,93,81,12
2007-05-28,3,Bed Number 3,93,42,51
2007-05-29,1,Bed Number 1,88,57,31
2007-05-29,2,Bed Number 2,99,99,0
2007-05-29,3,Bed Number 3,40,36,4
2007-05-30,1,Bed Number 1,60,27,33
2007-05-30,2,Bed Number 2,60,54,6
2007-05-30,3,Bed Number 3,57,24,33
2007-05-31,1,Bed Number 1,95,5,90
2007-05-31,2,Bed Number 2,75,8,67
2007-05-31,3,Bed Number 3,15,2,13
2007-06-01,1,Bed Number 1,94,60,34
2007-06-01,2,Bed Number 2,11,2,9
2007-06-01,3,Bed Number 3,31,26,5
2007-06-02,1,Bed Number 1,82,44,38
2007-06-02,2,Bed Number 2,73,73,0
2007-06-02,3,Bed Number 3,48,19,29
2007-06-03,1,Bed Number 1,91,41,50
2007-06-03,2,Bed Number 2,48,46,2
2007-06-03,3,Bed Number 3,77,51,26
2007-06-04,1,Bed Number 1,10,5,5
2007-06-04,2,Bed Number 2,47,16,31
2007-06-04,3,Bed Number 3,37,34,3
2007-06-05,1,Bed Number 1,58,49,9
2007-06-05,2,Bed Number 2,28,7,21
2007-06-05,3,Bed Number 3,78,10,68
2007-06-06,1,Bed Number 1,81,42,39
2007-06-06,2,Bed Number 2,78,72,6
2007-06-06,3,Bed Number 3,25,20,5
2007-06-07,1,Bed Number 1,77,12,65
2007-06-07,2,Bed Number 2,50,27,23
2007-06-07,3,Bed Number 3,87,71,16
2007-06-08,1,Bed Number 1,53,3,50
2007-06-08,2,Bed Number 2,70,25,45
2007-06-08,3,Bed Number 3,16,0,16
2007-06-09,1,Bed Number 1,12,3,9
2007-06-09,2,Bed Number 2,29,28,1
2007-06-09,3,Bed Number 3,48,4,44
2007-06-10,1,Bed Number 1,32,17,15
2007-06-10,2,Bed Number 2,96,52,44
2007-06-10,3,Bed Number 3,100,14,86
2007-06-11,1,Bed Number 1,93,58,35
2007-06-11,2,Bed Number 2,53,44,9
2007-06-11,3,Bed Number 3,74,0,74
2007-06-12,1,Bed Number 1,51,0,51
2007-06-12,2,Bed Number 2,21,17,4
2007-06-12,3,Bed Number 3,25,6,19
2007-06-13,1,Bed Number 1,57,0,57
2007-06-13,2,Bed Number 2,21,8,13
2007-06-13,3,Bed Number 3,69,8,61
2007-06-14,1,Bed Number 1,90,8,82
2007-06-14,2,Bed Number 2,88,52,36
2007-06-14,3,Bed Number 3,42,21,21
2007-06-15,1,Bed Number 1,60,47,13
2007-06-15,2,Bed Number 2,93,34,59
2007-06-15,3,Bed Number 3,13,2,11
2007-06-16,1,Bed Number 1,82,36,46
2007-06-16,2,Bed Number 2,63,56,7
2007-06-16,3,Bed Number 3,32,17,15
2007-06-17,1,Bed Number 1,40,35,5
2007-06-17,2,Bed Number 2,65,6,59
2007-06-17,3,Bed Number 3,87,65,22
2007-06-18,1,Bed Number 1,86,35,51
2007-06-18,2,Bed Number 2,23,20,3
2007-06-18,3,Bed Number 3,26,7,19
2007-06-19,1,Bed Number 1,74,1,73
2007-06-19,2,Bed Number 2,74,25,49
2007-06-19,3,Bed Number 3,33,24,9
2007-06-20,1,Bed Number 1,27,17,10
2007-06-20,2,Bed Number 2,12,10,2
2007-06-20,3,Bed Number 3,14,6,8
2007-06-21,1,Bed Number 1,88,33,55
2007-06-21,2,Bed Number 2,47,11,36
2007-06-21,3,Bed Number 3,62,34,28
2007-06-22,1,Bed Number 1,40,20,20
2007-06-22,2,Bed Number 2,78,18,60
2007-06-22,3,Bed Number 3,99,21,78
2007-06-23,1,Bed Number 1,50,44,6
2007-06-23,2,Bed Number 2,15,14,1
2007-06-23,3,Bed Number 3,43,43,0
2007-06-24,1,Bed Number 1,37,9,28
2007-06-24,2,Bed Number 2,95,61,34
2007-06-24,3,Bed Number 3,58,11,47
2007-06-25,1,Bed Number 1,19,6,13
2007-06-25,2,Bed Number 2,63,57,6
2007-06-25,3,Bed Number 3,98,97,1
2007-06-26,1,Bed Number 1,65,24,41
2007-06-26,2,Bed Number 2,61,36,25
2007-06-26,3,Bed Number 3,78,20,58
2007-06-27,1,Bed Number 1,28,25,3
2007-06-27,2,Bed Number 2,40,38,2
2007-06-27,3,Bed Number 3,82,17,65
2007-06-28,1,Bed Number 1,24,22,2
2007-06-28,2,Bed Number 2,91,22,69
2007-06-28,3,Bed Number 3,82,56,26
2007-06-29,1,Bed Number 1,67,65,2
2007-06-29,2,Bed Number 2,56,11,45
2007-06-29,3,Bed Number 3,20,15,5
2007-06-30,1,Bed Number 1,51,4,47
2007-06-30,2,Bed Number 2,17,7,10
2007-06-30,3,Bed Number 3,30,22,8
2007-07-01,1,Bed Number 1,56,27,29
2007-07-01,2,Bed Number 2,79,9,70
2007-07-01,3,Bed Number 3,33,14,19
2007-07-02,1,Bed Number 1,24,23,1
2007-07-02,2,Bed Number 2,88,70,18
2007-07-02,3,Bed Number 3,14,9,5
2007-07-03,1,Bed Number 1,94,90,4
2007-07-03,2,Bed Number 2,99,7,92
2007-07-03,3,Bed Number 3,37,20,17
2007-07-04,1,Bed Number 1,19,6,13
2007-07-04,2,Bed Number 2,51,29,22
2007-07-04,3,Bed Number 3,61,45,16
2007-07-05,1,Bed Number 1,13,11,2
2007-07-05,2,Bed Number 2,69,62,7
2007-07-05,3,Bed Number 3,39,0,39
2007-07-06,1,Bed Number 1,45,2,43
2007-07-06,2,Bed Number 2,98,88,10
2007-07-06,3,Bed Number 3,100,66,34
2007-07-07,1,Bed Number 1,50,31,19
2007-07-07,2,Bed Number 2,79,49,30
2007-07-07,3,Bed Number 3,98,84,14
2007-07-08,1,Bed Number 1,100,78,22
2007-07-08,2,Bed Number 2,84,52,32
2007-07-08,3,Bed Number 3,21,3,18
2007-07-09,1,Bed Number 1,47,5,42
2007-07-09,2,Bed Number 2,37,36,1
2007-07-09,3,Bed Number 3,14,10,4
2007-07-10,1,Bed Number 1,14,8,6
2007-07-10,2,Bed Number 2,79,33,46
2007-07-10,3,Bed Number 3,56,6,50
2007-07-11,1,Bed Number 1,37,11,26
2007-07-11,2,Bed Number 2,48,16,32
2007-07-11,3,Bed Number 3,84,79,5
2007-07-12,1,Bed Number 1,58,40,18
2007-07-12,2,Bed Number 2,93,64,29
2007-07-12,3,Bed Number 3,53,15,38
2007-07-13,1,Bed Number 1,50,40,10
2007-07-13,2,Bed Number 2,44,3,41
2007-07-13,3,Bed Number 3,28,19,9
2007-07-14,1,Bed Number 1,100,74,26
2007-07-14,2,Bed Number 2,76,20,56
2007-07-14,3,Bed Number 3,71,38,33
2007-07-15,1,Bed Number 1,59,7,52
2007-07-15,2,Bed Number 2,39,28,11
2007-07-15,3,Bed Number 3,21,6,15
2007-07-16,1,Bed Number 1,95,63,32
2007-07-16,2,Bed Number 2,11,11,0
2007-07-16,3,Bed Number 3,59,48,11
2007-07-17,1,Bed Number 1,97,22,75
2007-07-17,2,Bed Number 2,43,30,13
2007-07-17,3,Bed Number 3,17,15,2
2007-07-18,1,Bed Number 1,73,59,14
2007-07-18,2,Bed Number 2,15,11,4
2007-07-18,3,Bed Number 3,51,21,30
2007-07-19,1,Bed Number 1,84,59,25
2007-07-19,2,Bed Number 2,87,51,36
2007-07-19,3,Bed Number 3,69,49,20
2007-07-20,1,Bed Number 1,67,67,0
2007-07-20,2,Bed Number 2,51,28,23
2007-07-20,3,Bed Number 3,84,79,5
2007-07-21,1,Bed Number 1,66,38,28
2007-07-21,2,Bed Number 2,96,69,27
2007-07-21,3,Bed Number 3,79,49,30
2007-07-22,1,Bed Number 1,96,24,72
2007-07-22,2,Bed Number 2,48,30,18
2007-07-22,3,Bed Number 3,87,68,19
2007-07-23,1,Bed Number 1,39,39,0
2007-07-23,2,Bed Number 2,23,12,11
2007-07-23,3,Bed Number 3,15,7,8
2007-07-24,1,Bed Number 1,31,11,20
2007-07-24,2,Bed Number 2,29,14,15
2007-07-24,3,Bed Number 3,17,17,0
2007-07-25,1,Bed Number 1,77,67,10
2007-07-25,2,Bed Number 2,79,70,9
2007-07-25,3,Bed Number 3,67,33,34
2007-07-26,1,Bed Number 1,96,57,39
2007-07-26,2,Bed Number 2,71,0,71
2007-07-26,3,Bed Number 3,27,6,21
2007-07-27,1,Bed Number 1,40,15,25
2007-07-27,2,Bed Number 2,11,7,4
2007-07-27,3,Bed Number 3,24,15,9
2007-07-28,1,Bed Number 1,70,3,67
2007-07-28,2,Bed Number 2,77,15,62
2007-07-28,3,Bed Number 3,64,31,33
2007-07-29,1,Bed Number 1,53,36,17
2007-07-29,2,Bed Number 2,25,16,9
2007-07-29,3,Bed Number 3,13,5,8
2007-07-30,1,Bed Number 1,96,39,57
2007-07-30,2,Bed Number 2,95,39,56
2007-07-30,3,Bed Number 3,29,25,4
2007-07-31,1,Bed Number 1,44,43,1
2007-07-31,2,Bed Number 2,55,6,49
2007-07-31,3,Bed Number 3,85,27,58
2007-08-01,1,Bed Number 1,34,25,9
2007-08-01,2,Bed Number 2,72,53,19
2007-08-01,3,Bed Number 3,34,8,26
2007-08-02,1,Bed Number 1,18,6,12
2007-08-02,2,Bed Number 2,66,14,52
2007-08-02,3,Bed Number 3,13,8,5
2007-08-03,1,Bed Number 1,25,8,17
2007-08-03,2,Bed Number 2,75,56,19
2007-08-03,3,Bed Number 3,99,26,73
2007-08-04,1,Bed Number 1,98,25,73
2007-08-04,2,Bed Number 2,58,54,4
2007-08-04,3,Bed Number 3,77,67,10
2007-08-05,1,Bed Number 1,82,35,47
2007-08-05,2,Bed Number 2,33,9,24
2007-08-05,3,Bed Number 3,37,1,36
2007-08-06,1,Bed Number 1,65,15,50
2007-08-06,2,Bed Number 2,56,23,33
2007-08-06,3,Bed Number 3,12,2,10
2007-08-07,1,Bed Number 1,21,14,7
2007-08-07,2,Bed Number 2,73,12,61
2007-08-07,3,Bed Number 3,49,10,39
2007-08-08,1,Bed Number 1,32,6,26
2007-08-08,2,Bed Number 2,69,10,59
2007-08-08,3,Bed Number 3,31,2,29
2007-08-09,1,Bed Number 1,88,52,36
2007-08-09,2,Bed Number 2,70,24,46
2007-08-09,3,Bed Number 3,56,47,9
2007-08-10,1,Bed Number 1,40,18,22
2007-08-10,2,Bed Number 2,25,1,24
2007-08-10,3,Bed Number 3,53,6,47
2007-08-11,1,Bed Number 1,43,9,34
2007-08-11,2,Bed Number 2,72,29,43
2007-08-11,3,Bed Number 3,71,58,13
2007-08-12,1,Bed Number 1,62,50,12
2007-08-12,2,Bed Number 2,97,54,43
2007-08-12,3,Bed Number 3,20,16,4
2007-08-13,1,Bed Number 1,93,79,14
2007-08-13,2,Bed Number 2,40,6,34
2007-08-13,3,Bed Number 3,97,64,33
2007-08-14,1,Bed Number 1,76,63,13
2007-08-14,2,Bed Number 2,22,7,15
2007-08-14,3,Bed Number 3,47,34,13
2007-08-15,1,Bed Number 1,42,12,30
2007-08-15,2,Bed Number 2,80,77,3
2007-08-15,3,Bed Number 3,62,31,31
2007-08-16,1,Bed Number 1,29,29,0
2007-08-16,2,Bed Number 2,78,67,11
2007-08-16,3,Bed Number 3,50,48,2
2007-08-17,1,Bed Number 1,61,31,30
2007-08-17,2,Bed Number 2,96,52,44
2007-08-17,3,Bed Number 3,46,12,34
2007-08-18,1,Bed Number 1,35,29,6
2007-08-18,2,Bed Number 2,97,66,31
2007-08-18,3,Bed Number 3,51,47,4
2007-08-19,1,Bed Number 1,47,21,26
2007-08-19,2,Bed Number 2,44,23,21
2007-08-19,3,Bed Number 3,41,38,3
2007-08-20,1,Bed Number 1,39,31,8
2007-08-20,2,Bed Number 2,80,64,16
2007-08-20,3,Bed Number 3,69,35,34
2007-08-21,1,Bed Number 1,21,19,2
2007-08-21,2,Bed Number 2,15,0,15
2007-08-21,3,Bed Number 3,66,45,21
2007-08-22,1,Bed Number 1,17,9,8
2007-08-22,2,Bed Number 2,40,39,1
2007-08-22,3,Bed Number 3,42,30,12
2007-08-23,1,Bed Number 1,62,59,3
2007-08-23,2,Bed Number 2,50,43,7
2007-08-23,3,Bed Number 3,30,14,16
2007-08-24,1,Bed Number 1,56,29,27
2007-08-24,2,Bed Number 2,33,8,25
2007-08-24,3,Bed Number 3,23,21,2
2007-08-25,1,Bed Number 1,80,76,4
2007-08-25,2,Bed Number 2,79,33,46
2007-08-25,3,Bed Number 3,88,49,39
2007-08-26,1,Bed Number 1,75,11,64
2007-08-26,2,Bed Number 2,14,14,0
2007-08-26,3,Bed Number 3,23,22,1
2007-08-27,1,Bed Number 1,54,32,22
2007-08-27,2,Bed Number 2,75,66,9
2007-08-27,3,Bed Number 3,54,5,49
2007-08-28,1,Bed Number 1,45,14,31
2007-08-28,2,Bed Number 2,74,2,72
2007-08-28,3,Bed Number 3,87,40,47
2007-08-29,1,Bed Number 1,36,15,21
2007-08-29,2,Bed Number 2,83,38,45
2007-08-29,3,Bed Number 3,27,27,0
2007-08-30,1,Bed Number 1,82,41,41
2007-08-30,2,Bed Number 2,36,35,1
2007-08-30,3,Bed Number 3,45,31,14
2007-08-31,1,Bed Number 1,82,74,8
2007-08-31,2,Bed Number 2,50,28,22
2007-08-31,3,Bed Number 3,42,38,4
2007-09-01,1,Bed Number 1,72,65,7
2007-09-01,2,Bed Number 2,28,15,13
2007-09-01,3,Bed Number 3,82,43,39
2007-09-02,1,Bed Number 1,37,5,32
2007-09-02,2,Bed Number 2,76,63,13
2007-09-02,3,Bed Number 3,73,12,61
2007-09-03,1,Bed Number 1,75,9,66
2007-09-03,2,Bed Number 2,26,16,10
2007-09-03,3,Bed Number 3,96,61,35
2007-09-04,1,Bed Number 1,44,9,35
2007-09-04,2,Bed Number 2,21,9,12
2007-09-04,3,Bed Number 3,100,10,90
2007-09-05,1,Bed Number 1,76,57,19
2007-09-05,2,Bed Number 2,45,11,34
2007-09-05,3,Bed Number 3,69,53,16
2007-09-06,1,Bed Number 1,13,5,8
2007-09-06,2,Bed Number 2,39,20,19
2007-09-06,3,Bed Number 3,97,58,39
2007-09-07,1,Bed Number 1,53,21,32
2007-09-07,2,Bed Number 2,42,9,33
2007-09-07,3,Bed Number 3,69,14,55
2007-09-08,1,Bed Number 1,23,12,11
2007-09-08,2,Bed Number 2,95,8,87
2007-09-08,3,Bed Number 3,18,1,17
2007-09-09,1,Bed Number 1,52,21,31
2007-09-09,2,Bed Number 2,44,28,16
2007-09-09,3,Bed Number 3,88,63,25
2007-09-10,1,Bed Number 1,41,19,22
2007-09-10,2,Bed Number 2,92,19,73
2007-09-10,3,Bed Number 3,31,7,24
2007-09-11,1,Bed Number 1,55,26,29
2007-09-11,2,Bed Number 2,51,4,47
2007-09-11,3,Bed Number 3,18,0,18
2007-09-12,1,Bed Number 1,67,41,26
2007-09-12,2,Bed Number 2,99,39,60
2007-09-12,3,Bed Number 3,51,4,47
2007-09-13,1,Bed Number 1,44,0,44
2007-09-13,2,Bed Number 2,34,6,28
2007-09-13,3,Bed Number 3,70,32,38
2007-09-14,1,Bed Number 1,41,4,37
2007-09-14,2,Bed Number 2,33,12,21
2007-09-14,3,Bed Number 3,74,68,6
2007-09-15,1,Bed Number 1,13,10,3
2007-09-15,2,Bed Number 2,98,87,11
2007-09-15,3,Bed Number 3,56,31,25
2007-09-16,1,Bed Number 1,30,21,9
2007-09-16,2,Bed Number 2,72,24,48
2007-09-16,3,Bed Number 3,41,41,0
2007-09-17,1,Bed Number 1,70,18,52
2007-09-17,2,Bed Number 2,54,39,15
2007-09-17,3,Bed Number 3,54,25,29
2007-09-18,1,Bed Number 1,67,40,27
2007-09-18,2,Bed Number 2,51,24,27
2007-09-18,3,Bed Number 3,92,8,84
2007-09-19,1,Bed Number 1,47,47,0
2007-09-19,2,Bed Number 2,93,4,89
2007-09-19,3,Bed Number 3,81,26,55
2007-09-20,1,Bed Number 1,51,24,27
2007-09-20,2,Bed Number 2,95,83,12
2007-09-20,3,Bed Number 3,61,17,44
2007-09-21,1,Bed Number 1,31,3,28
2007-09-21,2,Bed Number 2,99,69,30
2007-09-21,3,Bed Number 3,32,21,11
2007-09-22,1,Bed Number 1,54,16,38
2007-09-22,2,Bed Number 2,58,43,15
2007-09-22,3,Bed Number 3,94,86,8
2007-09-23,1,Bed Number 1,100,62,38
2007-09-23,2,Bed Number 2,49,32,17
2007-09-23,3,Bed Number 3,90,74,16
2007-09-24,1,Bed Number 1,100,53,47
2007-09-24,2,Bed Number 2,21,13,8
2007-09-24,3,Bed Number 3,30,30,0
2007-09-25,1,Bed Number 1,82,14,68
2007-09-25,2,Bed Number 2,61,53,8
2007-09-25,3,Bed Number 3,67,62,5
2007-09-26,1,Bed Number 1,23,23,0
2007-09-26,2,Bed Number 2,92,0,92
2007-09-26,3,Bed Number 3,44,13,31
2007-09-27,1,Bed Number 1,81,1,80
2007-09-27,2,Bed Number 2,29,9,20
2007-09-27,3,Bed Number 3,87,36,51
2007-09-28,1,Bed Number 1,16,2,14
2007-09-28,2,Bed Number 2,28,20,8
2007-09-28,3,Bed Number 3,59,28,31
2007-09-29,1,Bed Number 1,28,13,15
2007-09-29,2,Bed Number 2,62,34,28
2007-09-29,3,Bed Number 3,70,48,22
2007-09-30,1,Bed Number 1,59,16,43
2007-09-30,2,Bed Number 2,68,67,1
2007-09-30,3,Bed Number 3,45,24,21
2007-10-01,1,Bed Number 1,63,31,32
2007-10-01,2,Bed Number 2,89,54,35
2007-10-01,3,Bed Number 3,37,35,2
2007-10-02,1,Bed Number 1,85,23,62
2007-10-02,2,Bed Number 2,61,24,37
2007-10-02,3,Bed Number 3,78,43,35
2007-10-03,1,Bed Number 1,25,16,9
2007-10-03,2,Bed Number 2,57,18,39
2007-10-03,3,Bed Number 3,34,27,7
2007-10-04,1,Bed Number 1,17,0,17
2007-10-04,2,Bed Number 2,44,44,0
2007-10-04,3,Bed Number 3,61,35,26
2007-10-05,1,Bed Number 1,84,75,9
2007-10-05,2,Bed Number 2,64,60,4
2007-10-05,3,Bed Number 3,59,36,23
2007-10-06,1,Bed Number 1,54,54,0
2007-10-06,2,Bed Number 2,26,1,25
2007-10-06,3,Bed Number 3,13,7,6
2007-10-07,1,Bed Number 1,39,10,29
2007-10-07,2,Bed Number 2,66,47,19
2007-10-07,3,Bed Number 3,99,1,98
2007-10-08,1,Bed Number 1,72,33,39
2007-10-08,2,Bed Number 2,32,22,10
2007-10-08,3,Bed Number 3,71,53,18
2007-10-09,1,Bed Number 1,18,18,0
2007-10-09,2,Bed Number 2,21,5,16
2007-10-09,3,Bed Number 3,59,34,25
2007-10-10,1,Bed Number 1,64,54,10
2007-10-10,2,Bed Number 2,16,6,10
2007-10-10,3,Bed Number 3,18,9,9
2007-10-11,1,Bed Number 1,26,17,9
2007-10-11,2,Bed Number 2,42,18,24
2007-10-11,3,Bed Number 3,19,2,17
2007-10-12,1,Bed Number 1,41,9,32
2007-10-12,2,Bed Number 2,98,38,60
2007-10-12,3,Bed Number 3,27,19,8
2007-10-13,1,Bed Number 1,60,23,37
2007-10-13,2,Bed Number 2,76,22,54
2007-10-13,3,Bed Number 3,33,23,10
2007-10-14,1,Bed Number 1,57,30,27
2007-10-14,2,Bed Number 2,70,54,16
2007-10-14,3,Bed Number 3,28,5,23
2007-10-15,1,Bed Number 1,83,44,39
2007-10-15,2,Bed Number 2,21,4,17
2007-10-15,3,Bed Number 3,93,73,20
2007-10-16,1,Bed Number 1,53,52,1
2007-10-16,2,Bed Number 2,36,8,28
2007-10-16,3,Bed Number 3,53,36,17
2007-10-17,1,Bed Number 1,34,0,34
2007-10-17,2,Bed Number 2,10,6,4
2007-10-17,3,Bed Number 3,74,40,34
2007-10-18,1,Bed Number 1,25,4,21
2007-10-18,2,Bed Number 2,29,6,23
2007-10-18,3,Bed Number 3,19,16,3
2007-10-19,1,Bed Number 1,75,1,74
2007-10-19,2,Bed Number 2,60,3,57
2007-10-19,3,Bed Number 3,49,1,48
2007-10-20,1,Bed Number 1,75,28,47
2007-10-20,2,Bed Number 2,77,59,18
2007-10-20,3,Bed Number 3,90,79,11
2007-10-21,1,Bed Number 1,58,51,7
2007-10-21,2,Bed Number 2,45,45,0
2007-10-21,3,Bed Number 3,36,19,17
2007-10-22,1,Bed Number 1,48,39,9
2007-10-22,2,Bed Number 2,22,2,20
2007-10-22,3,Bed Number 3,36,26,10
2007-10-23,1,Bed Number 1,54,39,15
2007-10-23,2,Bed Number 2,43,20,23
2007-10-23,3,Bed Number 3,29,6,23
2007-10-24,1,Bed Number 1,97,93,4
2007-10-24,2,Bed Number 2,79,19,60
2007-10-24,3,Bed Number 3,87,52,35
2007-10-25,1,Bed Number 1,47,21,26
2007-10-25,2,Bed Number 2,18,14,4
2007-10-25,3,Bed Number 3,87,56,31
2007-10-26,1,Bed Number 1,98,10,88
2007-10-26,2,Bed Number 2,93,52,41
2007-10-26,3,Bed Number 3,48,36,12
2007-10-27,1,Bed Number 1,51,30,21
2007-10-27,2,Bed Number 2,89,47,42
2007-10-27,3,Bed Number 3,21,20,1
2007-10-28,1,Bed Number 1,64,54,10
2007-10-28,2,Bed Number 2,39,26,13
2007-10-28,3,Bed Number 3,85,33,52
2007-10-29,1,Bed Number 1,18,9,9
2007-10-29,2,Bed Number 2,91,3,88
2007-10-29,3,Bed Number 3,37,20,17
2007-10-30,1,Bed Number 1,52,8,44
2007-10-30,2,Bed Number 2,38,5,33
2007-10-30,3,Bed Number 3,16,2,14
2007-10-31,1,Bed Number 1,35,35,0
2007-10-31,2,Bed Number 2,42,20,22
2007-10-31,3,Bed Number 3,42,28,14
2007-11-01,1,Bed Number 1,24,23,1
2007-11-01,2,Bed Number 2,12,7,5
2007-11-01,3,Bed Number 3,38,34,4
2007-11-02,1,Bed Number 1,99,89,10
2007-11-02,2,Bed Number 2,57,13,44
2007-11-02,3,Bed Number 3,24,6,18
2007-11-03,1,Bed Number 1,17,2,15
2007-11-03,2,Bed Number 2,20,13,7
2007-11-03,3,Bed Number 3,95,67,28
2007-11-04,1,Bed Number 1,54,5,49
2007-11-04,2,Bed Number 2,70,66,4
2007-11-04,3,Bed Number 3,52,31,21
2007-11-05,1,Bed Number 1,94,18,76
2007-11-05,2,Bed Number 2,59,56,3
2007-11-05,3,Bed Number 3,99,43,56
2007-11-06,1,Bed Number 1,13,6,7
2007-11-06,2,Bed Number 2,69,18,51
2007-11-06,3,Bed Number 3,96,67,29
2007-11-07,1,Bed Number 1,65,64,1
2007-11-07,2,Bed Number 2,61,19,42
2007-11-07,3,Bed Number 3,97,70,27
2007-11-08,1,Bed Number 1,92,11,81
2007-11-08,2,Bed Number 2,37,33,4
2007-11-08,3,Bed Number 3,15,15,0
2007-11-09,1,Bed Number 1,24,20,4
2007-11-09,2,Bed Number 2,28,19,9
2007-11-09,3,Bed Number 3,96,25,71
2007-11-10,1,Bed Number 1,38,38,0
2007-11-10,2,Bed Number 2,65,8,57
2007-11-10,3,Bed Number 3,71,20,51
2007-11-11,1,Bed Number 1,78,52,26
2007-11-11,2,Bed Number 2,19,3,16
2007-11-11,3,Bed Number 3,50,19,31
2007-11-12,1,Bed Number 1,77,10,67
2007-11-12,2,Bed Number 2,42,23,19
2007-11-12,3,Bed Number 3,30,19,11
2007-11-13,1,Bed Number 1,21,19,2
2007-11-13,2,Bed Number 2,99,29,70
2007-11-13,3,Bed Number 3,88,29,59
2007-11-14,1,Bed Number 1,70,6,64
2007-11-14,2,Bed Number 2,10,2,8
2007-11-14,3,Bed Number 3,78,49,29
2007-11-15,1,Bed Number 1,17,9,8
2007-11-15,2,Bed Number 2,26,15,11
2007-11-15,3,Bed Number 3,71,50,21
2007-11-16,1,Bed Number 1,81,29,52
2007-11-16,2,Bed Number 2,10,7,3
2007-11-16,3,Bed Number 3,85,78,7
2007-11-17,1,Bed Number 1,95,88,7
2007-11-17,2,Bed Number 2,57,43,14
2007-11-17,3,Bed Number 3,29,29,0
2007-11-18,1,Bed Number 1,89,83,6
2007-11-18,2,Bed Number 2,72,14,58
2007-11-18,3,Bed Number 3,72,47,25
2007-11-19,1,Bed Number 1,99,74,25
2007-11-19,2,Bed Number 2,48,13,35
2007-11-19,3,Bed Number 3,16,10,6
2007-11-20,1,Bed Number 1,67,31,36
2007-11-20,2,Bed Number 2,10,7,3
2007-11-20,3,Bed Number 3,32,5,27
2007-11-21,1,Bed Number 1,71,65,6
2007-11-21,2,Bed Number 2,75,40,35
2007-11-21,3,Bed Number 3,51,16,35
2007-11-22,1,Bed Number 1,71,34,37
2007-11-22,2,Bed Number 2,71,2,69
2007-11-22,3,Bed Number 3,45,42,3
2007-11-23,1,Bed Number 1,31,28,3
2007-11-23,2,Bed Number 2,78,62,16
2007-11-23,3,Bed Number 3,26,9,17
2007-11-24,1,Bed Number 1,14,6,8
2007-11-24,2,Bed Number 2,91,66,25
2007-11-24,3,Bed Number 3,53,26,27
2007-11-25,1,Bed Number 1,27,7,20
2007-11-25,2,Bed Number 2,100,3,97
2007-11-25,3,Bed Number 3,25,23,2
2007-11-26,1,Bed Number 1,13,8,5
2007-11-26,2,Bed Number 2,34,26,8
2007-11-26,3,Bed Number 3,91,84,7
2007-11-27,1,Bed Number 1,95,79,16
2007-11-27,2,Bed Number 2,83,38,45
2007-11-27,3,Bed Number 3,14,7,7
2007-11-28,1,Bed Number 1,38,19,19
2007-11-28,2,Bed Number 2,78,14,64
2007-11-28,3,Bed Number 3,51,14,37
2007-11-29,1,Bed Number 1,23,15,8
2007-11-29,2,Bed Number 2,70,40,30
2007-11-29,3,Bed Number 3,18,2,16
2007-11-30,1,Bed Number 1,90,34,56
2007-11-30,2,Bed Number 2,100,68,32
2007-11-30,3,Bed Number 3,10,10,0
2007-12-01,1,Bed Number 1,38,2,36
2007-12-01,2,Bed Number 2,47,30,17
2007-12-01,3,Bed Number 3,98,12,86
2007-12-02,1,Bed Number 1,80,57,23
2007-12-02,2,Bed Number 2,67,28,39
2007-12-02,3,Bed Number 3,56,48,8
2007-12-03,1,Bed Number 1,26,11,15
2007-12-03,2,Bed Number 2,26,20,6
2007-12-03,3,Bed Number 3,64,15,49
2007-12-04,1,Bed Number 1,79,51,28
2007-12-04,2,Bed Number 2,88,34,54
2007-12-04,3,Bed Number 3,99,93,6
2007-12-05,1,Bed Number 1,82,54,28
2007-12-05,2,Bed Number 2,82,16,66
2007-12-05,3,Bed Number 3,50,17,33
2007-12-06,1,Bed Number 1,92,73,19
2007-12-06,2,Bed Number 2,94,66,28
2007-12-06,3,Bed Number 3,31,0,31
2007-12-07,1,Bed Number 1,94,9,85
2007-12-07,2,Bed Number 2,78,40,38
2007-12-07,3,Bed Number 3,29,21,8
2007-12-08,1,Bed Number 1,61,29,32
2007-12-08,2,Bed Number 2,98,54,44
2007-12-08,3,Bed Number 3,82,81,1
2007-12-09,1,Bed Number 1,51,16,35
2007-12-09,2,Bed Number 2,17,10,7
2007-12-09,3,Bed Number 3,42,3,39
2007-12-10,1,Bed Number 1,29,19,10
2007-12-10,2,Bed Number 2,60,23,37
2007-12-10,3,Bed Number 3,23,23,0
2007-12-11,1,Bed Number 1,11,6,5
2007-12-11,2,Bed Number 2,70,38,32
2007-12-11,3,Bed Number 3,35,31,4
2007-12-12,1,Bed Number 1,90,62,28
2007-12-12,2,Bed Number 2,40,4,36
2007-12-12,3,Bed Number 3,72,47,25
2007-12-13,1,Bed Number 1,47,18,29
2007-12-13,2,Bed Number 2,100,69,31
2007-12-13,3,Bed Number 3,25,11,14
2007-12-14,1,Bed Number 1,88,4,84
2007-12-14,2,Bed Number 2,11,11,0
2007-12-14,3,Bed Number 3,76,28,48
2007-12-15,1,Bed Number 1,69,31,38
2007-12-15,2,Bed Number 2,22,16,6
2007-12-15,3,Bed Number 3,93,5,88
2007-12-16,1,Bed Number 1,86,86,0
2007-12-16,2,Bed Number 2,16,3,13
2007-12-16,3,Bed Number 3,79,7,72
2007-12-17,1,Bed Number 1,60,25,35
2007-12-17,2,Bed Number 2,13,11,2
2007-12-17,3,Bed Number 3,87,75,12
2007-12-18,1,Bed Number 1,65,10,55
2007-12-18,2,Bed Number 2,100,22,78
2007-12-18,3,Bed Number 3,28,10,18
2007-12-19,1,Bed Number 1,68,33,35
2007-12-19,2,Bed Number 2,23,18,5
2007-12-19,3,Bed Number 3,65,57,8
2007-12-20,1,Bed Number 1,63,63,0
2007-12-20,2,Bed Number 2,48,36,12
2007-12-20,3,Bed Number 3,81,50,31
2007-12-21,1,Bed Number 1,24,22,2
2007-12-21,2,Bed Number 2,60,47,13
2007-12-21,3,Bed Number 3,24,16,8
2007-12-22,1,Bed Number 1,26,17,9
2007-12-22,2,Bed Number 2,39,8,31
2007-12-22,3,Bed Number 3,87,86,1
2007-12-23,1,Bed Number 1,15,8,7
2007-12-23,2,Bed Number 2,53,12,41
2007-12-23,3,Bed Number 3,47,22,25
2007-12-24,1,Bed Number 1,57,54,3
2007-12-24,2,Bed Number 2,64,21,43
2007-12-24,3,Bed Number 3,30,16,14
2007-12-25,1,Bed Number 1,31,15,16
2007-12-25,2,Bed Number 2,41,39,2
2007-12-25,3,Bed Number 3,64,61,3
2007-12-26,1,Bed Number 1,70,31,39
2007-12-26,2,Bed Number 2,96,36,60
2007-12-26,3,Bed Number 3,95,91,4
2007-12-27,1,Bed Number 1,69,3,66
2007-12-27,2,Bed Number 2,59,21,38
2007-12-27,3,Bed Number 3,13,12,1
2007-12-28,1,Bed Number 1,67,11,56
2007-12-28,2,Bed Number 2,92,69,23
2007-12-28,3,Bed Number 3,67,20,47
2007-12-29,1,Bed Number 1,16,6,10
2007-12-29,2,Bed Number 2,78,3,75
2007-12-29,3,Bed Number 3,54,38,16
2007-12-30,1,Bed Number 1,12,0,12
2007-12-30,2,Bed Number 2,91,2,89
2007-12-30,3,Bed Number 3,86,61,25
2007-12-31,1,Bed Number 1,84,32,52
2007-12-31,2,Bed Number 2,16,0,16
2007-12-31,3,Bed Number 3,55,41,14
2008-01-01,1,Bed Number 1,81,65,16
2008-01-01,2,Bed Number 2,50,22,28
2008-01-01,3,Bed Number 3,69,21,48
2008-01-02,1,Bed Number 1,68,7,61
2008-01-02,2,Bed Number 2,36,24,12
2008-01-02,3,Bed Number 3,12,6,6
2008-01-03,1,Bed Number 1,92,7,85
2008-01-03,2,Bed Number 2,73,59,14
2008-01-03,3,Bed Number 3,19,8,11
2008-01-04,1,Bed Number 1,21,3,18
2008-01-04,2,Bed Number 2,33,19,14
2008-01-04,3,Bed Number 3,40,20,20
2008-01-05,1,Bed Number 1,24,18,6
2008-01-05,2,Bed Number 2,19,6,13
2008-01-05,3,Bed Number 3,55,42,13
2008-01-06,1,Bed Number 1,50,3,47
2008-01-06,2,Bed Number 2,12,2,10
2008-01-06,3,Bed Number 3,27,22,5
2008-01-07,1,Bed Number 1,11,6,5
2008-01-07,2,Bed Number 2,40,29,11
2008-01-07,3,Bed Number 3,60,1,59
2008-01-08,1,Bed Number 1,44,4,40
2008-01-08,2,Bed Number 2,83,25,58
2008-01-08,3,Bed Number 3,63,23,40
2008-01-09,1,Bed Number 1,76,31,45
2008-01-09,2,Bed Number 2,51,47,4
2008-01-09,3,Bed Number 3,98,8,90
2008-01-10,1,Bed Number 1,54,5,49
2008-01-10,2,Bed Number 2,14,10,4
2008-01-10,3,Bed Number 3,71,60,11
2008-01-11,1,Bed Number 1,65,20,45
2008-01-11,2,Bed Number 2,99,87,12
2008-01-11,3,Bed Number 3,26,17,9
2008-01-12,1,Bed Number 1,81,4,77
2008-01-12,2,Bed Number 2,45,25,20
2008-01-12,3,Bed Number 3,20,17,3
2008-01-13,1,Bed Number 1,81,67,14
2008-01-13,2,Bed Number 2,67,20,47
2008-01-13,3,Bed Number 3,39,34,5
2008-01-14,1,Bed Number 1,98,51,47
2008-01-14,2,Bed Number 2,89,62,27
2008-01-14,3,Bed Number 3,32,20,12
2008-01-15,1,Bed Number 1,39,11,28
2008-01-15,2,Bed Number 2,64,5,59
2008-01-15,3,Bed Number 3,33,17,16
2008-01-16,1,Bed Number 1,55,8,47
2008-01-16,2,Bed Number 2,48,17,31
2008-01-16,3,Bed Number 3,14,2,12
2008-01-17,1,Bed Number 1,100,97,3
2008-01-17,2,Bed Number 2,32,14,18
2008-01-17,3,Bed Number 3,38,14,24
2008-01-18,1,Bed Number 1,36,30,6
2008-01-18,2,Bed Number 2,83,67,16
2008-01-18,3,Bed Number 3,41,27,14
2008-01-19,1,Bed Number 1,88,62,26
2008-01-19,2,Bed Number 2,47,11,36
2008-01-19,3,Bed Number 3,15,0,15
2008-01-20,1,Bed Number 1,25,11,14
2008-01-20,2,Bed Number 2,71,37,34
2008-01-20,3,Bed Number 3,71,22,49
2008-01-21,1,Bed Number 1,68,21,47
2008-01-21,2,Bed Number 2,45,23,22
2008-01-21,3,Bed Number 3,12,0,12
2008-01-22,1,Bed Number 1,57,22,35
2008-01-22,2,Bed Number 2,88,45,43
2008-01-22,3,Bed Number 3,25,17,8
2008-01-23,1,Bed Number 1,95,34,61
2008-01-23,2,Bed Number 2,53,8,45
2008-01-23,3,Bed Number 3,84,53,31
2008-01-24,1,Bed Number 1,60,31,29
2008-01-24,2,Bed Number 2,99,90,9
2008-01-24,3,Bed Number 3,44,25,19
2008-01-25,1,Bed Number 1,34,17,17
2008-01-25,2,Bed Number 2,82,24,58
2008-01-25,3,Bed Number 3,44,1,43
2008-01-26,1,Bed Number 1,55,4,51
2008-01-26,2,Bed Number 2,19,12,7
2008-01-26,3,Bed Number 3,64,43,21
2008-01-27,1,Bed Number 1,29,9,20
2008-01-27,2,Bed Number 2,84,78,6
2008-01-27,3,Bed Number 3,55,50,5
2008-01-28,1,Bed Number 1,84,51,33
2008-01-28,2,Bed Number 2,20,4,16
2008-01-28,3,Bed Number 3,55,17,38
2008-01-29,1,Bed Number 1,57,47,10
2008-01-29,2,Bed Number 2,61,40,21
2008-01-29,3,Bed Number 3,85,55,30
2008-01-30,1,Bed Number 1,79,18,61
2008-01-30,2,Bed Number 2,18,2,16
2008-01-30,3,Bed Number 3,33,18,15
2008-01-31,1,Bed Number 1,88,82,6
2008-01-31,2,Bed Number 2,68,47,21
2008-01-31,3,Bed Number 3,36,24,12
2008-02-01,1,Bed Number 1,36,26,10
2008-02-01,2,Bed Number 2,26,12,14
2008-02-01,3,Bed Number 3,59,51,8
2008-02-02,1,Bed Number 1,55,20,35
2008-02-02,2,Bed Number 2,81,3,78
2008-02-02,3,Bed Number 3,64,38,26
2008-02-03,1,Bed Number 1,68,9,59
2008-02-03,2,Bed Number 2,65,34,31
2008-02-03,3,Bed Number 3,51,15,36
2008-02-04,1,Bed Number 1,35,18,17
2008-02-04,2,Bed Number 2,62,5,57
2008-02-04,3,Bed Number 3,34,27,7
2008-02-05,1,Bed Number 1,68,29,39
2008-02-05,2,Bed Number 2,83,26,57
2008-02-05,3,Bed Number 3,54,22,32
2008-02-06,1,Bed Number 1,39,27,12
2008-02-06,2,Bed Number 2,84,81,3
2008-02-06,3,Bed Number 3,15,4,11
2008-02-07,1,Bed Number 1,74,35,39
2008-02-07,2,Bed Number 2,46,43,3
2008-02-07,3,Bed Number 3,25,19,6
2008-02-08,1,Bed Number 1,89,63,26
2008-02-08,2,Bed Number 2,30,11,19
2008-02-08,3,Bed Number 3,31,14,17
2008-02-09,1,Bed Number 1,18,4,14
2008-02-09,2,Bed Number 2,60,49,11
2008-02-09,3,Bed Number 3,27,12,15
2008-02-10,1,Bed Number 1,91,24,67
2008-02-10,2,Bed Number 2,94,42,52
2008-02-10,3,Bed Number 3,12,4,8
2008-02-11,1,Bed Number 1,75,47,28
2008-02-11,2,Bed Number 2,96,13,83
2008-02-11,3,Bed Number 3,64,35,29
2008-02-12,1,Bed Number 1,53,5,48
2008-02-12,2,Bed Number 2,30,8,22
2008-02-12,3,Bed Number 3,83,35,48
2008-02-13,1,Bed Number 1,35,22,13
2008-02-13,2,Bed Number 2,41,36,5
2008-02-13,3,Bed Number 3,24,14,10
2008-02-14,1,Bed Number 1,67,35,32
2008-02-14,2,Bed Number 2,80,35,45
2008-02-14,3,Bed Number 3,82,64,18
2008-02-15,1,Bed Number 1,16,1,15
2008-02-15,2,Bed Number 2,61,56,5
2008-02-15,3,Bed Number 3,36,22,14
2008-02-16,1,Bed Number 1,28,11,17
2008-02-16,2,Bed Number 2,14,9,5
2008-02-16,3,Bed Number 3,36,25,11
2008-02-17,1,Bed Number 1,39,21,18
2008-02-17,2,Bed Number 2,85,18,67
2008-02-17,3,Bed Number 3,37,24,13
2008-02-18,1,Bed Number 1,67,0,67
2008-02-18,2,Bed Number 2,21,9,12
2008-02-18,3,Bed Number 3,64,35,29
2008-02-19,1,Bed Number 1,61,43,18
2008-02-19,2,Bed Number 2,65,26,39
2008-02-19,3,Bed Number 3,24,22,2
2008-02-20,1,Bed Number 1,31,25,6
2008-02-20,2,Bed Number 2,25,9,16
2008-02-20,3,Bed Number 3,58,15,43
2008-02-21,1,Bed Number 1,22,14,8
2008-02-21,2,Bed Number 2,59,51,8
2008-02-21,3,Bed Number 3,100,33,67
2008-02-22,1,Bed Number 1,58,8,50
2008-02-22,2,Bed Number 2,97,32,65
2008-02-22,3,Bed Number 3,77,71,6
2008-02-23,1,Bed Number 1,25,25,0
2008-02-23,2,Bed Number 2,19,14,5
2008-02-23,3,Bed Number 3,71,15,56
2008-02-24,1,Bed Number 1,28,8,20
2008-02-24,2,Bed Number 2,50,12,38
2008-02-24,3,Bed Number 3,48,3,45
2008-02-25,1,Bed Number 1,76,38,38
2008-02-25,2,Bed Number 2,42,12,30
2008-02-25,3,Bed Number 3,53,26,27
2008-02-26,1,Bed Number 1,29,0,29
2008-02-26,2,Bed Number 2,78,59,19
2008-02-26,3,Bed Number 3,62,49,13
2008-02-27,1,Bed Number 1,74,44,30
2008-02-27,2,Bed Number 2,80,61,19
2008-02-27,3,Bed Number 3,58,14,44
2008-02-28,1,Bed Number 1,57,29,28
2008-02-28,2,Bed Number 2,78,27,51
2008-02-28,3,Bed Number 3,27,12,15
2008-02-29,1,Bed Number 1,81,1,80
2008-02-29,2,Bed Number 2,32,27,5
2008-02-29,3,Bed Number 3,63,58,5
2008-03-01,1,Bed Number 1,17,5,12
2008-03-01,2,Bed Number 2,21,11,10
2008-03-01,3,Bed Number 3,26,14,12
2008-03-02,1,Bed Number 1,47,16,31
2008-03-02,2,Bed Number 2,80,55,25
2008-03-02,3,Bed Number 3,55,45,10
2008-03-03,1,Bed Number 1,69,62,7
2008-03-03,2,Bed Number 2,66,48,18
2008-03-03,3,Bed Number 3,95,76,19
2008-03-04,1,Bed Number 1,21,0,21
2008-03-04,2,Bed Number 2,63,37,26
2008-03-04,3,Bed Number 3,75,55,20
2008-03-05,1,Bed Number 1,78,37,41
2008-03-05,2,Bed Number 2,21,11,10
2008-03-05,3,Bed Number 3,82,30,52
2008-03-06,1,Bed Number 1,92,50,42
2008-03-06,2,Bed Number 2,75,25,50
2008-03-06,3,Bed Number 3,21,12,9
2008-03-07,1,Bed Number 1,46,39,7
2008-03-07,2,Bed Number 2,49,39,10
2008-03-07,3,Bed Number 3,88,55,33
2008-03-08,1,Bed Number 1,100,48,52
2008-03-08,2,Bed Number 2,63,49,14
2008-03-08,3,Bed Number 3,79,8,71
2008-03-09,1,Bed Number 1,29,8,21
2008-03-09,2,Bed Number 2,37,7,30
2008-03-09,3,Bed Number 3,23,11,12
2008-03-10,1,Bed Number 1,100,22,78
2008-03-10,2,Bed Number 2,16,3,13
2008-03-10,3,Bed Number 3,65,34,31
2008-03-11,1,Bed Number 1,91,71,20
2008-03-11,2,Bed Number 2,17,0,17
2008-03-11,3,Bed Number 3,39,19,20
2008-03-12,1,Bed Number 1,69,10,59
2008-03-12,2,Bed Number 2,37,10,27
2008-03-12,3,Bed Number 3,66,60,6
2008-03-13,1,Bed Number 1,34,12,22
2008-03-13,2,Bed Number 2,61,51,10
2008-03-13,3,Bed Number 3,96,95,1
2008-03-14,1,Bed Number 1,28,4,24
2008-03-14,2,Bed Number 2,13,0,13
2008-03-14,3,Bed Number 3,84,48,36
2008-03-15,1,Bed Number 1,84,30,54
2008-03-15,2,Bed Number 2,63,40,23
2008-03-15,3,Bed Number 3,18,6,12
2008-03-16,1,Bed Number 1,98,69,29
2008-03-16,2,Bed Number 2,49,35,14
2008-03-16,3,Bed Number 3,22,21,1
2008-03-17,1,Bed Number 1,74,5,69
2008-03-17,2,Bed Number 2,10,9,1
2008-03-17,3,Bed Number 3,98,98,0
2008-03-18,1,Bed Number 1,24,0,24
2008-03-18,2,Bed Number 2,52,19,33
2008-03-18,3,Bed Number 3,66,13,53
2008-03-19,1,Bed Number 1,22,7,15
2008-03-19,2,Bed Number 2,79,79,0
2008-03-19,3,Bed Number 3,74,35,39
2008-03-20,1,Bed Number 1,93,12,81
2008-03-20,2,Bed Number 2,95,32,63
2008-03-20,3,Bed Number 3,21,2,19
2008-03-21,1,Bed Number 1,74,64,10
2008-03-21,2,Bed Number 2,44,8,36
2008-03-21,3,Bed Number 3,12,7,5
2008-03-22,1,Bed Number 1,56,50,6
2008-03-22,2,Bed Number 2,68,65,3
2008-03-22,3,Bed Number 3,68,13,55
2008-03-23,1,Bed Number 1,93,61,32
2008-03-23,2,Bed Number 2,51,12,39
2008-03-23,3,Bed Number 3,68,59,9
2008-03-24,1,Bed Number 1,53,6,47
2008-03-24,2,Bed Number 2,96,26,70
2008-03-24,3,Bed Number 3,13,6,7
2008-03-25,1,Bed Number 1,90,80,10
2008-03-25,2,Bed Number 2,63,45,18
2008-03-25,3,Bed Number 3,48,38,10
2008-03-26,1,Bed Number 1,68,66,2
2008-03-26,2,Bed Number 2,65,40,25
2008-03-26,3,Bed Number 3,88,45,43
2008-03-27,1,Bed Number 1,93,39,54
2008-03-27,2,Bed Number 2,69,63,6
2008-03-27,3,Bed Number 3,74,22,52
2008-03-28,1,Bed Number 1,66,33,33
2008-03-28,2,Bed Number 2,92,63,29
2008-03-28,3,Bed Number 3,43,37,6
2008-03-29,1,Bed Number 1,44,27,17
2008-03-29,2,Bed Number 2,10,6,4
2008-03-29,3,Bed Number 3,58,38,20
2008-03-30,1,Bed Number 1,36,9,27
2008-03-30,2,Bed Number 2,57,0,57
2008-03-30,3,Bed Number 3,15,7,8
2008-03-31,1,Bed Number 1,16,10,6
2008-03-31,2,Bed Number 2,14,10,4
2008-03-31,3,Bed Number 3,47,46,1
2008-04-01,1,Bed Number 1,59,6,53
2008-04-01,2,Bed Number 2,89,4,85
2008-04-01,3,Bed Number 3,55,26,29
2008-04-02,1,Bed Number 1,21,9,12
2008-04-02,2,Bed Number 2,31,15,16
2008-04-02,3,Bed Number 3,85,78,7
2008-04-03,1,Bed Number 1,72,27,45
2008-04-03,2,Bed Number 2,31,31,0
2008-04-03,3,Bed Number 3,57,4,53
2008-04-04,1,Bed Number 1,14,10,4
2008-04-04,2,Bed Number 2,98,37,61
2008-04-04,3,Bed Number 3,91,2,89
2008-04-05,1,Bed Number 1,17,12,5
2008-04-05,2,Bed Number 2,80,29,51
2008-04-05,3,Bed Number 3,91,4,87
2008-04-06,1,Bed Number 1,33,4,29
2008-04-06,2,Bed Number 2,86,81,5
2008-04-06,3,Bed Number 3,49,42,7
2008-04-07,1,Bed Number 1,85,2,83
2008-04-07,2,Bed Number 2,68,56,12
2008-04-07,3,Bed Number 3,11,1,10
2008-04-08,1,Bed Number 1,70,10,60
2008-04-08,2,Bed Number 2,98,7,91
2008-04-08,3,Bed Number 3,53,19,34
2008-04-09,1,Bed Number 1,10,6,4
2008-04-09,2,Bed Number 2,79,17,62
2008-04-09,3,Bed Number 3,56,13,43
2008-04-10,1,Bed Number 1,47,23,24
2008-04-10,2,Bed Number 2,54,1,53
2008-04-10,3,Bed Number 3,78,42,36
2008-04-11,1,Bed Number 1,36,5,31
2008-04-11,2,Bed Number 2,97,77,20
2008-04-11,3,Bed Number 3,39,24,15
2008-04-12,1,Bed Number 1,73,23,50
2008-04-12,2,Bed Number 2,46,10,36
2008-04-12,3,Bed Number 3,58,12,46
2008-04-13,1,Bed Number 1,89,14,75
2008-04-13,2,Bed Number 2,18,8,10
2008-04-13,3,Bed Number 3,69,61,8
2008-04-14,1,Bed Number 1,51,46,5
2008-04-14,2,Bed Number 2,88,55,33
2008-04-14,3,Bed Number 3,73,26,47
2008-04-15,1,Bed Number 1,73,72,1
2008-04-15,2,Bed Number 2,92,57,35
2008-04-15,3,Bed Number 3,44,38,6
2008-04-16,1,Bed Number 1,69,11,58
2008-04-16,2,Bed Number 2,26,26,0
2008-04-16,3,Bed Number 3,86,49,37
2008-04-17,1,Bed Number 1,93,50,43
2008-04-17,2,Bed Number 2,79,48,31
2008-04-17,3,Bed Number 3,48,47,1
2008-04-18,1,Bed Number 1,39,33,6
2008-04-18,2,Bed Number 2,59,24,35
2008-04-18,3,Bed Number 3,34,28,6
2008-04-19,1,Bed Number 1,46,42,4
2008-04-19,2,Bed Number 2,91,56,35
2008-04-19,3,Bed Number 3,59,15,44
2008-04-20,1,Bed Number 1,93,54,39
2008-04-20,2,Bed Number 2,34,6,28
2008-04-20,3,Bed Number 3,68,52,16
2008-04-21,1,Bed Number 1,43,26,17
2008-04-21,2,Bed Number 2,30,6,24
2008-04-21,3,Bed Number 3,63,47,16
2008-04-22,1,Bed Number 1,65,41,24
2008-04-22,2,Bed Number 2,19,9,10
2008-04-22,3,Bed Number 3,95,80,15
2008-04-23,1,Bed Number 1,37,24,13
2008-04-23,2,Bed Number 2,63,5,58
2008-04-23,3,Bed Number 3,83,60,23
2008-04-24,1,Bed Number 1,30,12,18
2008-04-24,2,Bed Number 2,73,41,32
2008-04-24,3,Bed Number 3,33,2,31
2008-04-25,1,Bed Number 1,94,93,1
2008-04-25,2,Bed Number 2,10,10,0
2008-04-25,3,Bed Number 3,17,12,5
2008-04-26,1,Bed Number 1,40,12,28
2008-04-26,2,Bed Number 2,63,27,36
2008-04-26,3,Bed Number 3,60,39,21
2008-04-27,1,Bed Number 1,78,43,35
2008-04-27,2,Bed Number 2,100,9,91
2008-04-27,3,Bed Number 3,85,24,61
2008-04-28,1,Bed Number 1,87,62,25
2008-04-28,2,Bed Number 2,58,29,29
2008-04-28,3,Bed Number 3,93,38,55
2008-04-29,1,Bed Number 1,17,7,10
2008-04-29,2,Bed Number 2,49,10,39
2008-04-29,3,Bed Number 3,47,35,12
2008-04-30,1,Bed Number 1,68,51,17
2008-04-30,2,Bed Number 2,91,59,32
2008-04-30,3,Bed Number 3,38,10,28
2008-05-01,1,Bed Number 1,89,11,78
2008-05-01,2,Bed Number 2,11,10,1
2008-05-01,3,Bed Number 3,97,81,16
2008-05-02,1,Bed Number 1,70,20,50
2008-05-02,2,Bed Number 2,31,14,17
2008-05-02,3,Bed Number 3,75,18,57
2008-05-03,1,Bed Number 1,47,34,13
2008-05-03,2,Bed Number 2,53,36,17
2008-05-03,3,Bed Number 3,19,7,12
2008-05-04,1,Bed Number 1,28,14,14
2008-05-04,2,Bed Number 2,25,23,2
2008-05-04,3,Bed Number 3,52,2,50
2008-05-05,1,Bed Number 1,65,61,4
2008-05-05,2,Bed Number 2,23,17,6
2008-05-05,3,Bed Number 3,87,75,12
2008-05-06,1,Bed Number 1,52,37,15
2008-05-06,2,Bed Number 2,36,24,12
2008-05-06,3,Bed Number 3,35,32,3
2008-05-07,1,Bed Number 1,35,5,30
2008-05-07,2,Bed Number 2,47,38,9
2008-05-07,3,Bed Number 3,86,19,67
2008-05-08,1,Bed Number 1,98,33,65
2008-05-08,2,Bed Number 2,51,39,12
2008-05-08,3,Bed Number 3,29,16,13
2008-05-09,1,Bed Number 1,26,5,21
2008-05-09,2,Bed Number 2,79,21,58
2008-05-09,3,Bed Number 3,38,24,14
2008-05-10,1,Bed Number 1,39,4,35
2008-05-10,2,Bed Number 2,22,5,17
2008-05-10,3,Bed Number 3,53,1,52
2008-05-11,1,Bed Number 1,21,18,3
2008-05-11,2,Bed Number 2,51,10,41
2008-05-11,3,Bed Number 3,84,10,74
2008-05-12,1,Bed Number 1,56,42,14
2008-05-12,2,Bed Number 2,58,1,57
2008-05-12,3,Bed Number 3,23,13,10
2008-05-13,1,Bed Number 1,17,14,3
2008-05-13,2,Bed Number 2,78,31,47
2008-05-13,3,Bed Number 3,97,32,65
2008-05-14,1,Bed Number 1,58,44,14
2008-05-14,2,Bed Number 2,12,11,1
2008-05-14,3,Bed Number 3,46,27,19
2008-05-15,1,Bed Number 1,79,7,72
2008-05-15,2,Bed Number 2,26,11,15
2008-05-15,3,Bed Number 3,64,18,46
2008-05-16,1,Bed Number 1,22,4,18
2008-05-16,2,Bed Number 2,24,20,4
2008-05-16,3,Bed Number 3,36,34,2
2008-05-17,1,Bed Number 1,14,11,3
2008-05-17,2,Bed Number 2,96,8,88
2008-05-17,3,Bed Number 3,39,15,24
2008-05-18,1,Bed Number 1,17,1,16
2008-05-18,2,Bed Number 2,60,12,48
2008-05-18,3,Bed Number 3,96,14,82
2008-05-19,1,Bed Number 1,47,39,8
2008-05-19,2,Bed Number 2,23,6,17
2008-05-19,3,Bed Number 3,94,88,6
2008-05-20,1,Bed Number 1,71,26,45
2008-05-20,2,Bed Number 2,63,43,20
2008-05-20,3,Bed Number 3,48,28,20
2008-05-21,1,Bed Number 1,55,21,34
2008-05-21,2,Bed Number 2,12,8,4
2008-05-21,3,Bed Number 3,10,2,8
2008-05-22,1,Bed Number 1,35,10,25
2008-05-22,2,Bed Number 2,85,24,61
2008-05-22,3,Bed Number 3,94,39,55
2008-05-23,1,Bed Number 1,86,8,78
2008-05-23,2,Bed Number 2,61,25,36
2008-05-23,3,Bed Number 3,40,12,28
2008-05-24,1,Bed Number 1,94,11,83
2008-05-24,2,Bed Number 2,56,10,46
2008-05-24,3,Bed Number 3,15,0,15
2008-05-25,1,Bed Number 1,17,13,4
2008-05-25,2,Bed Number 2,33,12,21
2008-05-25,3,Bed Number 3,60,60,0
2008-05-26,1,Bed Number 1,53,44,9
2008-05-26,2,Bed Number 2,77,74,3
2008-05-26,3,Bed Number 3,28,19,9
2008-05-27,1,Bed Number 1,16,9,7
2008-05-27,2,Bed Number 2,36,7,29
2008-05-27,3,Bed Number 3,75,10,65
2008-05-28,1,Bed Number 1,76,64,12
2008-05-28,2,Bed Number 2,56,11,45
2008-05-28,3,Bed Number 3,66,15,51
2008-05-29,1,Bed Number 1,84,28,56
2008-05-29,2,Bed Number 2,62,60,2
2008-05-29,3,Bed Number 3,43,42,1
2008-05-30,1,Bed Number 1,15,4,11
2008-05-30,2,Bed Number 2,87,4,83
2008-05-30,3,Bed Number 3,45,4,41
2008-05-31,1,Bed Number 1,32,27,5
2008-05-31,2,Bed Number 2,74,11,63
2008-05-31,3,Bed Number 3,29,19,10
2008-06-01,1,Bed Number 1,30,12,18
2008-06-01,2,Bed Number 2,38,32,6
2008-06-01,3,Bed Number 3,40,12,28
2008-06-02,1,Bed Number 1,31,31,0
2008-06-02,2,Bed Number 2,99,8,91
2008-06-02,3,Bed Number 3,86,0,86
2008-06-03,1,Bed Number 1,59,51,8
2008-06-03,2,Bed Number 2,35,10,25
2008-06-03,3,Bed Number 3,86,18,68
2008-06-04,1,Bed Number 1,72,72,0
2008-06-04,2,Bed Number 2,100,90,10
2008-06-04,3,Bed Number 3,31,22,9
2008-06-05,1,Bed Number 1,55,22,33
2008-06-05,2,Bed Number 2,81,67,14
2008-06-05,3,Bed Number 3,68,29,39
2008-06-06,1,Bed Number 1,36,5,31
2008-06-06,2,Bed Number 2,78,59,19
2008-06-06,3,Bed Number 3,60,34,26
2008-06-07,1,Bed Number 1,49,43,6
2008-06-07,2,Bed Number 2,33,16,17
2008-06-07,3,Bed Number 3,38,0,38
2008-06-08,1,Bed Number 1,63,13,50
2008-06-08,2,Bed Number 2,31,25,6
2008-06-08,3,Bed Number 3,72,58,14
2008-06-09,1,Bed Number 1,22,18,4
2008-06-09,2,Bed Number 2,39,31,8
2008-06-09,3,Bed Number 3,61,27,34
2008-06-10,1,Bed Number 1,31,11,20
2008-06-10,2,Bed Number 2,14,3,11
2008-06-10,3,Bed Number 3,61,27,34
2008-06-11,1,Bed Number 1,63,63,0
2008-06-11,2,Bed Number 2,30,13,17
2008-06-11,3,Bed Number 3,12,4,8
2008-06-12,1,Bed Number 1,55,9,46
2008-06-12,2,Bed Number 2,24,2,22
2008-06-12,3,Bed Number 3,75,25,50
2008-06-13,1,Bed Number 1,69,11,58
2008-06-13,2,Bed Number 2,88,42,46
2008-06-13,3,Bed Number 3,60,23,37
2008-06-14,1,Bed Number 1,41,20,21
2008-06-14,2,Bed Number 2,82,9,73
2008-06-14,3,Bed Number 3,11,7,4
2008-06-15,1,Bed Number 1,10,0,10
2008-06-15,2,Bed Number 2,60,51,9
2008-06-15,3,Bed Number 3,66,3,63
2008-06-16,1,Bed Number 1,47,2,45
2008-06-16,2,Bed Number 2,95,35,60
2008-06-16,3,Bed Number 3,40,39,1
2008-06-17,1,Bed Number 1,78,45,33
2008-06-17,2,Bed Number 2,82,23,59
2008-06-17,3,Bed Number 3,69,52,17
2008-06-18,1,Bed Number 1,59,51,8
2008-06-18,2,Bed Number 2,27,17,10
2008-06-18,3,Bed Number 3,24,8,16
2008-06-19,1,Bed Number 1,94,27,67
2008-06-19,2,Bed Number 2,49,14,35
2008-06-19,3,Bed Number 3,96,63,33
2008-06-20,1,Bed Number 1,12,3,9
2008-06-20,2,Bed Number 2,46,37,9
2008-06-20,3,Bed Number 3,62,44,18
2008-06-21,1,Bed Number 1,39,31,8
2008-06-21,2,Bed Number 2,87,19,68
2008-06-21,3,Bed Number 3,41,33,8
2008-06-22,1,Bed Number 1,85,20,65
2008-06-22,2,Bed Number 2,80,68,12
2008-06-22,3,Bed Number 3,90,11,79
2008-06-23,1,Bed Number 1,16,3,13
2008-06-23,2,Bed Number 2,61,23,38
2008-06-23,3,Bed Number 3,91,18,73
2008-06-24,1,Bed Number 1,19,12,7
2008-06-24,2,Bed Number 2,85,44,41
2008-06-24,3,Bed Number 3,79,23,56
2008-06-25,1,Bed Number 1,14,7,7
2008-06-25,2,Bed Number 2,70,37,33
2008-06-25,3,Bed Number 3,65,46,19
2008-06-26,1,Bed Number 1,59,26,33
2008-06-26,2,Bed Number 2,56,3,53
2008-06-26,3,Bed Number 3,54,10,44
2008-06-27,1,Bed Number 1,39,35,4
2008-06-27,2,Bed Number 2,33,2,31
2008-06-27,3,Bed Number 3,31,23,8
2008-06-28,1,Bed Number 1,82,52,30
2008-06-28,2,Bed Number 2,98,86,12
2008-06-28,3,Bed Number 3,22,2,20
2008-06-29,1,Bed Number 1,59,42,17
2008-06-29,2,Bed Number 2,100,62,38
2008-06-29,3,Bed Number 3,53,51,2
2008-06-30,1,Bed Number 1,30,25,5
2008-06-30,2,Bed Number 2,48,1,47
2008-06-30,3,Bed Number 3,60,60,0
2008-07-01,1,Bed Number 1,10,9,1
2008-07-01,2,Bed Number 2,22,16,6
2008-07-01,3,Bed Number 3,12,2,10
2008-07-02,1,Bed Number 1,40,13,27
2008-07-02,2,Bed Number 2,24,21,3
2008-07-02,3,Bed Number 3,81,80,1
2008-07-03,1,Bed Number 1,64,47,17
2008-07-03,2,Bed Number 2,23,22,1
2008-07-03,3,Bed Number 3,80,60,20
2008-07-04,1,Bed Number 1,69,44,25
2008-07-04,2,Bed Number 2,55,50,5
2008-07-04,3,Bed Number 3,71,62,9
2008-07-05,1,Bed Number 1,58,47,11
2008-07-05,2,Bed Number 2,62,54,8
2008-07-05,3,Bed Number 3,32,24,8
2008-07-06,1,Bed Number 1,76,48,28
2008-07-06,2,Bed Number 2,63,54,9
2008-07-06,3,Bed Number 3,48,6,42
2008-07-07,1,Bed Number 1,29,21,8
2008-07-07,2,Bed Number 2,64,9,55
2008-07-07,3,Bed Number 3,51,16,35
2008-07-08,1,Bed Number 1,14,13,1
2008-07-08,2,Bed Number 2,46,0,46
2008-07-08,3,Bed Number 3,86,71,15
2008-07-09,1,Bed Number 1,66,4,62
2008-07-09,2,Bed Number 2,81,34,47
2008-07-09,3,Bed Number 3,71,37,34
2008-07-10,1,Bed Number 1,76,68,8
2008-07-10,2,Bed Number 2,77,77,0
2008-07-10,3,Bed Number 3,21,3,18
2008-07-11,1,Bed Number 1,12,0,12
2008-07-11,2,Bed Number 2,45,33,12
2008-07-11,3,Bed Number 3,72,71,1
2008-07-12,1,Bed Number 1,35,6,29
2008-07-12,2,Bed Number 2,16,1,15
2008-07-12,3,Bed Number 3,22,20,2
2008-07-13,1,Bed Number 1,46,46,0
2008-07-13,2,Bed Number 2,64,17,47
2008-07-13,3,Bed Number 3,62,12,50
2008-07-14,1,Bed Number 1,72,8,64
2008-07-14,2,Bed Number 2,11,10,1
2008-07-14,3,Bed Number 3,89,60,29
2008-07-15,1,Bed Number 1,26,15,11
2008-07-15,2,Bed Number 2,71,6,65
2008-07-15,3,Bed Number 3,28,22,6
2008-07-16,1,Bed Number 1,90,50,40
2008-07-16,2,Bed Number 2,16,6,10
2008-07-16,3,Bed Number 3,81,37,44
2008-07-17,1,Bed Number 1,74,14,60
2008-07-17,2,Bed Number 2,71,31,40
2008-07-17,3,Bed Number 3,92,16,76
2008-07-18,1,Bed Number 1,81,14,67
2008-07-18,2,Bed Number 2,39,33,6
2008-07-18,3,Bed Number 3,26,7,19
2008-07-19,1,Bed Number 1,13,10,3
2008-07-19,2,Bed Number 2,78,52,26
2008-07-19,3,Bed Number 3,11,1,10
2008-07-20,1,Bed Number 1,75,8,67
2008-07-20,2,Bed Number 2,27,10,17
2008-07-20,3,Bed Number 3,82,17,65
2008-07-21,1,Bed Number 1,72,22,50
2008-07-21,2,Bed Number 2,60,17,43
2008-07-21,3,Bed Number 3,95,9,86
2008-07-22,1,Bed Number 1,91,52,39
2008-07-22,2,Bed Number 2,74,44,30
2008-07-22,3,Bed Number 3,99,16,83
2008-07-23,1,Bed Number 1,57,48,9
2008-07-23,2,Bed Number 2,100,2,98
2008-07-23,3,Bed Number 3,86,65,21
2008-07-24,1,Bed Number 1,72,12,60
2008-07-24,2,Bed Number 2,85,74,11
2008-07-24,3,Bed Number 3,89,15,74
2008-07-25,1,Bed Number 1,93,25,68
2008-07-25,2,Bed Number 2,89,42,47
2008-07-25,3,Bed Number 3,38,15,23
2008-07-26,1,Bed Number 1,53,39,14
2008-07-26,2,Bed Number 2,66,48,18
2008-07-26,3,Bed Number 3,100,84,16
2008-07-27,1,Bed Number 1,47,10,37
2008-07-27,2,Bed Number 2,65,64,1
2008-07-27,3,Bed Number 3,50,43,7
2008-07-28,1,Bed Number 1,72,40,32
2008-07-28,2,Bed Number 2,12,5,7
2008-07-28,3,Bed Number 3,24,11,13
2008-07-29,1,Bed Number 1,13,4,9
2008-07-29,2,Bed Number 2,32,19,13
2008-07-29,3,Bed Number 3,61,39,22
2008-07-30,1,Bed Number 1,56,0,56
2008-07-30,2,Bed Number 2,96,48,48
2008-07-30,3,Bed Number 3,99,7,92
2008-07-31,1,Bed Number 1,59,25,34
2008-07-31,2,Bed Number 2,30,9,21
2008-07-31,3,Bed Number 3,11,8,3
2008-08-01,1,Bed Number 1,65,30,35
2008-08-01,2,Bed Number 2,47,32,15
2008-08-01,3,Bed Number 3,17,3,14
2008-08-02,1,Bed Number 1,56,25,31
2008-08-02,2,Bed Number 2,47,11,36
2008-08-02,3,Bed Number 3,40,15,25
2008-08-03,1,Bed Number 1,77,73,4
2008-08-03,2,Bed Number 2,78,72,6
2008-08-03,3,Bed Number 3,55,37,18
2008-08-04,1,Bed Number 1,59,32,27
2008-08-04,2,Bed Number 2,95,91,4
2008-08-04,3,Bed Number 3,49,23,26
2008-08-05,1,Bed Number 1,26,19,7
2008-08-05,2,Bed Number 2,23,10,13
2008-08-05,3,Bed Number 3,18,9,9
2008-08-06,1,Bed Number 1,81,29,52
2008-08-06,2,Bed Number 2,72,56,16
2008-08-06,3,Bed Number 3,53,4,49
2008-08-07,1,Bed Number 1,43,9,34
2008-08-07,2,Bed Number 2,73,73,0
2008-08-07,3,Bed Number 3,98,95,3
2008-08-08,1,Bed Number 1,78,47,31
2008-08-08,2,Bed Number 2,12,5,7
2008-08-08,3,Bed Number 3,20,20,0
2008-08-09,1,Bed Number 1,63,32,31
2008-08-09,2,Bed Number 2,25,17,8
2008-08-09,3,Bed Number 3,98,1,97
2008-08-10,1,Bed Number 1,50,30,20
2008-08-10,2,Bed Number 2,30,18,12
2008-08-10,3,Bed Number 3,89,81,8
2008-08-11,1,Bed Number 1,15,1,14
2008-08-11,2,Bed Number 2,34,28,6
2008-08-11,3,Bed Number 3,16,12,4
2008-08-12,1,Bed Number 1,69,37,32
2008-08-12,2,Bed Number 2,40,23,17
2008-08-12,3,Bed Number 3,50,9,41
2008-08-13,1,Bed Number 1,17,3,14
2008-08-13,2,Bed Number 2,58,36,22
2008-08-13,3,Bed Number 3,56,17,39
2008-08-14,1,Bed Number 1,81,22,59
2008-08-14,2,Bed Number 2,93,30,63
2008-08-14,3,Bed Number 3,54,13,41
2008-08-15,1,Bed Number 1,76,45,31
2008-08-15,2,Bed Number 2,62,37,25
2008-08-15,3,Bed Number 3,82,72,10
2008-08-16,1,Bed Number 1,47,7,40
2008-08-16,2,Bed Number 2,24,8,16
2008-08-16,3,Bed Number 3,27,4,23
2008-08-17,1,Bed Number 1,54,16,38
2008-08-17,2,Bed Number 2,87,64,23
2008-08-17,3,Bed Number 3,27,1,26
2008-08-18,1,Bed Number 1,52,29,23
2008-08-18,2,Bed Number 2,73,24,49
2008-08-18,3,Bed Number 3,42,20,22
2008-08-19,1,Bed Number 1,30,21,9
2008-08-19,2,Bed Number 2,11,10,1
2008-08-19,3,Bed Number 3,80,69,11
2008-08-20,1,Bed Number 1,24,10,14
2008-08-20,2,Bed Number 2,82,82,0
2008-08-20,3,Bed Number 3,45,35,10
2008-08-21,1,Bed Number 1,75,59,16
2008-08-21,2,Bed Number 2,79,39,40
2008-08-21,3,Bed Number 3,76,30,46
2008-08-22,1,Bed Number 1,51,4,47
2008-08-22,2,Bed Number 2,51,33,18
2008-08-22,3,Bed Number 3,81,9,72
2008-08-23,1,Bed Number 1,56,23,33
2008-08-23,2,Bed Number 2,32,32,0
2008-08-23,3,Bed Number 3,66,50,16
2008-08-24,1,Bed Number 1,53,25,28
2008-08-24,2,Bed Number 2,11,8,3
2008-08-24,3,Bed Number 3,31,2,29
2008-08-25,1,Bed Number 1,52,35,17
2008-08-25,2,Bed Number 2,100,75,25
2008-08-25,3,Bed Number 3,33,8,25
2008-08-26,1,Bed Number 1,14,0,14
2008-08-26,2,Bed Number 2,27,23,4
2008-08-26,3,Bed Number 3,45,37,8
2008-08-27,1,Bed Number 1,18,15,3
2008-08-27,2,Bed Number 2,25,14,11
2008-08-27,3,Bed Number 3,73,35,38
2008-08-28,1,Bed Number 1,88,57,31
2008-08-28,2,Bed Number 2,32,18,14
2008-08-28,3,Bed Number 3,63,4,59
2008-08-29,1,Bed Number 1,72,41,31
2008-08-29,2,Bed Number 2,17,0,17
2008-08-29,3,Bed Number 3,36,23,13
2008-08-30,1,Bed Number 1,39,21,18
2008-08-30,2,Bed Number 2,15,10,5
2008-08-30,3,Bed Number 3,93,84,9
2008-08-31,1,Bed Number 1,14,13,1
2008-08-31,2,Bed Number 2,97,25,72
2008-08-31,3,Bed Number 3,14,6,8
2008-09-01,1,Bed Number 1,43,7,36
2008-09-01,2,Bed Number 2,52,33,19
2008-09-01,3,Bed Number 3,95,92,3
2008-09-02,1,Bed Number 1,16,15,1
2008-09-02,2,Bed Number 2,45,34,11
2008-09-02,3,Bed Number 3,52,35,17
2008-09-03,1,Bed Number 1,99,62,37
2008-09-03,2,Bed Number 2,92,58,34
2008-09-03,3,Bed Number 3,32,0,32
2008-09-04,1,Bed Number 1,71,26,45
2008-09-04,2,Bed Number 2,36,19,17
2008-09-04,3,Bed Number 3,48,29,19
2008-09-05,1,Bed Number 1,95,34,61
2008-09-05,2,Bed Number 2,21,1,20
2008-09-05,3,Bed Number 3,59,22,37
2008-09-06,1,Bed Number 1,93,35,58
2008-09-06,2,Bed Number 2,40,26,14
2008-09-06,3,Bed Number 3,17,7,10
2008-09-07,1,Bed Number 1,26,10,16
2008-09-07,2,Bed Number 2,85,11,74
2008-09-07,3,Bed Number 3,59,4,55
2008-09-08,1,Bed Number 1,90,41,49
2008-09-08,2,Bed Number 2,82,50,32
2008-09-08,3,Bed Number 3,21,1,20
2008-09-09,1,Bed Number 1,75,28,47
2008-09-09,2,Bed Number 2,51,28,23
2008-09-09,3,Bed Number 3,50,36,14
2008-09-10,1,Bed Number 1,55,44,11
2008-09-10,2,Bed Number 2,43,43,0
2008-09-10,3,Bed Number 3,66,11,55
2008-09-11,1,Bed Number 1,19,18,1
2008-09-11,2,Bed Number 2,50,8,42
2008-09-11,3,Bed Number 3,60,36,24
2008-09-12,1,Bed Number 1,26,8,18
2008-09-12,2,Bed Number 2,62,29,33
2008-09-12,3,Bed Number 3,13,1,12
2008-09-13,1,Bed Number 1,34,6,28
2008-09-13,2,Bed Number 2,71,26,45
2008-09-13,3,Bed Number 3,66,47,19
2008-09-14,1,Bed Number 1,12,8,4
2008-09-14,2,Bed Number 2,27,6,21
2008-09-14,3,Bed Number 3,61,39,22
2008-09-15,1,Bed Number 1,88,8,80
2008-09-15,2,Bed Number 2,31,28,3
2008-09-15,3,Bed Number 3,73,4,69
2008-09-16,1,Bed Number 1,13,13,0
2008-09-16,2,Bed Number 2,29,11,18
2008-09-16,3,Bed Number 3,76,44,32
2008-09-17,1,Bed Number 1,36,5,31
2008-09-17,2,Bed Number 2,70,31,39
2008-09-17,3,Bed Number 3,15,3,12
2008-09-18,1,Bed Number 1,81,21,60
2008-09-18,2,Bed Number 2,45,28,17
2008-09-18,3,Bed Number 3,89,48,41
2008-09-19,1,Bed Number 1,69,2,67
2008-09-19,2,Bed Number 2,20,6,14
2008-09-19,3,Bed Number 3,28,1,27
2008-09-20,1,Bed Number 1,47,12,35
2008-09-20,2,Bed Number 2,82,11,71
2008-09-20,3,Bed Number 3,25,10,15
2008-09-21,1,Bed Number 1,66,15,51
2008-09-21,2,Bed Number 2,24,7,17
2008-09-21,3,Bed Number 3,68,59,9
2008-09-22,1,Bed Number 1,11,5,6
2008-09-22,2,Bed Number 2,79,23,56
2008-09-22,3,Bed Number 3,32,15,17
2008-09-23,1,Bed Number 1,59,59,0
2008-09-23,2,Bed Number 2,63,46,17
2008-09-23,3,Bed Number 3,98,73,25
2008-09-24,1,Bed Number 1,25,22,3
2008-09-24,2,Bed Number 2,36,15,21
2008-09-24,3,Bed Number 3,87,30,57
2008-09-25,1,Bed Number 1,76,38,38
2008-09-25,2,Bed Number 2,22,21,1
2008-09-25,3,Bed Number 3,51,49,2
2008-09-26,1,Bed Number 1,11,11,0
2008-09-26,2,Bed Number 2,35,12,23
2008-09-26,3,Bed Number 3,78,32,46
2008-09-27,1,Bed Number 1,91,46,45
2008-09-27,2,Bed Number 2,47,37,10
2008-09-27,3,Bed Number 3,89,66,23
2008-09-28,1,Bed Number 1,71,64,7
2008-09-28,2,Bed Number 2,55,30,25
2008-09-28,3,Bed Number 3,67,12,55
2008-09-29,1,Bed Number 1,100,39,61
2008-09-29,2,Bed Number 2,18,9,9
2008-09-29,3,Bed Number 3,19,10,9
2008-09-30,1,Bed Number 1,59,23,36
2008-09-30,2,Bed Number 2,64,16,48
2008-09-30,3,Bed Number 3,30,6,24
2008-10-01,1,Bed Number 1,40,21,19
2008-10-01,2,Bed Number 2,49,3,46
2008-10-01,3,Bed Number 3,84,43,41
2008-10-02,1,Bed Number 1,64,52,12
2008-10-02,2,Bed Number 2,47,13,34
2008-10-02,3,Bed Number 3,29,24,5
2008-10-03,1,Bed Number 1,39,3,36
2008-10-03,2,Bed Number 2,67,28,39
2008-10-03,3,Bed Number 3,27,24,3
2008-10-04,1,Bed Number 1,75,14,61
2008-10-04,2,Bed Number 2,31,5,26
2008-10-04,3,Bed Number 3,65,2,63
2008-10-05,1,Bed Number 1,60,52,8
2008-10-05,2,Bed Number 2,85,5,80
2008-10-05,3,Bed Number 3,42,2,40
2008-10-06,1,Bed Number 1,66,10,56
2008-10-06,2,Bed Number 2,30,5,25
2008-10-06,3,Bed Number 3,52,0,52
2008-10-07,1,Bed Number 1,60,4,56
2008-10-07,2,Bed Number 2,46,21,25
2008-10-07,3,Bed Number 3,49,12,37
2008-10-08,1,Bed Number 1,78,38,40
2008-10-08,2,Bed Number 2,39,6,33
2008-10-08,3,Bed Number 3,38,33,5
2008-10-09,1,Bed Number 1,77,72,5
2008-10-09,2,Bed Number 2,51,10,41
2008-10-09,3,Bed Number 3,35,16,19
2008-10-10,1,Bed Number 1,23,18,5
2008-10-10,2,Bed Number 2,61,9,52
2008-10-10,3,Bed Number 3,46,2,44
2008-10-11,1,Bed Number 1,78,24,54
2008-10-11,2,Bed Number 2,95,64,31
2008-10-11,3,Bed Number 3,58,25,33
2008-10-12,1,Bed Number 1,27,2,25
2008-10-12,2,Bed Number 2,60,6,54
2008-10-12,3,Bed Number 3,56,29,27
2008-10-13,1,Bed Number 1,18,8,10
2008-10-13,2,Bed Number 2,73,21,52
2008-10-13,3,Bed Number 3,15,7,8
2008-10-14,1,Bed Number 1,58,18,40
2008-10-14,2,Bed Number 2,71,47,24
2008-10-14,3,Bed Number 3,18,7,11
2008-10-15,1,Bed Number 1,86,70,16
2008-10-15,2,Bed Number 2,16,3,13
2008-10-15,3,Bed Number 3,95,83,12
2008-10-16,1,Bed Number 1,10,9,1
2008-10-16,2,Bed Number 2,77,27,50
2008-10-16,3,Bed Number 3,50,11,39
2008-10-17,1,Bed Number 1,65,28,37
2008-10-17,2,Bed Number 2,27,8,19
2008-10-17,3,Bed Number 3,92,73,19
2008-10-18,1,Bed Number 1,28,22,6
2008-10-18,2,Bed Number 2,76,1,75
2008-10-18,3,Bed Number 3,40,1,39
2008-10-19,1,Bed Number 1,77,39,38
2008-10-19,2,Bed Number 2,19,17,2
2008-10-19,3,Bed Number 3,35,28,7
2008-10-20,1,Bed Number 1,82,20,62
2008-10-20,2,Bed Number 2,86,17,69
2008-10-20,3,Bed Number 3,66,45,21
2008-10-21,1,Bed Number 1,74,50,24
2008-10-21,2,Bed Number 2,43,32,11
2008-10-21,3,Bed Number 3,33,24,9
2008-10-22,1,Bed Number 1,95,41,54
2008-10-22,2,Bed Number 2,17,14,3
2008-10-22,3,Bed Number 3,26,13,13
2008-10-23,1,Bed Number 1,61,58,3
2008-10-23,2,Bed Number 2,65,13,52
2008-10-23,3,Bed Number 3,98,49,49
2008-10-24,1,Bed Number 1,93,32,61
2008-10-24,2,Bed Number 2,13,4,9
2008-10-24,3,Bed Number 3,81,70,11
2008-10-25,1,Bed Number 1,15,12,3
2008-10-25,2,Bed Number 2,44,41,3
2008-10-25,3,Bed Number 3,61,21,40
2008-10-26,1,Bed Number 1,43,38,5
2008-10-26,2,Bed Number 2,83,22,61
2008-10-26,3,Bed Number 3,16,16,0
2008-10-27,1,Bed Number 1,57,11,46
2008-10-27,2,Bed Number 2,28,21,7
2008-10-27,3,Bed Number 3,33,4,29
2008-10-28,1,Bed Number 1,23,23,0
2008-10-28,2,Bed Number 2,47,37,10
2008-10-28,3,Bed Number 3,63,16,47
2008-10-29,1,Bed Number 1,17,14,3
2008-10-29,2,Bed Number 2,49,39,10
2008-10-29,3,Bed Number 3,71,3,68
2008-10-30,1,Bed Number 1,92,75,17
2008-10-30,2,Bed Number 2,85,42,43
2008-10-30,3,Bed Number 3,14,12,2
2008-10-31,1,Bed Number 1,59,6,53
2008-10-31,2,Bed Number 2,52,7,45
2008-10-31,3,Bed Number 3,96,52,44
2008-11-01,1,Bed Number 1,41,5,36
2008-11-01,2,Bed Number 2,45,12,33
2008-11-01,3,Bed Number 3,23,0,23
2008-11-02,1,Bed Number 1,12,0,12
2008-11-02,2,Bed Number 2,44,16,28
2008-11-02,3,Bed Number 3,74,68,6
2008-11-03,1,Bed Number 1,43,15,28
2008-11-03,2,Bed Number 2,69,41,28
2008-11-03,3,Bed Number 3,91,38,53
2008-11-04,1,Bed Number 1,63,23,40
2008-11-04,2,Bed Number 2,84,12,72
2008-11-04,3,Bed Number 3,79,53,26
2008-11-05,1,Bed Number 1,12,6,6
2008-11-05,2,Bed Number 2,32,24,8
2008-11-05,3,Bed Number 3,52,48,4
2008-11-06,1,Bed Number 1,57,44,13
2008-11-06,2,Bed Number 2,49,27,22
2008-11-06,3,Bed Number 3,66,53,13
2008-11-07,1,Bed Number 1,64,36,28
2008-11-07,2,Bed Number 2,32,2,30
2008-11-07,3,Bed Number 3,29,4,25
2008-11-08,1,Bed Number 1,50,40,10
2008-11-08,2,Bed Number 2,18,5,13
2008-11-08,3,Bed Number 3,19,16,3
2008-11-09,1,Bed Number 1,78,35,43
2008-11-09,2,Bed Number 2,100,65,35
2008-11-09,3,Bed Number 3,11,5,6
2008-11-10,1,Bed Number 1,49,44,5
2008-11-10,2,Bed Number 2,76,38,38
2008-11-10,3,Bed Number 3,51,0,51
2008-11-11,1,Bed Number 1,24,10,14
2008-11-11,2,Bed Number 2,26,12,14
2008-11-11,3,Bed Number 3,86,85,1
2008-11-12,1,Bed Number 1,65,5,60
2008-11-12,2,Bed Number 2,12,0,12
2008-11-12,3,Bed Number 3,92,87,5
2008-11-13,1,Bed Number 1,71,58,13
2008-11-13,2,Bed Number 2,72,39,33
2008-11-13,3,Bed Number 3,64,48,16
2008-11-14,1,Bed Number 1,61,14,47
2008-11-14,2,Bed Number 2,29,25,4
2008-11-14,3,Bed Number 3,91,85,6
2008-11-15,1,Bed Number 1,63,4,59
2008-11-15,2,Bed Number 2,78,41,37
2008-11-15,3,Bed Number 3,94,18,76
2008-11-16,1,Bed Number 1,36,23,13
2008-11-16,2,Bed Number 2,71,14,57
2008-11-16,3,Bed Number 3,11,4,7
2008-11-17,1,Bed Number 1,66,47,19
2008-11-17,2,Bed Number 2,82,4,78
2008-11-17,3,Bed Number 3,26,22,4
2008-11-18,1,Bed Number 1,60,54,6
2008-11-18,2,Bed Number 2,55,26,29
2008-11-18,3,Bed Number 3,75,58,17
2008-11-19,1,Bed Number 1,60,34,26
2008-11-19,2,Bed Number 2,25,2,23
2008-11-19,3,Bed Number 3,42,33,9
2008-11-20,1,Bed Number 1,80,10,70
2008-11-20,2,Bed Number 2,20,11,9
2008-11-20,3,Bed Number 3,90,36,54
2008-11-21,1,Bed Number 1,35,3,32
2008-11-21,2,Bed Number 2,60,15,45
2008-11-21,3,Bed Number 3,51,46,5
2008-11-22,1,Bed Number 1,72,46,26
2008-11-22,2,Bed Number 2,70,28,42
2008-11-22,3,Bed Number 3,75,62,13
2008-11-23,1,Bed Number 1,96,94,2
2008-11-23,2,Bed Number 2,53,32,21
2008-11-23,3,Bed Number 3,84,19,65
2008-11-24,1,Bed Number 1,20,0,20
2008-11-24,2,Bed Number 2,77,14,63
2008-11-24,3,Bed Number 3,53,21,32
2008-11-25,1,Bed Number 1,83,11,72
2008-11-25,2,Bed Number 2,38,1,37
2008-11-25,3,Bed Number 3,83,8,75
2008-11-26,1,Bed Number 1,64,55,9
2008-11-26,2,Bed Number 2,59,34,25
2008-11-26,3,Bed Number 3,54,43,11
2008-11-27,1,Bed Number 1,37,21,16
2008-11-27,2,Bed Number 2,93,73,20
2008-11-27,3,Bed Number 3,12,9,3
2008-11-28,1,Bed Number 1,72,57,15
2008-11-28,2,Bed Number 2,59,16,43
2008-11-28,3,Bed Number 3,15,3,12
2008-11-29,1,Bed Number 1,85,61,24
2008-11-29,2,Bed Number 2,88,85,3
2008-11-29,3,Bed Number 3,22,21,1
2008-11-30,1,Bed Number 1,89,76,13
2008-11-30,2,Bed Number 2,36,14,22
2008-11-30,3,Bed Number 3,64,0,64
2008-12-01,1,Bed Number 1,16,2,14
2008-12-01,2,Bed Number 2,60,11,49
2008-12-01,3,Bed Number 3,11,3,8
2008-12-02,1,Bed Number 1,99,88,11
2008-12-02,2,Bed Number 2,85,34,51
2008-12-02,3,Bed Number 3,41,15,26
2008-12-03,1,Bed Number 1,44,3,41
2008-12-03,2,Bed Number 2,34,27,7
2008-12-03,3,Bed Number 3,81,4,77
2008-12-04,1,Bed Number 1,73,60,13
2008-12-04,2,Bed Number 2,77,50,27
2008-12-04,3,Bed Number 3,27,6,21
2008-12-05,1,Bed Number 1,80,9,71
2008-12-05,2,Bed Number 2,33,14,19
2008-12-05,3,Bed Number 3,35,25,10
2008-12-06,1,Bed Number 1,25,1,24
2008-12-06,2,Bed Number 2,15,3,12
2008-12-06,3,Bed Number 3,30,24,6
2008-12-07,1,Bed Number 1,35,15,20
2008-12-07,2,Bed Number 2,12,12,0
2008-12-07,3,Bed Number 3,25,4,21
2008-12-08,1,Bed Number 1,41,13,28
2008-12-08,2,Bed Number 2,47,38,9
2008-12-08,3,Bed Number 3,11,7,4
2008-12-09,1,Bed Number 1,10,9,1
2008-12-09,2,Bed Number 2,21,2,19
2008-12-09,3,Bed Number 3,11,10,1
2008-12-10,1,Bed Number 1,71,36,35
2008-12-10,2,Bed Number 2,68,61,7
2008-12-10,3,Bed Number 3,44,17,27
2008-12-11,1,Bed Number 1,97,67,30
2008-12-11,2,Bed Number 2,56,20,36
2008-12-11,3,Bed Number 3,39,19,20
2008-12-12,1,Bed Number 1,92,2,90
2008-12-12,2,Bed Number 2,80,70,10
2008-12-12,3,Bed Number 3,22,19,3
2008-12-13,1,Bed Number 1,80,4,76
2008-12-13,2,Bed Number 2,71,0,71
2008-12-13,3,Bed Number 3,37,36,1
2008-12-14,1,Bed Number 1,40,29,11
2008-12-14,2,Bed Number 2,76,23,53
2008-12-14,3,Bed Number 3,67,39,28
2008-12-15,1,Bed Number 1,32,7,25
2008-12-15,2,Bed Number 2,80,44,36
2008-12-15,3,Bed Number 3,83,73,10
2008-12-16,1,Bed Number 1,87,23,64
2008-12-16,2,Bed Number 2,85,51,34
2008-12-16,3,Bed Number 3,76,5,71
2008-12-17,1,Bed Number 1,94,18,76
2008-12-17,2,Bed Number 2,35,2,33
2008-12-17,3,Bed Number 3,37,8,29
2008-12-18,1,Bed Number 1,40,3,37
2008-12-18,2,Bed Number 2,61,39,22
2008-12-18,3,Bed Number 3,61,0,61
2008-12-19,1,Bed Number 1,31,15,16
2008-12-19,2,Bed Number 2,80,75,5
2008-12-19,3,Bed Number 3,35,20,15
2008-12-20,1,Bed Number 1,61,43,18
2008-12-20,2,Bed Number 2,74,52,22
2008-12-20,3,Bed Number 3,83,51,32
2008-12-21,1,Bed Number 1,87,0,87
2008-12-21,2,Bed Number 2,56,42,14
2008-12-21,3,Bed Number 3,99,26,73
2008-12-22,1,Bed Number 1,24,3,21
2008-12-22,2,Bed Number 2,46,45,1
2008-12-22,3,Bed Number 3,39,29,10
2008-12-23,1,Bed Number 1,88,49,39
2008-12-23,2,Bed Number 2,44,31,13
2008-12-23,3,Bed Number 3,84,51,33
2008-12-24,1,Bed Number 1,99,53,46
2008-12-24,2,Bed Number 2,100,28,72
2008-12-24,3,Bed Number 3,81,63,18
2008-12-25,1,Bed Number 1,89,1,88
2008-12-25,2,Bed Number 2,51,25,26
2008-12-25,3,Bed Number 3,93,45,48
2008-12-26,1,Bed Number 1,41,36,5
2008-12-26,2,Bed Number 2,58,9,49
2008-12-26,3,Bed Number 3,25,7,18
2008-12-27,1,Bed Number 1,74,17,57
2008-12-27,2,Bed Number 2,74,22,52
2008-12-27,3,Bed Number 3,93,65,28
2008-12-28,1,Bed Number 1,92,66,26
2008-12-28,2,Bed Number 2,46,40,6
2008-12-28,3,Bed Number 3,42,29,13
2008-12-29,1,Bed Number 1,77,63,14
2008-12-29,2,Bed Number 2,40,13,27
2008-12-29,3,Bed Number 3,96,34,62
2008-12-30,1,Bed Number 1,56,43,13
2008-12-30,2,Bed Number 2,83,57,26
2008-12-30,3,Bed Number 3,34,31,3
2008-12-31,1,Bed Number 1,57,40,17
2008-12-31,2,Bed Number 2,81,81,0
2008-12-31,3,Bed Number 3,24,18,6
2009-01-01,1,Bed Number 1,92,82,10
2009-01-01,2,Bed Number 2,69,66,3
2009-01-01,3,Bed Number 3,67,1,66
2009-01-02,1,Bed Number 1,76,75,1
2009-01-02,2,Bed Number 2,95,77,18
2009-01-02,3,Bed Number 3,23,8,15
2009-01-03,1,Bed Number 1,74,9,65
2009-01-03,2,Bed Number 2,15,1,14
2009-01-03,3,Bed Number 3,91,44,47
2009-01-04,1,Bed Number 1,45,0,45
2009-01-04,2,Bed Number 2,45,6,39
2009-01-04,3,Bed Number 3,87,47,40
2009-01-05,1,Bed Number 1,96,3,93
2009-01-05,2,Bed Number 2,56,1,55
2009-01-05,3,Bed Number 3,96,83,13
2009-01-06,1,Bed Number 1,50,10,40
2009-01-06,2,Bed Number 2,50,46,4
2009-01-06,3,Bed Number 3,48,24,24
2009-01-07,1,Bed Number 1,31,28,3
2009-01-07,2,Bed Number 2,62,12,50
2009-01-07,3,Bed Number 3,76,8,68
2009-01-08,1,Bed Number 1,56,1,55
2009-01-08,2,Bed Number 2,26,21,5
2009-01-08,3,Bed Number 3,86,5,81
2009-01-09,1,Bed Number 1,86,23,63
2009-01-09,2,Bed Number 2,37,2,35
2009-01-09,3,Bed Number 3,18,17,1
2009-01-10,1,Bed Number 1,42,10,32
2009-01-10,2,Bed Number 2,52,51,1
2009-01-10,3,Bed Number 3,11,6,5
2009-01-11,1,Bed Number 1,96,16,80
2009-01-11,2,Bed Number 2,52,39,13
2009-01-11,3,Bed Number 3,75,38,37
2009-01-12,1,Bed Number 1,45,0,45
2009-01-12,2,Bed Number 2,86,40,46
2009-01-12,3,Bed Number 3,80,33,47
2009-01-13,1,Bed Number 1,42,19,23
2009-01-13,2,Bed Number 2,11,8,3
2009-01-13,3,Bed Number 3,42,37,5
2009-01-14,1,Bed Number 1,57,39,18
2009-01-14,2,Bed Number 2,33,20,13
2009-01-14,3,Bed Number 3,99,29,70
2009-01-15,1,Bed Number 1,22,3,19
2009-01-15,2,Bed Number 2,55,4,51
2009-01-15,3,Bed Number 3,85,1,84
2009-01-16,1,Bed Number 1,84,22,62
2009-01-16,2,Bed Number 2,98,2,96
2009-01-16,3,Bed Number 3,31,9,22
2009-01-17,1,Bed Number 1,99,48,51
2009-01-17,2,Bed Number 2,100,50,50
2009-01-17,3,Bed Number 3,12,3,9
2009-01-18,1,Bed Number 1,97,40,57
2009-01-18,2,Bed Number 2,30,13,17
2009-01-18,3,Bed Number 3,92,39,53
2009-01-19,1,Bed Number 1,71,50,21
2009-01-19,2,Bed Number 2,59,17,42
2009-01-19,3,Bed Number 3,81,79,2
2009-01-20,1,Bed Number 1,45,42,3
2009-01-20,2,Bed Number 2,81,44,37
2009-01-20,3,Bed Number 3,73,0,73
2009-01-21,1,Bed Number 1,12,9,3
2009-01-21,2,Bed Number 2,66,25,41
2009-01-21,3,Bed Number 3,71,70,1
2009-01-22,1,Bed Number 1,43,29,14
2009-01-22,2,Bed Number 2,80,14,66
2009-01-22,3,Bed Number 3,25,3,22
2009-01-23,1,Bed Number 1,79,52,27
2009-01-23,2,Bed Number 2,71,64,7
2009-01-23,3,Bed Number 3,56,22,34
2009-01-24,1,Bed Number 1,100,83,17
2009-01-24,2,Bed Number 2,55,17,38
2009-01-24,3,Bed Number 3,94,54,40
2009-01-25,1,Bed Number 1,82,71,11
2009-01-25,2,Bed Number 2,30,7,23
2009-01-25,3,Bed Number 3,48,26,22
2009-01-26,1,Bed Number 1,61,28,33
2009-01-26,2,Bed Number 2,55,23,32
2009-01-26,3,Bed Number 3,18,6,12
2009-01-27,1,Bed Number 1,38,5,33
2009-01-27,2,Bed Number 2,45,23,22
2009-01-27,3,Bed Number 3,71,69,2
2009-01-28,1,Bed Number 1,70,33,37
2009-01-28,2,Bed Number 2,13,1,12
2009-01-28,3,Bed Number 3,93,58,35
2009-01-29,1,Bed Number 1,64,2,62
2009-01-29,2,Bed Number 2,98,25,73
2009-01-29,3,Bed Number 3,13,4,9
2009-01-30,1,Bed Number 1,37,34,3
2009-01-30,2,Bed Number 2,94,1,93
2009-01-30,3,Bed Number 3,42,7,35
2009-01-31,1,Bed Number 1,54,5,49
2009-01-31,2,Bed Number 2,61,25,36
2009-01-31,3,Bed Number 3,76,10,66
2009-02-01,1,Bed Number 1,43,21,22
2009-02-01,2,Bed Number 2,61,26,35
2009-02-01,3,Bed Number 3,99,12,87
2009-02-02,1,Bed Number 1,31,22,9
2009-02-02,2,Bed Number 2,50,37,13
2009-02-02,3,Bed Number 3,19,16,3
2009-02-03,1,Bed Number 1,90,13,77
2009-02-03,2,Bed Number 2,65,7,58
2009-02-03,3,Bed Number 3,18,2,16
2009-02-04,1,Bed Number 1,83,54,29
2009-02-04,2,Bed Number 2,98,79,19
2009-02-04,3,Bed Number 3,75,25,50
2009-02-05,1,Bed Number 1,74,17,57
2009-02-05,2,Bed Number 2,39,35,4
2009-02-05,3,Bed Number 3,22,9,13
2009-02-06,1,Bed Number 1,75,34,41
2009-02-06,2,Bed Number 2,45,12,33
2009-02-06,3,Bed Number 3,19,18,1
2009-02-07,1,Bed Number 1,57,40,17
2009-02-07,2,Bed Number 2,91,60,31
2009-02-07,3,Bed Number 3,39,28,11
2009-02-08,1,Bed Number 1,51,40,11
2009-02-08,2,Bed Number 2,73,17,56
2009-02-08,3,Bed Number 3,60,29,31
2009-02-09,1,Bed Number 1,10,5,5
2009-02-09,2,Bed Number 2,52,41,11
2009-02-09,3,Bed Number 3,20,13,7
2009-02-10,1,Bed Number 1,55,53,2
2009-02-10,2,Bed Number 2,27,15,12
2009-02-10,3,Bed Number 3,83,18,65
2009-02-11,1,Bed Number 1,51,26,25
2009-02-11,2,Bed Number 2,74,57,17
2009-02-11,3,Bed Number 3,36,12,24
2009-02-12,1,Bed Number 1,27,19,8
2009-02-12,2,Bed Number 2,19,2,17
2009-02-12,3,Bed Number 3,69,31,38
2009-02-13,1,Bed Number 1,41,31,10
2009-02-13,2,Bed Number 2,44,44,0
2009-02-13,3,Bed Number 3,68,51,17
2009-02-14,1,Bed Number 1,72,64,8
2009-02-14,2,Bed Number 2,66,59,7
2009-02-14,3,Bed Number 3,44,16,28
2009-02-15,1,Bed Number 1,26,2,24
2009-02-15,2,Bed Number 2,94,81,13
2009-02-15,3,Bed Number 3,26,1,25
2009-02-16,1,Bed Number 1,86,21,65
2009-02-16,2,Bed Number 2,42,10,32
2009-02-16,3,Bed Number 3,31,4,27
2009-02-17,1,Bed Number 1,22,4,18
2009-02-17,2,Bed Number 2,25,4,21
2009-02-17,3,Bed Number 3,52,23,29
2009-02-18,1,Bed Number 1,56,42,14
2009-02-18,2,Bed Number 2,45,33,12
2009-02-18,3,Bed Number 3,66,1,65
2009-02-19,1,Bed Number 1,10,3,7
2009-02-19,2,Bed Number 2,18,17,1
2009-02-19,3,Bed Number 3,46,15,31
2009-02-20,1,Bed Number 1,57,4,53
2009-02-20,2,Bed Number 2,98,33,65
2009-02-20,3,Bed Number 3,73,10,63
2009-02-21,1,Bed Number 1,52,42,10
2009-02-21,2,Bed Number 2,96,52,44
2009-02-21,3,Bed Number 3,59,23,36
2009-02-22,1,Bed Number 1,58,33,25
2009-02-22,2,Bed Number 2,20,10,10
2009-02-22,3,Bed Number 3,11,9,2
2009-02-23,1,Bed Number 1,84,50,34
2009-02-23,2,Bed Number 2,11,11,0
2009-02-23,3,Bed Number 3,32,32,0
2009-02-24,1,Bed Number 1,87,3,84
2009-02-24,2,Bed Number 2,84,66,18
2009-02-24,3,Bed Number 3,97,20,77
2009-02-25,1,Bed Number 1,10,10,0
2009-02-25,2,Bed Number 2,46,42,4
2009-02-25,3,Bed Number 3,61,16,45
2009-02-26,1,Bed Number 1,74,50,24
2009-02-26,2,Bed Number 2,51,8,43
2009-02-26,3,Bed Number 3,48,3,45
2009-02-27,1,Bed Number 1,74,26,48
2009-02-27,2,Bed Number 2,87,29,58
2009-02-27,3,Bed Number 3,71,28,43
2009-02-28,1,Bed Number 1,56,14,42
2009-02-28,2,Bed Number 2,78,19,59
2009-02-28,3,Bed Number 3,56,9,47
2009-03-01,1,Bed Number 1,99,50,49
2009-03-01,2,Bed Number 2,64,25,39
2009-03-01,3,Bed Number 3,27,10,17
2009-03-02,1,Bed Number 1,21,0,21
2009-03-02,2,Bed Number 2,15,10,5
2009-03-02,3,Bed Number 3,63,47,16
2009-03-03,1,Bed Number 1,87,63,24
2009-03-03,2,Bed Number 2,68,30,38
2009-03-03,3,Bed Number 3,21,18,3
2009-03-04,1,Bed Number 1,89,70,19
2009-03-04,2,Bed Number 2,21,21,0
2009-03-04,3,Bed Number 3,87,29,58
2009-03-05,1,Bed Number 1,48,33,15
2009-03-05,2,Bed Number 2,94,34,60
2009-03-05,3,Bed Number 3,64,57,7
2009-03-06,1,Bed Number 1,37,18,19
2009-03-06,2,Bed Number 2,29,8,21
2009-03-06,3,Bed Number 3,46,43,3
2009-03-07,1,Bed Number 1,60,46,14
2009-03-07,2,Bed Number 2,23,4,19
2009-03-07,3,Bed Number 3,25,3,22
2009-03-08,1,Bed Number 1,64,9,55
2009-03-08,2,Bed Number 2,92,5,87
2009-03-08,3,Bed Number 3,74,3,71
2009-03-09,1,Bed Number 1,28,6,22
2009-03-09,2,Bed Number 2,44,9,35
2009-03-09,3,Bed Number 3,49,17,32
2009-03-10,1,Bed Number 1,22,21,1
2009-03-10,2,Bed Number 2,45,37,8
2009-03-10,3,Bed Number 3,80,25,55
2009-03-11,1,Bed Number 1,77,49,28
2009-03-11,2,Bed Number 2,60,37,23
2009-03-11,3,Bed Number 3,100,42,58
2009-03-12,1,Bed Number 1,97,45,52
2009-03-12,2,Bed Number 2,20,12,8
2009-03-12,3,Bed Number 3,14,5,9
2009-03-13,1,Bed Number 1,68,26,42
2009-03-13,2,Bed Number 2,22,19,3
2009-03-13,3,Bed Number 3,52,16,36
2009-03-14,1,Bed Number 1,25,8,17
2009-03-14,2,Bed Number 2,37,15,22
2009-03-14,3,Bed Number 3,37,29,8
2009-03-15,1,Bed Number 1,56,11,45
2009-03-15,2,Bed Number 2,58,40,18
2009-03-15,3,Bed Number 3,53,9,44
2009-03-16,1,Bed Number 1,100,60,40
2009-03-16,2,Bed Number 2,26,0,26
2009-03-16,3,Bed Number 3,37,16,21
2009-03-17,1,Bed Number 1,30,26,4
2009-03-17,2,Bed Number 2,23,10,13
2009-03-17,3,Bed Number 3,34,9,25
2009-03-18,1,Bed Number 1,33,22,11
2009-03-18,2,Bed Number 2,26,10,16
2009-03-18,3,Bed Number 3,13,3,10
2009-03-19,1,Bed Number 1,81,59,22
2009-03-19,2,Bed Number 2,29,9,20
2009-03-19,3,Bed Number 3,96,24,72
2009-03-20,1,Bed Number 1,98,56,42
2009-03-20,2,Bed Number 2,99,65,34
2009-03-20,3,Bed Number 3,82,69,13
2009-03-21,1,Bed Number 1,96,92,4
2009-03-21,2,Bed Number 2,68,50,18
2009-03-21,3,Bed Number 3,26,9,17
2009-03-22,1,Bed Number 1,25,14,11
2009-03-22,2,Bed Number 2,45,12,33
2009-03-22,3,Bed Number 3,75,49,26
2009-03-23,1,Bed Number 1,65,13,52
2009-03-23,2,Bed Number 2,81,18,63
2009-03-23,3,Bed Number 3,41,7,34
2009-03-24,1,Bed Number 1,75,72,3
2009-03-24,2,Bed Number 2,96,31,65
2009-03-24,3,Bed Number 3,11,1,10
2009-03-25,1,Bed Number 1,14,14,0
2009-03-25,2,Bed Number 2,81,6,75
2009-03-25,3,Bed Number 3,97,60,37
2009-03-26,1,Bed Number 1,35,34,1
2009-03-26,2,Bed Number 2,80,50,30
2009-03-26,3,Bed Number 3,67,56,11
2009-03-27,1,Bed Number 1,17,13,4
2009-03-27,2,Bed Number 2,93,4,89
2009-03-27,3,Bed Number 3,41,8,33
2009-03-28,1,Bed Number 1,48,30,18
2009-03-28,2,Bed Number 2,97,61,36
2009-03-28,3,Bed Number 3,79,35,44
2009-03-29,1,Bed Number 1,68,50,18
2009-03-29,2,Bed Number 2,10,7,3
2009-03-29,3,Bed Number 3,69,31,38
2009-03-30,1,Bed Number 1,85,2,83
2009-03-30,2,Bed Number 2,21,8,13
2009-03-30,3,Bed Number 3,72,6,66
2009-03-31,1,Bed Number 1,45,17,28
2009-03-31,2,Bed Number 2,46,7,39
2009-03-31,3,Bed Number 3,91,80,11
2009-04-01,1,Bed Number 1,42,4,38
2009-04-01,2,Bed Number 2,27,24,3
2009-04-01,3,Bed Number 3,10,3,7
2009-04-02,1,Bed Number 1,81,65,16
2009-04-02,2,Bed Number 2,10,4,6
2009-04-02,3,Bed Number 3,76,16,60
2009-04-03,1,Bed Number 1,26,8,18
2009-04-03,2,Bed Number 2,90,17,73
2009-04-03,3,Bed Number 3,54,22,32
2009-04-04,1,Bed Number 1,80,18,62
2009-04-04,2,Bed Number 2,38,29,9
2009-04-04,3,Bed Number 3,60,51,9
2009-04-05,1,Bed Number 1,42,12,30
2009-04-05,2,Bed Number 2,28,19,9
2009-04-05,3,Bed Number 3,12,12,0
2009-04-06,1,Bed Number 1,60,19,41
2009-04-06,2,Bed Number 2,76,33,43
2009-04-06,3,Bed Number 3,47,31,16
2009-04-07,1,Bed Number 1,77,53,24
2009-04-07,2,Bed Number 2,89,74,15
2009-04-07,3,Bed Number 3,83,34,49
2009-04-08,1,Bed Number 1,76,18,58
2009-04-08,2,Bed Number 2,30,17,13
2009-04-08,3,Bed Number 3,92,23,69
2009-04-09,1,Bed Number 1,88,76,12
2009-04-09,2,Bed Number 2,41,25,16
2009-04-09,3,Bed Number 3,32,23,9
2009-04-10,1,Bed Number 1,11,9,2
2009-04-10,2,Bed Number 2,75,18,57
2009-04-10,3,Bed Number 3,30,16,14
2009-04-11,1,Bed Number 1,37,36,1
2009-04-11,2,Bed Number 2,69,48,21
2009-04-11,3,Bed Number 3,75,53,22
2009-04-12,1,Bed Number 1,32,7,25
2009-04-12,2,Bed Number 2,16,12,4
2009-04-12,3,Bed Number 3,94,23,71
2009-04-13,1,Bed Number 1,17,14,3
2009-04-13,2,Bed Number 2,43,1,42
2009-04-13,3,Bed Number 3,10,1,9
2009-04-14,1,Bed Number 1,60,0,60
2009-04-14,2,Bed Number 2,64,29,35
2009-04-14,3,Bed Number 3,92,8,84
2009-04-15,1,Bed Number 1,91,14,77
2009-04-15,2,Bed Number 2,41,24,17
2009-04-15,3,Bed Number 3,23,7,16
2009-04-16,1,Bed Number 1,51,32,19
2009-04-16,2,Bed Number 2,80,66,14
2009-04-16,3,Bed Number 3,25,14,11
2009-04-17,1,Bed Number 1,60,25,35
2009-04-17,2,Bed Number 2,82,8,74
2009-04-17,3,Bed Number 3,44,40,4
2009-04-18,1,Bed Number 1,91,84,7
2009-04-18,2,Bed Number 2,10,9,1
2009-04-18,3,Bed Number 3,14,3,11
2009-04-19,1,Bed Number 1,46,12,34
2009-04-19,2,Bed Number 2,21,20,1
2009-04-19,3,Bed Number 3,83,10,73
2009-04-20,1,Bed Number 1,24,10,14
2009-04-20,2,Bed Number 2,78,73,5
2009-04-20,3,Bed Number 3,92,8,84
2009-04-21,1,Bed Number 1,50,28,22
2009-04-21,2,Bed Number 2,35,2,33
2009-04-21,3,Bed Number 3,98,49,49
2009-04-22,1,Bed Number 1,24,0,24
2009-04-22,2,Bed Number 2,10,4,6
2009-04-22,3,Bed Number 3,62,49,13
2009-04-23,1,Bed Number 1,21,0,21
2009-04-23,2,Bed Number 2,23,2,21
2009-04-23,3,Bed Number 3,51,24,27
2009-04-24,1,Bed Number 1,10,10,0
2009-04-24,2,Bed Number 2,31,15,16
2009-04-24,3,Bed Number 3,19,1,18
2009-04-25,1,Bed Number 1,24,13,11
2009-04-25,2,Bed Number 2,62,39,23
2009-04-25,3,Bed Number 3,97,46,51
2009-04-26,1,Bed Number 1,69,4,65
2009-04-26,2,Bed Number 2,26,21,5
2009-04-26,3,Bed Number 3,27,6,21
2009-04-27,1,Bed Number 1,48,2,46
2009-04-27,2,Bed Number 2,67,55,12
2009-04-27,3,Bed Number 3,37,17,20
2009-04-28,1,Bed Number 1,39,12,27
2009-04-28,2,Bed Number 2,55,7,48
2009-04-28,3,Bed Number 3,66,64,2
2009-04-29,1,Bed Number 1,89,18,71
2009-04-29,2,Bed Number 2,62,2,60
2009-04-29,3,Bed Number 3,44,16,28
2009-04-30,1,Bed Number 1,76,15,61
2009-04-30,2,Bed Number 2,35,4,31
2009-04-30,3,Bed Number 3,26,19,7
2009-05-01,1,Bed Number 1,78,29,49
2009-05-01,2,Bed Number 2,21,12,9
2009-05-01,3,Bed Number 3,75,21,54
2009-05-02,1,Bed Number 1,23,16,7
2009-05-02,2,Bed Number 2,17,11,6
2009-05-02,3,Bed Number 3,92,65,27
2009-05-03,1,Bed Number 1,43,36,7
2009-05-03,2,Bed Number 2,50,6,44
2009-05-03,3,Bed Number 3,85,26,59
2009-05-04,1,Bed Number 1,35,33,2
2009-05-04,2,Bed Number 2,43,16,27
2009-05-04,3,Bed Number 3,97,78,19
2009-05-05,1,Bed Number 1,23,2,21
2009-05-05,2,Bed Number 2,78,24,54
2009-05-05,3,Bed Number 3,24,18,6
2009-05-06,1,Bed Number 1,97,57,40
2009-05-06,2,Bed Number 2,73,21,52
2009-05-06,3,Bed Number 3,38,29,9
2009-05-07,1,Bed Number 1,35,18,17
2009-05-07,2,Bed Number 2,88,44,44
2009-05-07,3,Bed Number 3,34,5,29
2009-05-08,1,Bed Number 1,90,79,11
2009-05-08,2,Bed Number 2,40,1,39
2009-05-08,3,Bed Number 3,90,79,11
2009-05-09,1,Bed Number 1,52,16,36
2009-05-09,2,Bed Number 2,16,7,9
2009-05-09,3,Bed Number 3,74,48,26
2009-05-10,1,Bed Number 1,10,10,0
2009-05-10,2,Bed Number 2,22,19,3
2009-05-10,3,Bed Number 3,17,15,2
2009-05-11,1,Bed Number 1,72,68,4
2009-05-11,2,Bed Number 2,52,8,44
2009-05-11,3,Bed Number 3,82,81,1
2009-05-12,1,Bed Number 1,82,41,41
2009-05-12,2,Bed Number 2,92,82,10
2009-05-12,3,Bed Number 3,19,13,6
2009-05-13,1,Bed Number 1,59,57,2
2009-05-13,2,Bed Number 2,55,43,12
2009-05-13,3,Bed Number 3,33,19,14
2009-05-14,1,Bed Number 1,53,32,21
2009-05-14,2,Bed Number 2,41,6,35
2009-05-14,3,Bed Number 3,15,12,3
2009-05-15,1,Bed Number 1,33,17,16
2009-05-15,2,Bed Number 2,30,25,5
2009-05-15,3,Bed Number 3,52,15,37
2009-05-16,1,Bed Number 1,30,22,8
2009-05-16,2,Bed Number 2,75,67,8
2009-05-16,3,Bed Number 3,41,28,13
2009-05-17,1,Bed Number 1,33,10,23
2009-05-17,2,Bed Number 2,34,6,28
2009-05-17,3,Bed Number 3,23,9,14
2009-05-18,1,Bed Number 1,61,39,22
2009-05-18,2,Bed Number 2,52,29,23
2009-05-18,3,Bed Number 3,19,1,18
2009-05-19,1,Bed Number 1,61,9,52
2009-05-19,2,Bed Number 2,30,7,23
2009-05-19,3,Bed Number 3,14,2,12
2009-05-20,1,Bed Number 1,90,41,49
2009-05-20,2,Bed Number 2,18,17,1
2009-05-20,3,Bed Number 3,72,44,28
2009-05-21,1,Bed Number 1,82,18,64
2009-05-21,2,Bed Number 2,93,8,85
2009-05-21,3,Bed Number 3,74,50,24
2009-05-22,1,Bed Number 1,43,1,42
2009-05-22,2,Bed Number 2,48,47,1
2009-05-22,3,Bed Number 3,69,55,14
2009-05-23,1,Bed Number 1,55,35,20
2009-05-23,2,Bed Number 2,48,41,7
2009-05-23,3,Bed Number 3,37,7,30
2009-05-24,1,Bed Number 1,36,0,36
2009-05-24,2,Bed Number 2,97,55,42
2009-05-24,3,Bed Number 3,47,35,12
2009-05-25,1,Bed Number 1,90,7,83
2009-05-25,2,Bed Number 2,61,35,26
2009-05-25,3,Bed Number 3,41,15,26
2009-05-26,1,Bed Number 1,42,41,1
2009-05-26,2,Bed Number 2,67,66,1
2009-05-26,3,Bed Number 3,60,49,11
2009-05-27,1,Bed Number 1,97,42,55
2009-05-27,2,Bed Number 2,48,12,36
2009-05-27,3,Bed Number 3,14,11,3
2009-05-28,1,Bed Number 1,54,34,20
2009-05-28,2,Bed Number 2,24,13,11
2009-05-28,3,Bed Number 3,71,60,11
2009-05-29,1,Bed Number 1,36,11,25
2009-05-29,2,Bed Number 2,45,26,19
2009-05-29,3,Bed Number 3,90,48,42
2009-05-30,1,Bed Number 1,24,8,16
2009-05-30,2,Bed Number 2,99,77,22
2009-05-30,3,Bed Number 3,91,65,26
2009-05-31,1,Bed Number 1,16,4,12
2009-05-31,2,Bed Number 2,79,6,73
2009-05-31,3,Bed Number 3,65,41,24
2009-06-01,1,Bed Number 1,74,40,34
2009-06-01,2,Bed Number 2,62,46,16
2009-06-01,3,Bed Number 3,36,16,20
2009-06-02,1,Bed Number 1,75,39,36
2009-06-02,2,Bed Number 2,20,15,5
2009-06-02,3,Bed Number 3,87,1,86
2009-06-03,1,Bed Number 1,98,42,56
2009-06-03,2,Bed Number 2,53,9,44
2009-06-03,3,Bed Number 3,72,30,42
2009-06-04,1,Bed Number 1,23,23,0
2009-06-04,2,Bed Number 2,13,5,8
2009-06-04,3,Bed Number 3,60,0,60
2009-06-05,1,Bed Number 1,61,57,4
2009-06-05,2,Bed Number 2,89,44,45
2009-06-05,3,Bed Number 3,61,14,47
2009-06-06,1,Bed Number 1,93,86,7
2009-06-06,2,Bed Number 2,76,12,64
2009-06-06,3,Bed Number 3,50,0,50
2009-06-07,1,Bed Number 1,86,75,11
2009-06-07,2,Bed Number 2,20,5,15
2009-06-07,3,Bed Number 3,63,60,3
2009-06-08,1,Bed Number 1,52,5,47
2009-06-08,2,Bed Number 2,74,1,73
2009-06-08,3,Bed Number 3,38,19,19
2009-06-09,1,Bed Number 1,30,13,17
2009-06-09,2,Bed Number 2,44,19,25
2009-06-09,3,Bed Number 3,15,14,1
2009-06-10,1,Bed Number 1,93,65,28
2009-06-10,2,Bed Number 2,99,75,24
2009-06-10,3,Bed Number 3,29,22,7
2009-06-11,1,Bed Number 1,98,67,31
2009-06-11,2,Bed Number 2,60,4,56
2009-06-11,3,Bed Number 3,49,41,8
2009-06-12,1,Bed Number 1,12,9,3
2009-06-12,2,Bed Number 2,19,7,12
2009-06-12,3,Bed Number 3,88,40,48
2009-06-13,1,Bed Number 1,51,44,7
2009-06-13,2,Bed Number 2,25,5,20
2009-06-13,3,Bed Number 3,75,65,10
2009-06-14,1,Bed Number 1,34,29,5
2009-06-14,2,Bed Number 2,50,25,25
2009-06-14,3,Bed Number 3,91,9,82
2009-06-15,1,Bed Number 1,96,44,52
2009-06-15,2,Bed Number 2,35,7,28
2009-06-15,3,Bed Number 3,48,28,20
2009-06-16,1,Bed Number 1,61,42,19
2009-06-16,2,Bed Number 2,24,11,13
2009-06-16,3,Bed Number 3,89,70,19
2009-06-17,1,Bed Number 1,70,21,49
2009-06-17,2,Bed Number 2,22,1,21
2009-06-17,3,Bed Number 3,71,7,64
2009-06-18,1,Bed Number 1,57,41,16
2009-06-18,2,Bed Number 2,35,19,16
2009-06-18,3,Bed Number 3,35,0,35
2009-06-19,1,Bed Number 1,36,12,24
2009-06-19,2,Bed Number 2,15,6,9
2009-06-19,3,Bed Number 3,48,47,1
2009-06-20,1,Bed Number 1,76,50,26
2009-06-20,2,Bed Number 2,72,69,3
2009-06-20,3,Bed Number 3,17,8,9
2009-06-21,1,Bed Number 1,24,18,6
2009-06-21,2,Bed Number 2,40,31,9
2009-06-21,3,Bed Number 3,63,44,19
2009-06-22,1,Bed Number 1,41,0,41
2009-06-22,2,Bed Number 2,98,68,30
2009-06-22,3,Bed Number 3,91,80,11
2009-06-23,1,Bed Number 1,55,20,35
2009-06-23,2,Bed Number 2,11,2,9
2009-06-23,3,Bed Number 3,50,14,36
2009-06-24,1,Bed Number 1,82,1,81
2009-06-24,2,Bed Number 2,60,57,3
2009-06-24,3,Bed Number 3,64,42,22
2009-06-25,1,Bed Number 1,12,10,2
2009-06-25,2,Bed Number 2,31,25,6
2009-06-25,3,Bed Number 3,82,49,33
2009-06-26,1,Bed Number 1,93,50,43
2009-06-26,2,Bed Number 2,100,14,86
2009-06-26,3,Bed Number 3,57,53,4
2009-06-27,1,Bed Number 1,39,26,13
2009-06-27,2,Bed Number 2,15,1,14
2009-06-27,3,Bed Number 3,37,35,2
2009-06-28,1,Bed Number 1,60,59,1
2009-06-28,2,Bed Number 2,27,22,5
2009-06-28,3,Bed Number 3,95,4,91
2009-06-29,1,Bed Number 1,52,42,10
2009-06-29,2,Bed Number 2,18,18,0
2009-06-29,3,Bed Number 3,14,9,5
2009-06-30,1,Bed Number 1,90,13,77
2009-06-30,2,Bed Number 2,48,42,6
2009-06-30,3,Bed Number 3,84,65,19
2009-07-01,1,Bed Number 1,91,83,8
2009-07-01,2,Bed Number 2,55,24,31
2009-07-01,3,Bed Number 3,29,13,16
2009-07-02,1,Bed Number 1,15,5,10
2009-07-02,2,Bed Number 2,11,7,4
2009-07-02,3,Bed Number 3,53,32,21
2009-07-03,1,Bed Number 1,98,93,5
2009-07-03,2,Bed Number 2,25,25,0
2009-07-03,3,Bed Number 3,14,6,8
2009-07-04,1,Bed Number 1,16,10,6
2009-07-04,2,Bed Number 2,90,44,46
2009-07-04,3,Bed Number 3,68,51,17
2009-07-05,1,Bed Number 1,39,13,26
2009-07-05,2,Bed Number 2,62,36,26
2009-07-05,3,Bed Number 3,33,12,21
2009-07-06,1,Bed Number 1,13,8,5
2009-07-06,2,Bed Number 2,100,25,75
2009-07-06,3,Bed Number 3,15,1,14
2009-07-07,1,Bed Number 1,69,22,47
2009-07-07,2,Bed Number 2,60,33,27
2009-07-07,3,Bed Number 3,43,39,4
2009-07-08,1,Bed Number 1,17,12,5
2009-07-08,2,Bed Number 2,75,18,57
2009-07-08,3,Bed Number 3,62,47,15
2009-07-09,1,Bed Number 1,21,10,11
2009-07-09,2,Bed Number 2,50,8,42
2009-07-09,3,Bed Number 3,21,3,18
2009-07-10,1,Bed Number 1,71,1,70
2009-07-10,2,Bed Number 2,88,30,58
2009-07-10,3,Bed Number 3,74,72,2
2009-07-11,1,Bed Number 1,43,12,31
2009-07-11,2,Bed Number 2,73,31,42
2009-07-11,3,Bed Number 3,68,65,3
2009-07-12,1,Bed Number 1,90,70,20
2009-07-12,2,Bed Number 2,37,7,30
2009-07-12,3,Bed Number 3,56,39,17
2009-07-13,1,Bed Number 1,49,1,48
2009-07-13,2,Bed Number 2,39,16,23
2009-07-13,3,Bed Number 3,13,9,4
2009-07-14,1,Bed Number 1,45,0,45
2009-07-14,2,Bed Number 2,70,25,45
2009-07-14,3,Bed Number 3,98,19,79
2009-07-15,1,Bed Number 1,56,19,37
2009-07-15,2,Bed Number 2,22,15,7
2009-07-15,3,Bed Number 3,29,10,19
2009-07-16,1,Bed Number 1,100,89,11
2009-07-16,2,Bed Number 2,81,77,4
2009-07-16,3,Bed Number 3,16,10,6
2009-07-17,1,Bed Number 1,79,72,7
2009-07-17,2,Bed Number 2,49,26,23
2009-07-17,3,Bed Number 3,15,3,12
2009-07-18,1,Bed Number 1,96,84,12
2009-07-18,2,Bed Number 2,50,40,10
2009-07-18,3,Bed Number 3,70,58,12
2009-07-19,1,Bed Number 1,24,17,7
2009-07-19,2,Bed Number 2,21,0,21
2009-07-19,3,Bed Number 3,73,55,18
2009-07-20,1,Bed Number 1,85,62,23
2009-07-20,2,Bed Number 2,69,5,64
2009-07-20,3,Bed Number 3,78,54,24
2009-07-21,1,Bed Number 1,92,84,8
2009-07-21,2,Bed Number 2,95,41,54
2009-07-21,3,Bed Number 3,60,38,22
2009-07-22,1,Bed Number 1,100,52,48
2009-07-22,2,Bed Number 2,12,6,6
2009-07-22,3,Bed Number 3,57,56,1
2009-07-23,1,Bed Number 1,43,6,37
2009-07-23,2,Bed Number 2,25,22,3
2009-07-23,3,Bed Number 3,72,30,42
2009-07-24,1,Bed Number 1,50,13,37
2009-07-24,2,Bed Number 2,27,2,25
2009-07-24,3,Bed Number 3,85,79,6
2009-07-25,1,Bed Number 1,63,49,14
2009-07-25,2,Bed Number 2,81,62,19
2009-07-25,3,Bed Number 3,78,26,52
2009-07-26,1,Bed Number 1,62,1,61
2009-07-26,2,Bed Number 2,64,35,29
2009-07-26,3,Bed Number 3,81,79,2
2009-07-27,1,Bed Number 1,62,43,19
2009-07-27,2,Bed Number 2,17,10,7
2009-07-27,3,Bed Number 3,74,31,43
2009-07-28,1,Bed Number 1,69,14,55
2009-07-28,2,Bed Number 2,24,13,11
2009-07-28,3,Bed Number 3,20,4,16
2009-07-29,1,Bed Number 1,17,3,14
2009-07-29,2,Bed Number 2,50,45,5
2009-07-29,3,Bed Number 3,40,7,33
2009-07-30,1,Bed Number 1,25,2,23
2009-07-30,2,Bed Number 2,82,69,13
2009-07-30,3,Bed Number 3,54,45,9
2009-07-31,1,Bed Number 1,60,39,21
2009-07-31,2,Bed Number 2,47,24,23
2009-07-31,3,Bed Number 3,40,3,37
2009-08-01,1,Bed Number 1,70,27,43
2009-08-01,2,Bed Number 2,34,2,32
2009-08-01,3,Bed Number 3,20,15,5
2009-08-02,1,Bed Number 1,49,37,12
2009-08-02,2,Bed Number 2,76,9,67
2009-08-02,3,Bed Number 3,50,39,11
2009-08-03,1,Bed Number 1,69,52,17
2009-08-03,2,Bed Number 2,80,24,56
2009-08-03,3,Bed Number 3,18,14,4
2009-08-04,1,Bed Number 1,35,8,27
2009-08-04,2,Bed Number 2,57,42,15
2009-08-04,3,Bed Number 3,97,86,11
2009-08-05,1,Bed Number 1,14,13,1
2009-08-05,2,Bed Number 2,55,35,20
2009-08-05,3,Bed Number 3,32,31,1
2009-08-06,1,Bed Number 1,57,35,22
2009-08-06,2,Bed Number 2,85,28,57
2009-08-06,3,Bed Number 3,52,9,43
2009-08-07,1,Bed Number 1,67,2,65
2009-08-07,2,Bed Number 2,12,5,7
2009-08-07,3,Bed Number 3,49,25,24
2009-08-08,1,Bed Number 1,100,22,78
2009-08-08,2,Bed Number 2,98,70,28
2009-08-08,3,Bed Number 3,72,23,49
2009-08-09,1,Bed Number 1,35,28,7
2009-08-09,2,Bed Number 2,43,13,30
2009-08-09,3,Bed Number 3,20,10,10
2009-08-10,1,Bed Number 1,16,10,6
2009-08-10,2,Bed Number 2,53,7,46
2009-08-10,3,Bed Number 3,39,18,21
2009-08-11,1,Bed Number 1,85,48,37
2009-08-11,2,Bed Number 2,62,36,26
2009-08-11,3,Bed Number 3,18,3,15
2009-08-12,1,Bed Number 1,96,50,46
2009-08-12,2,Bed Number 2,17,17,0
2009-08-12,3,Bed Number 3,96,25,71
2009-08-13,1,Bed Number 1,22,16,6
2009-08-13,2,Bed Number 2,51,25,26
2009-08-13,3,Bed Number 3,78,5,73
2009-08-14,1,Bed Number 1,80,53,27
2009-08-14,2,Bed Number 2,69,6,63
2009-08-14,3,Bed Number 3,83,64,19
2009-08-15,1,Bed Number 1,83,42,41
2009-08-15,2,Bed Number 2,10,0,10
2009-08-15,3,Bed Number 3,60,35,25
2009-08-16,1,Bed Number 1,59,54,5
2009-08-16,2,Bed Number 2,100,93,7
2009-08-16,3,Bed Number 3,38,4,34
2009-08-17,1,Bed Number 1,34,31,3
2009-08-17,2,Bed Number 2,75,42,33
2009-08-17,3,Bed Number 3,53,29,24
2009-08-18,1,Bed Number 1,11,3,8
2009-08-18,2,Bed Number 2,79,50,29
2009-08-18,3,Bed Number 3,80,11,69
2009-08-19,1,Bed Number 1,50,40,10
2009-08-19,2,Bed Number 2,11,3,8
2009-08-19,3,Bed Number 3,10,8,2
2009-08-20,1,Bed Number 1,34,29,5
2009-08-20,2,Bed Number 2,15,0,15
2009-08-20,3,Bed Number 3,89,17,72
2009-08-21,1,Bed Number 1,93,45,48
2009-08-21,2,Bed Number 2,22,10,12
2009-08-21,3,Bed Number 3,25,23,2
2009-08-22,1,Bed Number 1,27,19,8
2009-08-22,2,Bed Number 2,59,4,55
2009-08-22,3,Bed Number 3,31,6,25
2009-08-23,1,Bed Number 1,48,15,33
2009-08-23,2,Bed Number 2,40,9,31
2009-08-23,3,Bed Number 3,50,7,43
2009-08-24,1,Bed Number 1,82,6,76
2009-08-24,2,Bed Number 2,69,24,45
2009-08-24,3,Bed Number 3,83,74,9
2009-08-25,1,Bed Number 1,84,51,33
2009-08-25,2,Bed Number 2,54,48,6
2009-08-25,3,Bed Number 3,74,19,55
2009-08-26,1,Bed Number 1,21,17,4
2009-08-26,2,Bed Number 2,63,30,33
2009-08-26,3,Bed Number 3,47,46,1
2009-08-27,1,Bed Number 1,80,41,39
2009-08-27,2,Bed Number 2,34,7,27
2009-08-27,3,Bed Number 3,95,48,47
2009-08-28,1,Bed Number 1,45,27,18
2009-08-28,2,Bed Number 2,41,13,28
2009-08-28,3,Bed Number 3,53,1,52
2009-08-29,1,Bed Number 1,97,51,46
2009-08-29,2,Bed Number 2,25,14,11
2009-08-29,3,Bed Number 3,60,16,44
2009-08-30,1,Bed Number 1,69,64,5
2009-08-30,2,Bed Number 2,88,60,28
2009-08-30,3,Bed Number 3,92,31,61
2009-08-31,1,Bed Number 1,27,18,9
2009-08-31,2,Bed Number 2,74,20,54
2009-08-31,3,Bed Number 3,26,11,15
2009-09-01,1,Bed Number 1,44,21,23
2009-09-01,2,Bed Number 2,99,90,9
2009-09-01,3,Bed Number 3,94,64,30
2009-09-02,1,Bed Number 1,68,57,11
2009-09-02,2,Bed Number 2,73,68,5
2009-09-02,3,Bed Number 3,76,67,9
2009-09-03,1,Bed Number 1,92,13,79
2009-09-03,2,Bed Number 2,42,21,21
2009-09-03,3,Bed Number 3,64,2,62
2009-09-04,1,Bed Number 1,95,1,94
2009-09-04,2,Bed Number 2,44,42,2
2009-09-04,3,Bed Number 3,76,17,59
2009-09-05,1,Bed Number 1,41,14,27
2009-09-05,2,Bed Number 2,70,68,2
2009-09-05,3,Bed Number 3,51,16,35
2009-09-06,1,Bed Number 1,28,17,11
2009-09-06,2,Bed Number 2,85,11,74
2009-09-06,3,Bed Number 3,48,9,39
2009-09-07,1,Bed Number 1,83,39,44
2009-09-07,2,Bed Number 2,12,0,12
2009-09-07,3,Bed Number 3,65,64,1
2009-09-08,1,Bed Number 1,91,65,26
2009-09-08,2,Bed Number 2,58,42,16
2009-09-08,3,Bed Number 3,60,25,35
2009-09-09,1,Bed Number 1,23,16,7
2009-09-09,2,Bed Number 2,100,57,43
2009-09-09,3,Bed Number 3,49,18,31
2009-09-10,1,Bed Number 1,66,37,29
2009-09-10,2,Bed Number 2,54,12,42
2009-09-10,3,Bed Number 3,56,41,15
2009-09-11,1,Bed Number 1,90,81,9
2009-09-11,2,Bed Number 2,96,94,2
2009-09-11,3,Bed Number 3,94,11,83
2009-09-12,1,Bed Number 1,10,9,1
2009-09-12,2,Bed Number 2,23,11,12
2009-09-12,3,Bed Number 3,34,5,29
2009-09-13,1,Bed Number 1,22,0,22
2009-09-13,2,Bed Number 2,85,19,66
2009-09-13,3,Bed Number 3,49,21,28
2009-09-14,1,Bed Number 1,19,12,7
2009-09-14,2,Bed Number 2,95,22,73
2009-09-14,3,Bed Number 3,93,75,18
2009-09-15,1,Bed Number 1,21,15,6
2009-09-15,2,Bed Number 2,38,23,15
2009-09-15,3,Bed Number 3,32,21,11
2009-09-16,1,Bed Number 1,98,84,14
2009-09-16,2,Bed Number 2,11,2,9
2009-09-16,3,Bed Number 3,69,42,27
2009-09-17,1,Bed Number 1,68,50,18
2009-09-17,2,Bed Number 2,23,2,21
2009-09-17,3,Bed Number 3,12,7,5
2009-09-18,1,Bed Number 1,10,6,4
2009-09-18,2,Bed Number 2,73,63,10
2009-09-18,3,Bed Number 3,87,15,72
2009-09-19,1,Bed Number 1,18,15,3
2009-09-19,2,Bed Number 2,76,43,33
2009-09-19,3,Bed Number 3,94,13,81
2009-09-20,1,Bed Number 1,11,7,4
2009-09-20,2,Bed Number 2,49,43,6
2009-09-20,3,Bed Number 3,71,4,67
2009-09-21,1,Bed Number 1,100,51,49
2009-09-21,2,Bed Number 2,79,5,74
2009-09-21,3,Bed Number 3,44,33,11
2009-09-22,1,Bed Number 1,54,34,20
2009-09-22,2,Bed Number 2,43,28,15
2009-09-22,3,Bed Number 3,56,7,49
2009-09-23,1,Bed Number 1,89,82,7
2009-09-23,2,Bed Number 2,46,27,19
2009-09-23,3,Bed Number 3,76,54,22
2009-09-24,1,Bed Number 1,38,32,6
2009-09-24,2,Bed Number 2,79,0,79
2009-09-24,3,Bed Number 3,78,26,52
2009-09-25,1,Bed Number 1,66,53,13
2009-09-25,2,Bed Number 2,91,73,18
2009-09-25,3,Bed Number 3,33,9,24
2009-09-26,1,Bed Number 1,83,2,81
2009-09-26,2,Bed Number 2,38,20,18
2009-09-26,3,Bed Number 3,74,19,55
2009-09-27,1,Bed Number 1,18,15,3
2009-09-27,2,Bed Number 2,23,11,12
2009-09-27,3,Bed Number 3,17,9,8
2009-09-28,1,Bed Number 1,11,8,3
2009-09-28,2,Bed Number 2,41,8,33
2009-09-28,3,Bed Number 3,100,99,1
2009-09-29,1,Bed Number 1,69,47,22
2009-09-29,2,Bed Number 2,36,15,21
2009-09-29,3,Bed Number 3,76,9,67
2009-09-30,1,Bed Number 1,53,49,4
2009-09-30,2,Bed Number 2,29,11,18
2009-09-30,3,Bed Number 3,59,35,24
2009-10-01,1,Bed Number 1,66,62,4
2009-10-01,2,Bed Number 2,93,53,40
2009-10-01,3,Bed Number 3,97,86,11
2009-10-02,1,Bed Number 1,62,55,7
2009-10-02,2,Bed Number 2,100,31,69
2009-10-02,3,Bed Number 3,34,6,28
2009-10-03,1,Bed Number 1,74,73,1
2009-10-03,2,Bed Number 2,59,29,30
2009-10-03,3,Bed Number 3,40,32,8
2009-10-04,1,Bed Number 1,56,54,2
2009-10-04,2,Bed Number 2,37,36,1
2009-10-04,3,Bed Number 3,61,61,0
2009-10-05,1,Bed Number 1,62,34,28
2009-10-05,2,Bed Number 2,42,40,2
2009-10-05,3,Bed Number 3,57,4,53
2009-10-06,1,Bed Number 1,38,7,31
2009-10-06,2,Bed Number 2,33,24,9
2009-10-06,3,Bed Number 3,69,26,43
2009-10-07,1,Bed Number 1,29,0,29
2009-10-07,2,Bed Number 2,68,27,41
2009-10-07,3,Bed Number 3,80,13,67
2009-10-08,1,Bed Number 1,30,17,13
2009-10-08,2,Bed Number 2,44,32,12
2009-10-08,3,Bed Number 3,89,84,5
2009-10-09,1,Bed Number 1,57,11,46
2009-10-09,2,Bed Number 2,99,13,86
2009-10-09,3,Bed Number 3,99,67,32
2009-10-10,1,Bed Number 1,85,52,33
2009-10-10,2,Bed Number 2,18,8,10
2009-10-10,3,Bed Number 3,71,32,39
2009-10-11,1,Bed Number 1,90,84,6
2009-10-11,2,Bed Number 2,57,36,21
2009-10-11,3,Bed Number 3,17,17,0
2009-10-12,1,Bed Number 1,99,94,5
2009-10-12,2,Bed Number 2,60,42,18
2009-10-12,3,Bed Number 3,100,60,40
2009-10-13,1,Bed Number 1,65,38,27
2009-10-13,2,Bed Number 2,85,85,0
2009-10-13,3,Bed Number 3,76,34,42
2009-10-14,1,Bed Number 1,84,66,18
2009-10-14,2,Bed Number 2,31,23,8
2009-10-14,3,Bed Number 3,45,23,22
2009-10-15,1,Bed Number 1,83,10,73
2009-10-15,2,Bed Number 2,16,13,3
2009-10-15,3,Bed Number 3,17,14,3
2009-10-16,1,Bed Number 1,98,49,49
2009-10-16,2,Bed Number 2,42,20,22
2009-10-16,3,Bed Number 3,15,7,8
2009-10-17,1,Bed Number 1,23,19,4
2009-10-17,2,Bed Number 2,42,4,38
2009-10-17,3,Bed Number 3,82,45,37
2009-10-18,1,Bed Number 1,49,14,35
2009-10-18,2,Bed Number 2,53,28,25
2009-10-18,3,Bed Number 3,100,93,7
2009-10-19,1,Bed Number 1,19,2,17
2009-10-19,2,Bed Number 2,93,0,93
2009-10-19,3,Bed Number 3,19,13,6
2009-10-20,1,Bed Number 1,75,71,4
2009-10-20,2,Bed Number 2,60,39,21
2009-10-20,3,Bed Number 3,82,57,25
2009-10-21,1,Bed Number 1,70,17,53
2009-10-21,2,Bed Number 2,94,48,46
2009-10-21,3,Bed Number 3,42,9,33
2009-10-22,1,Bed Number 1,34,25,9
2009-10-22,2,Bed Number 2,15,4,11
2009-10-22,3,Bed Number 3,31,28,3
2009-10-23,1,Bed Number 1,50,36,14
2009-10-23,2,Bed Number 2,66,66,0
2009-10-23,3,Bed Number 3,76,10,66
2009-10-24,1,Bed Number 1,97,37,60
2009-10-24,2,Bed Number 2,13,6,7
2009-10-24,3,Bed Number 3,43,7,36
2009-10-25,1,Bed Number 1,85,69,16
2009-10-25,2,Bed Number 2,51,25,26
2009-10-25,3,Bed Number 3,20,4,16
2009-10-26,1,Bed Number 1,66,10,56
2009-10-26,2,Bed Number 2,87,44,43
2009-10-26,3,Bed Number 3,96,48,48
2009-10-27,1,Bed Number 1,22,6,16
2009-10-27,2,Bed Number 2,76,69,7
2009-10-27,3,Bed Number 3,50,46,4
2009-10-28,1,Bed Number 1,96,4,92
2009-10-28,2,Bed Number 2,13,8,5
2009-10-28,3,Bed Number 3,95,94,1
2009-10-29,1,Bed Number 1,56,41,15
2009-10-29,2,Bed Number 2,77,70,7
2009-10-29,3,Bed Number 3,74,27,47
2009-10-30,1,Bed Number 1,76,42,34
2009-10-30,2,Bed Number 2,56,29,27
2009-10-30,3,Bed Number 3,79,35,44
2009-10-31,1,Bed Number 1,85,22,63
2009-10-31,2,Bed Number 2,65,41,24
2009-10-31,3,Bed Number 3,20,2,18
2009-11-01,1,Bed Number 1,90,4,86
2009-11-01,2,Bed Number 2,41,4,37
2009-11-01,3,Bed Number 3,22,22,0
2009-11-02,1,Bed Number 1,35,1,34
2009-11-02,2,Bed Number 2,59,6,53
2009-11-02,3,Bed Number 3,42,8,34
2009-11-03,1,Bed Number 1,29,0,29
2009-11-03,2,Bed Number 2,82,17,65
2009-11-03,3,Bed Number 3,74,1,73
2009-11-04,1,Bed Number 1,63,9,54
2009-11-04,2,Bed Number 2,92,10,82
2009-11-04,3,Bed Number 3,60,16,44
2009-11-05,1,Bed Number 1,53,46,7
2009-11-05,2,Bed Number 2,50,49,1
2009-11-05,3,Bed Number 3,69,36,33
2009-11-06,1,Bed Number 1,73,26,47
2009-11-06,2,Bed Number 2,41,3,38
2009-11-06,3,Bed Number 3,87,11,76
2009-11-07,1,Bed Number 1,95,81,14
2009-11-07,2,Bed Number 2,57,48,9
2009-11-07,3,Bed Number 3,42,41,1
2009-11-08,1,Bed Number 1,72,52,20
2009-11-08,2,Bed Number 2,33,3,30
2009-11-08,3,Bed Number 3,61,35,26
2009-11-09,1,Bed Number 1,85,36,49
2009-11-09,2,Bed Number 2,35,4,31
2009-11-09,3,Bed Number 3,57,38,19
2009-11-10,1,Bed Number 1,87,64,23
2009-11-10,2,Bed Number 2,53,51,2
2009-11-10,3,Bed Number 3,47,21,26
2009-11-11,1,Bed Number 1,34,33,1
2009-11-11,2,Bed Number 2,73,42,31
2009-11-11,3,Bed Number 3,14,5,9
2009-11-12,1,Bed Number 1,10,9,1
2009-11-12,2,Bed Number 2,91,70,21
2009-11-12,3,Bed Number 3,31,16,15
2009-11-13,1,Bed Number 1,28,0,28
2009-11-13,2,Bed Number 2,26,3,23
2009-11-13,3,Bed Number 3,32,27,5
2009-11-14,1,Bed Number 1,79,46,33
2009-11-14,2,Bed Number 2,100,49,51
2009-11-14,3,Bed Number 3,19,10,9
2009-11-15,1,Bed Number 1,46,10,36
2009-11-15,2,Bed Number 2,99,96,3
2009-11-15,3,Bed Number 3,97,14,83
2009-11-16,1,Bed Number 1,25,21,4
2009-11-16,2,Bed Number 2,24,10,14
2009-11-16,3,Bed Number 3,81,62,19
2009-11-17,1,Bed Number 1,83,76,7
2009-11-17,2,Bed Number 2,71,46,25
2009-11-17,3,Bed Number 3,79,61,18
2009-11-18,1,Bed Number 1,54,35,19
2009-11-18,2,Bed Number 2,82,48,34
2009-11-18,3,Bed Number 3,87,56,31
2009-11-19,1,Bed Number 1,10,2,8
2009-11-19,2,Bed Number 2,16,8,8
2009-11-19,3,Bed Number 3,50,19,31
2009-11-20,1,Bed Number 1,26,10,16
2009-11-20,2,Bed Number 2,20,10,10
2009-11-20,3,Bed Number 3,69,40,29
2009-11-21,1,Bed Number 1,33,33,0
2009-11-21,2,Bed Number 2,71,8,63
2009-11-21,3,Bed Number 3,23,15,8
2009-11-22,1,Bed Number 1,49,34,15
2009-11-22,2,Bed Number 2,85,8,77
2009-11-22,3,Bed Number 3,39,32,7
2009-11-23,1,Bed Number 1,18,7,11
2009-11-23,2,Bed Number 2,76,49,27
2009-11-23,3,Bed Number 3,99,43,56
2009-11-24,1,Bed Number 1,19,5,14
2009-11-24,2,Bed Number 2,58,40,18
2009-11-24,3,Bed Number 3,92,14,78
2009-11-25,1,Bed Number 1,93,10,83
2009-11-25,2,Bed Number 2,27,23,4
2009-11-25,3,Bed Number 3,71,29,42
2009-11-26,1,Bed Number 1,100,8,92
2009-11-26,2,Bed Number 2,99,15,84
2009-11-26,3,Bed Number 3,87,55,32
2009-11-27,1,Bed Number 1,46,39,7
2009-11-27,2,Bed Number 2,59,3,56
2009-11-27,3,Bed Number 3,81,81,0
2009-11-28,1,Bed Number 1,56,55,1
2009-11-28,2,Bed Number 2,90,52,38
2009-11-28,3,Bed Number 3,28,4,24
2009-11-29,1,Bed Number 1,57,49,8
2009-11-29,2,Bed Number 2,91,42,49
2009-11-29,3,Bed Number 3,53,53,0
2009-11-30,1,Bed Number 1,49,46,3
2009-11-30,2,Bed Number 2,62,12,50
2009-11-30,3,Bed Number 3,55,46,9
2009-12-01,1,Bed Number 1,39,39,0
2009-12-01,2,Bed Number 2,36,7,29
2009-12-01,3,Bed Number 3,59,43,16
2009-12-02,1,Bed Number 1,20,18,2
2009-12-02,2,Bed Number 2,51,50,1
2009-12-02,3,Bed Number 3,95,13,82
2009-12-03,1,Bed Number 1,99,35,64
2009-12-03,2,Bed Number 2,22,7,15
2009-12-03,3,Bed Number 3,41,29,12
2009-12-04,1,Bed Number 1,18,14,4
2009-12-04,2,Bed Number 2,82,76,6
2009-12-04,3,Bed Number 3,94,45,49
2009-12-05,1,Bed Number 1,60,40,20
2009-12-05,2,Bed Number 2,51,43,8
2009-12-05,3,Bed Number 3,53,49,4
2009-12-06,1,Bed Number 1,15,3,12
2009-12-06,2,Bed Number 2,95,15,80
2009-12-06,3,Bed Number 3,83,75,8
2009-12-07,1,Bed Number 1,98,66,32
2009-12-07,2,Bed Number 2,53,25,28
2009-12-07,3,Bed Number 3,55,46,9
2009-12-08,1,Bed Number 1,50,26,24
2009-12-08,2,Bed Number 2,90,9,81
2009-12-08,3,Bed Number 3,52,41,11
2009-12-09,1,Bed Number 1,10,10,0
2009-12-09,2,Bed Number 2,100,38,62
2009-12-09,3,Bed Number 3,19,4,15
2009-12-10,1,Bed Number 1,85,42,43
2009-12-10,2,Bed Number 2,88,43,45
2009-12-10,3,Bed Number 3,12,4,8
2009-12-11,1,Bed Number 1,42,9,33
2009-12-11,2,Bed Number 2,47,36,11
2009-12-11,3,Bed Number 3,60,35,25
2009-12-12,1,Bed Number 1,91,67,24
2009-12-12,2,Bed Number 2,25,18,7
2009-12-12,3,Bed Number 3,46,17,29
2009-12-13,1,Bed Number 1,21,5,16
2009-12-13,2,Bed Number 2,63,23,40
2009-12-13,3,Bed Number 3,53,40,13
2009-12-14,1,Bed Number 1,42,18,24
2009-12-14,2,Bed Number 2,73,56,17
2009-12-14,3,Bed Number 3,26,5,21
2009-12-15,1,Bed Number 1,79,59,20
2009-12-15,2,Bed Number 2,58,42,16
2009-12-15,3,Bed Number 3,31,10,21
2009-12-16,1,Bed Number 1,99,19,80
2009-12-16,2,Bed Number 2,84,66,18
2009-12-16,3,Bed Number 3,89,86,3
2009-12-17,1,Bed Number 1,20,3,17
2009-12-17,2,Bed Number 2,48,27,21
2009-12-17,3,Bed Number 3,81,9,72
2009-12-18,1,Bed Number 1,68,11,57
2009-12-18,2,Bed Number 2,90,61,29
2009-12-18,3,Bed Number 3,30,30,0
2009-12-19,1,Bed Number 1,59,44,15
2009-12-19,2,Bed Number 2,17,11,6
2009-12-19,3,Bed Number 3,65,33,32
2009-12-20,1,Bed Number 1,64,51,13
2009-12-20,2,Bed Number 2,49,25,24
2009-12-20,3,Bed Number 3,97,49,48
2009-12-21,1,Bed Number 1,69,61,8
2009-12-21,2,Bed Number 2,10,1,9
2009-12-21,3,Bed Number 3,85,73,12
2009-12-22,1,Bed Number 1,39,39,0
2009-12-22,2,Bed Number 2,35,33,2
2009-12-22,3,Bed Number 3,82,36,46
2009-12-23,1,Bed Number 1,90,71,19
2009-12-23,2,Bed Number 2,95,36,59
2009-12-23,3,Bed Number 3,20,17,3
2009-12-24,1,Bed Number 1,33,26,7
2009-12-24,2,Bed Number 2,28,7,21
2009-12-24,3,Bed Number 3,40,15,25
2009-12-25,1,Bed Number 1,73,71,2
2009-12-25,2,Bed Number 2,21,8,13
2009-12-25,3,Bed Number 3,65,1,64
2009-12-26,1,Bed Number 1,89,63,26
2009-12-26,2,Bed Number 2,40,37,3
2009-12-26,3,Bed Number 3,26,16,10
2009-12-27,1,Bed Number 1,66,16,50
2009-12-27,2,Bed Number 2,66,40,26
2009-12-27,3,Bed Number 3,88,31,57
2009-12-28,1,Bed Number 1,42,24,18
2009-12-28,2,Bed Number 2,68,41,27
2009-12-28,3,Bed Number 3,65,38,27
2009-12-29,1,Bed Number 1,53,10,43
2009-12-29,2,Bed Number 2,34,13,21
2009-12-29,3,Bed Number 3,62,26,36
2009-12-30,1,Bed Number 1,16,3,13
2009-12-30,2,Bed Number 2,65,56,9
2009-12-30,3,Bed Number 3,20,1,19
2009-12-31,1,Bed Number 1,89,84,5
2009-12-31,2,Bed Number 2,33,16,17
2009-12-31,3,Bed Number 3,87,78,9
2010-01-01,1,Bed Number 1,40,0,40
2010-01-01,2,Bed Number 2,75,9,66
2010-01-01,3,Bed Number 3,33,21,12
2010-01-02,1,Bed Number 1,22,1,21
2010-01-02,2,Bed Number 2,92,27,65
2010-01-02,3,Bed Number 3,29,23,6
2010-01-03,1,Bed Number 1,53,7,46
2010-01-03,2,Bed Number 2,77,48,29
2010-01-03,3,Bed Number 3,46,37,9
2010-01-04,1,Bed Number 1,38,34,4
2010-01-04,2,Bed Number 2,49,29,20
2010-01-04,3,Bed Number 3,33,31,2
2010-01-05,1,Bed Number 1,69,8,61
2010-01-05,2,Bed Number 2,60,32,28
2010-01-05,3,Bed Number 3,25,3,22
2010-01-06,1,Bed Number 1,63,33,30
2010-01-06,2,Bed Number 2,13,0,13
2010-01-06,3,Bed Number 3,32,31,1
2010-01-07,1,Bed Number 1,49,41,8
2010-01-07,2,Bed Number 2,53,43,10
2010-01-07,3,Bed Number 3,43,9,34
2010-01-08,1,Bed Number 1,82,37,45
2010-01-08,2,Bed Number 2,77,67,10
2010-01-08,3,Bed Number 3,64,30,34
2010-01-09,1,Bed Number 1,51,50,1
2010-01-09,2,Bed Number 2,49,24,25
2010-01-09,3,Bed Number 3,80,11,69
2010-01-10,1,Bed Number 1,87,31,56
2010-01-10,2,Bed Number 2,68,41,27
2010-01-10,3,Bed Number 3,73,58,15
2010-01-11,1,Bed Number 1,64,15,49
2010-01-11,2,Bed Number 2,20,10,10
2010-01-11,3,Bed Number 3,61,11,50
2010-01-12,1,Bed Number 1,22,18,4
2010-01-12,2,Bed Number 2,23,21,2
2010-01-12,3,Bed Number 3,43,0,43
2010-01-13,1,Bed Number 1,40,37,3
2010-01-13,2,Bed Number 2,44,2,42
2010-01-13,3,Bed Number 3,61,57,4
2010-01-14,1,Bed Number 1,25,2,23
2010-01-14,2,Bed Number 2,67,38,29
2010-01-14,3,Bed Number 3,95,86,9
2010-01-15,1,Bed Number 1,91,80,11
2010-01-15,2,Bed Number 2,41,0,41
2010-01-15,3,Bed Number 3,37,22,15
2010-01-16,1,Bed Number 1,60,38,22
2010-01-16,2,Bed Number 2,10,10,0
2010-01-16,3,Bed Number 3,17,6,11
2010-01-17,1,Bed Number 1,25,4,21
2010-01-17,2,Bed Number 2,41,19,22
2010-01-17,3,Bed Number 3,58,1,57
2010-01-18,1,Bed Number 1,90,68,22
2010-01-18,2,Bed Number 2,77,18,59
2010-01-18,3,Bed Number 3,99,40,59
2010-01-19,1,Bed Number 1,93,21,72
2010-01-19,2,Bed Number 2,38,18,20
2010-01-19,3,Bed Number 3,82,21,61
2010-01-20,1,Bed Number 1,37,17,20
2010-01-20,2,Bed Number 2,80,35,45
2010-01-20,3,Bed Number 3,52,47,5
2010-01-21,1,Bed Number 1,32,25,7
2010-01-21,2,Bed Number 2,92,7,85
2010-01-21,3,Bed Number 3,59,3,56
2010-01-22,1,Bed Number 1,85,1,84
2010-01-22,2,Bed Number 2,84,63,21
2010-01-22,3,Bed Number 3,12,7,5
2010-01-23,1,Bed Number 1,18,11,7
2010-01-23,2,Bed Number 2,95,81,14
2010-01-23,3,Bed Number 3,67,32,35
2010-01-24,1,Bed Number 1,76,53,23
2010-01-24,2,Bed Number 2,38,3,35
2010-01-24,3,Bed Number 3,23,11,12
2010-01-25,1,Bed Number 1,27,0,27
2010-01-25,2,Bed Number 2,100,98,2
2010-01-25,3,Bed Number 3,21,0,21
2010-01-26,1,Bed Number 1,94,91,3
2010-01-26,2,Bed Number 2,23,10,13
2010-01-26,3,Bed Number 3,65,25,40
2010-01-27,1,Bed Number 1,85,43,42
2010-01-27,2,Bed Number 2,31,12,19
2010-01-27,3,Bed Number 3,69,67,2
2010-01-28,1,Bed Number 1,32,7,25
2010-01-28,2,Bed Number 2,68,25,43
2010-01-28,3,Bed Number 3,90,45,45
2010-01-29,1,Bed Number 1,60,50,10
2010-01-29,2,Bed Number 2,30,21,9
2010-01-29,3,Bed Number 3,24,23,1
2010-01-30,1,Bed Number 1,22,15,7
2010-01-30,2,Bed Number 2,66,55,11
2010-01-30,3,Bed Number 3,78,48,30
2010-01-31,1,Bed Number 1,18,16,2
2010-01-31,2,Bed Number 2,60,57,3
2010-01-31,3,Bed Number 3,17,15,2
2010-02-01,1,Bed Number 1,78,9,69
2010-02-01,2,Bed Number 2,28,20,8
2010-02-01,3,Bed Number 3,78,74,4
2010-02-02,1,Bed Number 1,24,10,14
2010-02-02,2,Bed Number 2,31,18,13
2010-02-02,3,Bed Number 3,71,23,48
2010-02-03,1,Bed Number 1,75,64,11
2010-02-03,2,Bed Number 2,55,25,30
2010-02-03,3,Bed Number 3,51,48,3
2010-02-04,1,Bed Number 1,18,5,13
2010-02-04,2,Bed Number 2,47,15,32
2010-02-04,3,Bed Number 3,22,0,22
2010-02-05,1,Bed Number 1,43,22,21
2010-02-05,2,Bed Number 2,62,22,40
2010-02-05,3,Bed Number 3,28,17,11
2010-02-06,1,Bed Number 1,98,72,26
2010-02-06,2,Bed Number 2,36,3,33
2010-02-06,3,Bed Number 3,39,11,28
2010-02-07,1,Bed Number 1,62,54,8
2010-02-07,2,Bed Number 2,44,18,26
2010-02-07,3,Bed Number 3,25,2,23
2010-02-08,1,Bed Number 1,46,45,1
2010-02-08,2,Bed Number 2,93,9,84
2010-02-08,3,Bed Number 3,27,19,8
2010-02-09,1,Bed Number 1,45,9,36
2010-02-09,2,Bed Number 2,98,86,12
2010-02-09,3,Bed Number 3,93,49,44
2010-02-10,1,Bed Number 1,96,51,45
2010-02-10,2,Bed Number 2,58,21,37
2010-02-10,3,Bed Number 3,13,13,0
2010-02-11,1,Bed Number 1,44,13,31
2010-02-11,2,Bed Number 2,55,7,48
2010-02-11,3,Bed Number 3,20,6,14
2010-02-12,1,Bed Number 1,55,47,8
2010-02-12,2,Bed Number 2,49,12,37
2010-02-12,3,Bed Number 3,45,29,16
2010-02-13,1,Bed Number 1,40,13,27
2010-02-13,2,Bed Number 2,90,25,65
2010-02-13,3,Bed Number 3,91,52,39
2010-02-14,1,Bed Number 1,31,5,26
2010-02-14,2,Bed Number 2,47,34,13
2010-02-14,3,Bed Number 3,22,21,1
2010-02-15,1,Bed Number 1,34,29,5
2010-02-15,2,Bed Number 2,69,24,45
2010-02-15,3,Bed Number 3,55,6,49
2010-02-16,1,Bed Number 1,39,32,7
2010-02-16,2,Bed Number 2,67,32,35
2010-02-16,3,Bed Number 3,85,12,73
2010-02-17,1,Bed Number 1,75,19,56
2010-02-17,2,Bed Number 2,82,54,28
2010-02-17,3,Bed Number 3,40,7,33
2010-02-18,1,Bed Number 1,63,33,30
2010-02-18,2,Bed Number 2,97,94,3
2010-02-18,3,Bed Number 3,70,69,1
2010-02-19,1,Bed Number 1,11,11,0
2010-02-19,2,Bed Number 2,95,26,69
2010-02-19,3,Bed Number 3,62,17,45
2010-02-20,1,Bed Number 1,93,2,91
2010-02-20,2,Bed Number 2,26,4,22
2010-02-20,3,Bed Number 3,20,1,19
2010-02-21,1,Bed Number 1,32,7,25
2010-02-21,2,Bed Number 2,53,12,41
2010-02-21,3,Bed Number 3,45,41,4
2010-02-22,1,Bed Number 1,34,18,16
2010-02-22,2,Bed Number 2,88,41,47
2010-02-22,3,Bed Number 3,33,32,1
2010-02-23,1,Bed Number 1,84,79,5
2010-02-23,2,Bed Number 2,42,29,13
2010-02-23,3,Bed Number 3,30,26,4
2010-02-24,1,Bed Number 1,42,12,30
2010-02-24,2,Bed Number 2,20,13,7
2010-02-24,3,Bed Number 3,74,21,53
2010-02-25,1,Bed Number 1,65,23,42
2010-02-25,2,Bed Number 2,53,0,53
2010-02-25,3,Bed Number 3,36,14,22
2010-02-26,1,Bed Number 1,34,4,30
2010-02-26,2,Bed Number 2,16,12,4
2010-02-26,3,Bed Number 3,34,20,14
2010-02-27,1,Bed Number 1,66,24,42
2010-02-27,2,Bed Number 2,42,20,22
2010-02-27,3,Bed Number 3,34,3,31
2010-02-28,1,Bed Number 1,66,18,48
2010-02-28,2,Bed Number 2,100,57,43
2010-02-28,3,Bed Number 3,38,18,20
2010-03-01,1,Bed Number 1,70,40,30
2010-03-01,2,Bed Number 2,82,5,77
2010-03-01,3,Bed Number 3,13,6,7
2010-03-02,1,Bed Number 1,35,32,3
2010-03-02,2,Bed Number 2,63,44,19
2010-03-02,3,Bed Number 3,72,71,1
2010-03-03,1,Bed Number 1,57,1,56
2010-03-03,2,Bed Number 2,18,17,1
2010-03-03,3,Bed Number 3,77,0,77
2010-03-04,1,Bed Number 1,18,15,3
2010-03-04,2,Bed Number 2,38,13,25
2010-03-04,3,Bed Number 3,81,59,22
2010-03-05,1,Bed Number 1,89,76,13
2010-03-05,2,Bed Number 2,56,3,53
2010-03-05,3,Bed Number 3,59,29,30
2010-03-06,1,Bed Number 1,93,6,87
2010-03-06,2,Bed Number 2,97,30,67
2010-03-06,3,Bed Number 3,84,40,44
2010-03-07,1,Bed Number 1,68,59,9
2010-03-07,2,Bed Number 2,92,30,62
2010-03-07,3,Bed Number 3,96,46,50
2010-03-08,1,Bed Number 1,38,14,24
2010-03-08,2,Bed Number 2,85,52,33
2010-03-08,3,Bed Number 3,51,13,38
2010-03-09,1,Bed Number 1,50,45,5
2010-03-09,2,Bed Number 2,36,6,30
2010-03-09,3,Bed Number 3,63,25,38
2010-03-10,1,Bed Number 1,90,75,15
2010-03-10,2,Bed Number 2,81,21,60
2010-03-10,3,Bed Number 3,32,28,4
2010-03-11,1,Bed Number 1,46,38,8
2010-03-11,2,Bed Number 2,53,9,44
2010-03-11,3,Bed Number 3,16,8,8
2010-03-12,1,Bed Number 1,79,4,75
2010-03-12,2,Bed Number 2,11,5,6
2010-03-12,3,Bed Number 3,100,97,3
2010-03-13,1,Bed Number 1,23,14,9
2010-03-13,2,Bed Number 2,41,18,23
2010-03-13,3,Bed Number 3,57,33,24
2010-03-14,1,Bed Number 1,97,8,89
2010-03-14,2,Bed Number 2,81,26,55
2010-03-14,3,Bed Number 3,54,22,32
2010-03-15,1,Bed Number 1,98,64,34
2010-03-15,2,Bed Number 2,56,27,29
2010-03-15,3,Bed Number 3,79,32,47
2010-03-16,1,Bed Number 1,25,15,10
2010-03-16,2,Bed Number 2,71,61,10
2010-03-16,3,Bed Number 3,95,16,79
2010-03-17,1,Bed Number 1,47,15,32
2010-03-17,2,Bed Number 2,95,87,8
2010-03-17,3,Bed Number 3,63,7,56
2010-03-18,1,Bed Number 1,58,27,31
2010-03-18,2,Bed Number 2,48,45,3
2010-03-18,3,Bed Number 3,10,7,3
2010-03-19,1,Bed Number 1,97,26,71
2010-03-19,2,Bed Number 2,43,31,12
2010-03-19,3,Bed Number 3,65,64,1
2010-03-20,1,Bed Number 1,22,1,21
2010-03-20,2,Bed Number 2,37,28,9
2010-03-20,3,Bed Number 3,19,4,15
2010-03-21,1,Bed Number 1,39,18,21
2010-03-21,2,Bed Number 2,26,6,20
2010-03-21,3,Bed Number 3,96,24,72
2010-03-22,1,Bed Number 1,27,22,5
2010-03-22,2,Bed Number 2,63,25,38
2010-03-22,3,Bed Number 3,75,42,33
2010-03-23,1,Bed Number 1,31,6,25
2010-03-23,2,Bed Number 2,38,10,28
2010-03-23,3,Bed Number 3,83,81,2
2010-03-24,1,Bed Number 1,54,38,16
2010-03-24,2,Bed Number 2,24,14,10
2010-03-24,3,Bed Number 3,29,11,18
2010-03-25,1,Bed Number 1,24,11,13
2010-03-25,2,Bed Number 2,51,12,39
2010-03-25,3,Bed Number 3,17,8,9
2010-03-26,1,Bed Number 1,19,14,5
2010-03-26,2,Bed Number 2,83,31,52
2010-03-26,3,Bed Number 3,19,17,2
2010-03-27,1,Bed Number 1,95,59,36
2010-03-27,2,Bed Number 2,24,15,9
2010-03-27,3,Bed Number 3,95,29,66
2010-03-28,1,Bed Number 1,46,5,41
2010-03-28,2,Bed Number 2,25,11,14
2010-03-28,3,Bed Number 3,75,32,43
2010-03-29,1,Bed Number 1,38,14,24
2010-03-29,2,Bed Number 2,73,60,13
2010-03-29,3,Bed Number 3,77,65,12
2010-03-30,1,Bed Number 1,33,21,12
2010-03-30,2,Bed Number 2,29,20,9
2010-03-30,3,Bed Number 3,28,16,12
2010-03-31,1,Bed Number 1,18,11,7
2010-03-31,2,Bed Number 2,20,12,8
2010-03-31,3,Bed Number 3,63,61,2
2010-04-01,1,Bed Number 1,65,57,8
2010-04-01,2,Bed Number 2,28,21,7
2010-04-01,3,Bed Number 3,61,40,21
2010-04-02,1,Bed Number 1,48,32,16
2010-04-02,2,Bed Number 2,42,13,29
2010-04-02,3,Bed Number 3,88,0,88
2010-04-03,1,Bed Number 1,99,30,69
2010-04-03,2,Bed Number 2,60,37,23
2010-04-03,3,Bed Number 3,90,59,31
2010-04-04,1,Bed Number 1,69,21,48
2010-04-04,2,Bed Number 2,74,10,64
2010-04-04,3,Bed Number 3,15,13,2
2010-04-05,1,Bed Number 1,67,36,31
2010-04-05,2,Bed Number 2,84,58,26
2010-04-05,3,Bed Number 3,44,15,29
2010-04-06,1,Bed Number 1,88,33,55
2010-04-06,2,Bed Number 2,59,11,48
2010-04-06,3,Bed Number 3,62,22,40
2010-04-07,1,Bed Number 1,54,20,34
2010-04-07,2,Bed Number 2,40,38,2
2010-04-07,3,Bed Number 3,21,11,10
2010-04-08,1,Bed Number 1,72,64,8
2010-04-08,2,Bed Number 2,72,68,4
2010-04-08,3,Bed Number 3,48,18,30
2010-04-09,1,Bed Number 1,47,21,26
2010-04-09,2,Bed Number 2,75,17,58
2010-04-09,3,Bed Number 3,57,25,32
2010-04-10,1,Bed Number 1,92,43,49
2010-04-10,2,Bed Number 2,72,11,61
2010-04-10,3,Bed Number 3,10,6,4
2010-04-11,1,Bed Number 1,89,78,11
2010-04-11,2,Bed Number 2,86,82,4
2010-04-11,3,Bed Number 3,19,11,8
2010-04-12,1,Bed Number 1,81,36,45
2010-04-12,2,Bed Number 2,94,86,8
2010-04-12,3,Bed Number 3,62,3,59
2010-04-13,1,Bed Number 1,41,28,13
2010-04-13,2,Bed Number 2,76,39,37
2010-04-13,3,Bed Number 3,73,51,22
2010-04-14,1,Bed Number 1,92,35,57
2010-04-14,2,Bed Number 2,61,36,25
2010-04-14,3,Bed Number 3,96,80,16
2010-04-15,1,Bed Number 1,11,11,0
2010-04-15,2,Bed Number 2,12,10,2
2010-04-15,3,Bed Number 3,41,7,34
2010-04-16,1,Bed Number 1,64,48,16
2010-04-16,2,Bed Number 2,12,6,6
2010-04-16,3,Bed Number 3,40,29,11
2010-04-17,1,Bed Number 1,46,3,43
2010-04-17,2,Bed Number 2,12,8,4
2010-04-17,3,Bed Number 3,14,9,5
2010-04-18,1,Bed Number 1,29,13,16
2010-04-18,2,Bed Number 2,64,32,32
2010-04-18,3,Bed Number 3,44,29,15
2010-04-19,1,Bed Number 1,83,53,30
2010-04-19,2,Bed Number 2,32,9,23
2010-04-19,3,Bed Number 3,68,62,6
2010-04-20,1,Bed Number 1,98,55,43
2010-04-20,2,Bed Number 2,58,4,54
2010-04-20,3,Bed Number 3,37,26,11
2010-04-21,1,Bed Number 1,60,17,43
2010-04-21,2,Bed Number 2,78,18,60
2010-04-21,3,Bed Number 3,71,67,4
2010-04-22,1,Bed Number 1,76,41,35
2010-04-22,2,Bed Number 2,52,21,31
2010-04-22,3,Bed Number 3,50,49,1
2010-04-23,1,Bed Number 1,76,12,64
2010-04-23,2,Bed Number 2,66,44,22
2010-04-23,3,Bed Number 3,52,11,41
2010-04-24,1,Bed Number 1,29,20,9
2010-04-24,2,Bed Number 2,37,20,17
2010-04-24,3,Bed Number 3,27,18,9
2010-04-25,1,Bed Number 1,85,21,64
2010-04-25,2,Bed Number 2,31,25,6
2010-04-25,3,Bed Number 3,34,15,19
2010-04-26,1,Bed Number 1,89,57,32
2010-04-26,2,Bed Number 2,12,3,9
2010-04-26,3,Bed Number 3,35,13,22
2010-04-27,1,Bed Number 1,46,34,12
2010-04-27,2,Bed Number 2,15,5,10
2010-04-27,3,Bed Number 3,66,25,41
2010-04-28,1,Bed Number 1,96,26,70
2010-04-28,2,Bed Number 2,18,11,7
2010-04-28,3,Bed Number 3,92,22,70
2010-04-29,1,Bed Number 1,43,1,42
2010-04-29,2,Bed Number 2,36,19,17
2010-04-29,3,Bed Number 3,56,14,42
2010-04-30,1,Bed Number 1,22,9,13
2010-04-30,2,Bed Number 2,31,12,19
2010-04-30,3,Bed Number 3,84,80,4
2010-05-01,1,Bed Number 1,66,31,35
2010-05-01,2,Bed Number 2,84,76,8
2010-05-01,3,Bed Number 3,25,17,8
2010-05-02,1,Bed Number 1,85,58,27
2010-05-02,2,Bed Number 2,53,51,2
2010-05-02,3,Bed Number 3,76,64,12
2010-05-03,1,Bed Number 1,50,12,38
2010-05-03,2,Bed Number 2,78,31,47
2010-05-03,3,Bed Number 3,47,15,32
2010-05-04,1,Bed Number 1,99,75,24
2010-05-04,2,Bed Number 2,20,18,2
2010-05-04,3,Bed Number 3,85,3,82
2010-05-05,1,Bed Number 1,16,2,14
2010-05-05,2,Bed Number 2,22,7,15
2010-05-05,3,Bed Number 3,86,9,77
2010-05-06,1,Bed Number 1,72,0,72
2010-05-06,2,Bed Number 2,32,30,2
2010-05-06,3,Bed Number 3,76,66,10
2010-05-07,1,Bed Number 1,40,26,14
2010-05-07,2,Bed Number 2,49,3,46
2010-05-07,3,Bed Number 3,58,21,37
2010-05-08,1,Bed Number 1,47,11,36
2010-05-08,2,Bed Number 2,97,96,1
2010-05-08,3,Bed Number 3,58,43,15
2010-05-09,1,Bed Number 1,66,15,51
2010-05-09,2,Bed Number 2,20,14,6
2010-05-09,3,Bed Number 3,53,18,35
2010-05-10,1,Bed Number 1,38,25,13
2010-05-10,2,Bed Number 2,99,59,40
2010-05-10,3,Bed Number 3,12,0,12
2010-05-11,1,Bed Number 1,38,5,33
2010-05-11,2,Bed Number 2,90,46,44
2010-05-11,3,Bed Number 3,83,61,22
2010-05-12,1,Bed Number 1,38,21,17
2010-05-12,2,Bed Number 2,19,4,15
2010-05-12,3,Bed Number 3,91,43,48
2010-05-13,1,Bed Number 1,89,0,89
2010-05-13,2,Bed Number 2,16,6,10
2010-05-13,3,Bed Number 3,47,26,21
2010-05-14,1,Bed Number 1,44,30,14
2010-05-14,2,Bed Number 2,18,14,4
2010-05-14,3,Bed Number 3,83,24,59
2010-05-15,1,Bed Number 1,67,49,18
2010-05-15,2,Bed Number 2,75,74,1
2010-05-15,3,Bed Number 3,99,45,54
2010-05-16,1,Bed Number 1,17,5,12
2010-05-16,2,Bed Number 2,51,10,41
2010-05-16,3,Bed Number 3,87,60,27
2010-05-17,1,Bed Number 1,72,32,40
2010-05-17,2,Bed Number 2,20,11,9
2010-05-17,3,Bed Number 3,64,18,46
2010-05-18,1,Bed Number 1,49,19,30
2010-05-18,2,Bed Number 2,39,20,19
2010-05-18,3,Bed Number 3,93,84,9
2010-05-19,1,Bed Number 1,63,29,34
2010-05-19,2,Bed Number 2,64,0,64
2010-05-19,3,Bed Number 3,88,42,46
2010-05-20,1,Bed Number 1,34,1,33
2010-05-20,2,Bed Number 2,12,3,9
2010-05-20,3,Bed Number 3,70,30,40
2010-05-21,1,Bed Number 1,18,15,3
2010-05-21,2,Bed Number 2,10,4,6
2010-05-21,3,Bed Number 3,73,64,9
2010-05-22,1,Bed Number 1,70,57,13
2010-05-22,2,Bed Number 2,55,30,25
2010-05-22,3,Bed Number 3,17,10,7
2010-05-23,1,Bed Number 1,27,4,23
2010-05-23,2,Bed Number 2,70,29,41
2010-05-23,3,Bed Number 3,30,17,13
2010-05-24,1,Bed Number 1,100,86,14
2010-05-24,2,Bed Number 2,96,82,14
2010-05-24,3,Bed Number 3,49,1,48
2010-05-25,1,Bed Number 1,77,74,3
2010-05-25,2,Bed Number 2,62,26,36
2010-05-25,3,Bed Number 3,81,60,21
2010-05-26,1,Bed Number 1,28,17,11
2010-05-26,2,Bed Number 2,96,93,3
2010-05-26,3,Bed Number 3,62,41,21
2010-05-27,1,Bed Number 1,96,46,50
2010-05-27,2,Bed Number 2,32,14,18
2010-05-27,3,Bed Number 3,48,30,18
2010-05-28,1,Bed Number 1,75,50,25
2010-05-28,2,Bed Number 2,58,46,12
2010-05-28,3,Bed Number 3,52,29,23
2010-05-29,1,Bed Number 1,82,21,61
2010-05-29,2,Bed Number 2,58,55,3
2010-05-29,3,Bed Number 3,10,1,9
2010-05-30,1,Bed Number 1,33,21,12
2010-05-30,2,Bed Number 2,100,57,43
2010-05-30,3,Bed Number 3,83,46,37
2010-05-31,1,Bed Number 1,85,74,11
2010-05-31,2,Bed Number 2,57,21,36
2010-05-31,3,Bed Number 3,80,1,79
2010-06-01,1,Bed Number 1,62,1,61
2010-06-01,2,Bed Number 2,78,17,61
2010-06-01,3,Bed Number 3,62,11,51
2010-06-02,1,Bed Number 1,73,51,22
2010-06-02,2,Bed Number 2,75,48,27
2010-06-02,3,Bed Number 3,69,68,1
2010-06-03,1,Bed Number 1,80,64,16
2010-06-03,2,Bed Number 2,70,65,5
2010-06-03,3,Bed Number 3,88,25,63
2010-06-04,1,Bed Number 1,36,36,0
2010-06-04,2,Bed Number 2,39,22,17
2010-06-04,3,Bed Number 3,19,16,3
2010-06-05,1,Bed Number 1,46,11,35
2010-06-05,2,Bed Number 2,35,24,11
2010-06-05,3,Bed Number 3,71,60,11
2010-06-06,1,Bed Number 1,42,33,9
2010-06-06,2,Bed Number 2,70,9,61
2010-06-06,3,Bed Number 3,88,2,86
2010-06-07,1,Bed Number 1,89,73,16
2010-06-07,2,Bed Number 2,100,45,55
2010-06-07,3,Bed Number 3,70,33,37
2010-06-08,1,Bed Number 1,19,11,8
2010-06-08,2,Bed Number 2,64,51,13
2010-06-08,3,Bed Number 3,18,8,10
2010-06-09,1,Bed Number 1,59,46,13
2010-06-09,2,Bed Number 2,34,17,17
2010-06-09,3,Bed Number 3,42,20,22
2010-06-10,1,Bed Number 1,34,2,32
2010-06-10,2,Bed Number 2,68,41,27
2010-06-10,3,Bed Number 3,90,59,31
2010-06-11,1,Bed Number 1,34,12,22
2010-06-11,2,Bed Number 2,14,7,7
2010-06-11,3,Bed Number 3,24,0,24
2010-06-12,1,Bed Number 1,34,21,13
2010-06-12,2,Bed Number 2,69,12,57
2010-06-12,3,Bed Number 3,92,54,38
2010-06-13,1,Bed Number 1,67,7,60
2010-06-13,2,Bed Number 2,14,8,6
2010-06-13,3,Bed Number 3,81,81,0
2010-06-14,1,Bed Number 1,66,2,64
2010-06-14,2,Bed Number 2,28,26,2
2010-06-14,3,Bed Number 3,100,19,81
2010-06-15,1,Bed Number 1,35,24,11
2010-06-15,2,Bed Number 2,32,21,11
2010-06-15,3,Bed Number 3,20,17,3
2010-06-16,1,Bed Number 1,68,9,59
2010-06-16,2,Bed Number 2,78,63,15
2010-06-16,3,Bed Number 3,26,1,25
2010-06-17,1,Bed Number 1,72,61,11
2010-06-17,2,Bed Number 2,45,44,1
2010-06-17,3,Bed Number 3,60,19,41
2010-06-18,1,Bed Number 1,87,44,43
2010-06-18,2,Bed Number 2,55,24,31
2010-06-18,3,Bed Number 3,33,25,8
2010-06-19,1,Bed Number 1,73,22,51
2010-06-19,2,Bed Number 2,16,15,1
2010-06-19,3,Bed Number 3,60,0,60
2010-06-20,1,Bed Number 1,85,23,62
2010-06-20,2,Bed Number 2,18,11,7
2010-06-20,3,Bed Number 3,39,28,11
2010-06-21,1,Bed Number 1,87,67,20
2010-06-21,2,Bed Number 2,67,15,52
2010-06-21,3,Bed Number 3,69,15,54
2010-06-22,1,Bed Number 1,100,34,66
2010-06-22,2,Bed Number 2,30,1,29
2010-06-22,3,Bed Number 3,44,0,44
2010-06-23,1,Bed Number 1,26,11,15
2010-06-23,2,Bed Number 2,93,33,60
2010-06-23,3,Bed Number 3,94,17,77
2010-06-24,1,Bed Number 1,32,0,32
2010-06-24,2,Bed Number 2,83,1,82
2010-06-24,3,Bed Number 3,24,17,7
2010-06-25,1,Bed Number 1,29,17,12
2010-06-25,2,Bed Number 2,13,2,11
2010-06-25,3,Bed Number 3,11,2,9
2010-06-26,1,Bed Number 1,43,29,14
2010-06-26,2,Bed Number 2,26,11,15
2010-06-26,3,Bed Number 3,77,19,58
2010-06-27,1,Bed Number 1,48,1,47
2010-06-27,2,Bed Number 2,68,57,11
2010-06-27,3,Bed Number 3,10,9,1
2010-06-28,1,Bed Number 1,96,92,4
2010-06-28,2,Bed Number 2,71,51,20
2010-06-28,3,Bed Number 3,62,12,50
2010-06-29,1,Bed Number 1,40,17,23
2010-06-29,2,Bed Number 2,85,62,23
2010-06-29,3,Bed Number 3,26,6,20
2010-06-30,1,Bed Number 1,42,24,18
2010-06-30,2,Bed Number 2,27,4,23
2010-06-30,3,Bed Number 3,23,12,11
2010-07-01,1,Bed Number 1,21,19,2
2010-07-01,2,Bed Number 2,89,71,18
2010-07-01,3,Bed Number 3,15,4,11
2010-07-02,1,Bed Number 1,18,3,15
2010-07-02,2,Bed Number 2,55,27,28
2010-07-02,3,Bed Number 3,98,64,34
2010-07-03,1,Bed Number 1,19,14,5
2010-07-03,2,Bed Number 2,73,66,7
2010-07-03,3,Bed Number 3,47,5,42
2010-07-04,1,Bed Number 1,88,10,78
2010-07-04,2,Bed Number 2,62,31,31
2010-07-04,3,Bed Number 3,80,79,1
2010-07-05,1,Bed Number 1,66,9,57
2010-07-05,2,Bed Number 2,23,7,16
2010-07-05,3,Bed Number 3,71,21,50
2010-07-06,1,Bed Number 1,24,2,22
2010-07-06,2,Bed Number 2,90,15,75
2010-07-06,3,Bed Number 3,78,13,65
2010-07-07,1,Bed Number 1,97,23,74
2010-07-07,2,Bed Number 2,97,69,28
2010-07-07,3,Bed Number 3,89,81,8
2010-07-08,1,Bed Number 1,28,5,23
2010-07-08,2,Bed Number 2,83,83,0
2010-07-08,3,Bed Number 3,28,12,16
2010-07-09,1,Bed Number 1,23,2,21
2010-07-09,2,Bed Number 2,52,6,46
2010-07-09,3,Bed Number 3,18,8,10
2010-07-10,1,Bed Number 1,51,6,45
2010-07-10,2,Bed Number 2,27,9,18
2010-07-10,3,Bed Number 3,61,17,44
2010-07-11,1,Bed Number 1,49,24,25
2010-07-11,2,Bed Number 2,50,2,48
2010-07-11,3,Bed Number 3,90,63,27
2010-07-12,1,Bed Number 1,53,18,35
2010-07-12,2,Bed Number 2,41,28,13
2010-07-12,3,Bed Number 3,75,44,31
2010-07-13,1,Bed Number 1,77,66,11
2010-07-13,2,Bed Number 2,33,10,23
2010-07-13,3,Bed Number 3,75,65,10
2010-07-14,1,Bed Number 1,99,96,3
2010-07-14,2,Bed Number 2,15,4,11
2010-07-14,3,Bed Number 3,11,2,9
2010-07-15,1,Bed Number 1,70,5,65
2010-07-15,2,Bed Number 2,40,17,23
2010-07-15,3,Bed Number 3,92,89,3
2010-07-16,1,Bed Number 1,22,13,9
2010-07-16,2,Bed Number 2,30,29,1
2010-07-16,3,Bed Number 3,73,53,20
2010-07-17,1,Bed Number 1,11,6,5
2010-07-17,2,Bed Number 2,17,4,13
2010-07-17,3,Bed Number 3,42,1,41
2010-07-18,1,Bed Number 1,82,19,63
2010-07-18,2,Bed Number 2,78,67,11
2010-07-18,3,Bed Number 3,86,84,2
2010-07-19,1,Bed Number 1,39,15,24
2010-07-19,2,Bed Number 2,63,57,6
2010-07-19,3,Bed Number 3,48,4,44
2010-07-20,1,Bed Number 1,53,2,51
2010-07-20,2,Bed Number 2,87,64,23
2010-07-20,3,Bed Number 3,88,26,62
2010-07-21,1,Bed Number 1,52,32,20
2010-07-21,2,Bed Number 2,92,90,2
2010-07-21,3,Bed Number 3,13,5,8
2010-07-22,1,Bed Number 1,42,42,0
2010-07-22,2,Bed Number 2,16,15,1
2010-07-22,3,Bed Number 3,51,1,50
2010-07-23,1,Bed Number 1,46,41,5
2010-07-23,2,Bed Number 2,15,5,10
2010-07-23,3,Bed Number 3,37,23,14
2010-07-24,1,Bed Number 1,58,48,10
2010-07-24,2,Bed Number 2,28,26,2
2010-07-24,3,Bed Number 3,63,46,17
2010-07-25,1,Bed Number 1,92,3,89
2010-07-25,2,Bed Number 2,94,94,0
2010-07-25,3,Bed Number 3,81,55,26
2010-07-26,1,Bed Number 1,13,10,3
2010-07-26,2,Bed Number 2,77,9,68
2010-07-26,3,Bed Number 3,61,49,12
2010-07-27,1,Bed Number 1,42,38,4
2010-07-27,2,Bed Number 2,57,48,9
2010-07-27,3,Bed Number 3,35,34,1
2010-07-28,1,Bed Number 1,15,7,8
2010-07-28,2,Bed Number 2,75,4,71
2010-07-28,3,Bed Number 3,77,69,8
2010-07-29,1,Bed Number 1,19,6,13
2010-07-29,2,Bed Number 2,26,17,9
2010-07-29,3,Bed Number 3,42,21,21
2010-07-30,1,Bed Number 1,97,27,70
2010-07-30,2,Bed Number 2,99,97,2
2010-07-30,3,Bed Number 3,50,50,0
2010-07-31,1,Bed Number 1,61,5,56
2010-07-31,2,Bed Number 2,48,6,42
2010-07-31,3,Bed Number 3,94,46,48
2010-08-01,1,Bed Number 1,84,59,25
2010-08-01,2,Bed Number 2,32,9,23
2010-08-01,3,Bed Number 3,94,53,41
2010-08-02,1,Bed Number 1,89,68,21
2010-08-02,2,Bed Number 2,40,22,18
2010-08-02,3,Bed Number 3,97,7,90
2010-08-03,1,Bed Number 1,45,40,5
2010-08-03,2,Bed Number 2,24,16,8
2010-08-03,3,Bed Number 3,58,1,57
2010-08-04,1,Bed Number 1,13,4,9
2010-08-04,2,Bed Number 2,57,57,0
2010-08-04,3,Bed Number 3,97,34,63
2010-08-05,1,Bed Number 1,15,4,11
2010-08-05,2,Bed Number 2,98,71,27
2010-08-05,3,Bed Number 3,100,2,98
2010-08-06,1,Bed Number 1,33,15,18
2010-08-06,2,Bed Number 2,29,12,17
2010-08-06,3,Bed Number 3,88,39,49
2010-08-07,1,Bed Number 1,67,33,34
2010-08-07,2,Bed Number 2,56,21,35
2010-08-07,3,Bed Number 3,33,11,22
2010-08-08,1,Bed Number 1,82,47,35
2010-08-08,2,Bed Number 2,64,18,46
2010-08-08,3,Bed Number 3,95,50,45
2010-08-09,1,Bed Number 1,56,5,51
2010-08-09,2,Bed Number 2,12,0,12
2010-08-09,3,Bed Number 3,41,28,13
2010-08-10,1,Bed Number 1,88,40,48
2010-08-10,2,Bed Number 2,57,34,23
2010-08-10,3,Bed Number 3,47,33,14
2010-08-11,1,Bed Number 1,85,79,6
2010-08-11,2,Bed Number 2,92,64,28
2010-08-11,3,Bed Number 3,54,28,26
2010-08-12,1,Bed Number 1,85,48,37
2010-08-12,2,Bed Number 2,43,23,20
2010-08-12,3,Bed Number 3,52,25,27
2010-08-13,1,Bed Number 1,64,24,40
2010-08-13,2,Bed Number 2,15,3,12
2010-08-13,3,Bed Number 3,51,13,38
2010-08-14,1,Bed Number 1,66,63,3
2010-08-14,2,Bed Number 2,61,40,21
2010-08-14,3,Bed Number 3,63,6,57
2010-08-15,1,Bed Number 1,89,37,52
2010-08-15,2,Bed Number 2,39,38,1
2010-08-15,3,Bed Number 3,34,26,8
2010-08-16,1,Bed Number 1,19,4,15
2010-08-16,2,Bed Number 2,81,17,64
2010-08-16,3,Bed Number 3,57,37,20
2010-08-17,1,Bed Number 1,91,35,56
2010-08-17,2,Bed Number 2,99,45,54
2010-08-17,3,Bed Number 3,70,52,18
2010-08-18,1,Bed Number 1,10,7,3
2010-08-18,2,Bed Number 2,51,11,40
2010-08-18,3,Bed Number 3,69,11,58
2010-08-19,1,Bed Number 1,30,20,10
2010-08-19,2,Bed Number 2,22,19,3
2010-08-19,3,Bed Number 3,79,5,74
2010-08-20,1,Bed Number 1,59,11,48
2010-08-20,2,Bed Number 2,82,66,16
2010-08-20,3,Bed Number 3,23,13,10
2010-08-21,1,Bed Number 1,89,15,74
2010-08-21,2,Bed Number 2,57,45,12
2010-08-21,3,Bed Number 3,99,95,4
2010-08-22,1,Bed Number 1,93,58,35
2010-08-22,2,Bed Number 2,69,68,1
2010-08-22,3,Bed Number 3,44,15,29
2010-08-23,1,Bed Number 1,63,36,27
2010-08-23,2,Bed Number 2,20,11,9
2010-08-23,3,Bed Number 3,78,71,7
2010-08-24,1,Bed Number 1,36,18,18
2010-08-24,2,Bed Number 2,93,45,48
2010-08-24,3,Bed Number 3,83,56,27
2010-08-25,1,Bed Number 1,56,39,17
2010-08-25,2,Bed Number 2,21,2,19
2010-08-25,3,Bed Number 3,15,12,3
2010-08-26,1,Bed Number 1,53,10,43
2010-08-26,2,Bed Number 2,60,1,59
2010-08-26,3,Bed Number 3,27,9,18
2010-08-27,1,Bed Number 1,45,17,28
2010-08-27,2,Bed Number 2,37,25,12
2010-08-27,3,Bed Number 3,29,18,11
2010-08-28,1,Bed Number 1,20,19,1
2010-08-28,2,Bed Number 2,65,47,18
2010-08-28,3,Bed Number 3,18,7,11
2010-08-29,1,Bed Number 1,51,40,11
2010-08-29,2,Bed Number 2,58,48,10
2010-08-29,3,Bed Number 3,34,0,34
2010-08-30,1,Bed Number 1,70,67,3
2010-08-30,2,Bed Number 2,33,26,7
2010-08-30,3,Bed Number 3,27,21,6
2010-08-31,1,Bed Number 1,92,37,55
2010-08-31,2,Bed Number 2,39,19,20
2010-08-31,3,Bed Number 3,16,4,12
2010-09-01,1,Bed Number 1,87,71,16
2010-09-01,2,Bed Number 2,56,21,35
2010-09-01,3,Bed Number 3,40,30,10
2010-09-02,1,Bed Number 1,30,24,6
2010-09-02,2,Bed Number 2,49,2,47
2010-09-02,3,Bed Number 3,20,7,13
2010-09-03,1,Bed Number 1,81,26,55
2010-09-03,2,Bed Number 2,88,66,22
2010-09-03,3,Bed Number 3,53,2,51
2010-09-04,1,Bed Number 1,87,27,60
2010-09-04,2,Bed Number 2,28,20,8
2010-09-04,3,Bed Number 3,52,49,3
2010-09-05,1,Bed Number 1,25,12,13
2010-09-05,2,Bed Number 2,70,0,70
2010-09-05,3,Bed Number 3,19,6,13
2010-09-06,1,Bed Number 1,20,17,3
2010-09-06,2,Bed Number 2,85,36,49
2010-09-06,3,Bed Number 3,45,45,0
2010-09-07,1,Bed Number 1,46,6,40
2010-09-07,2,Bed Number 2,35,17,18
2010-09-07,3,Bed Number 3,99,65,34
2010-09-08,1,Bed Number 1,77,45,32
2010-09-08,2,Bed Number 2,81,69,12
2010-09-08,3,Bed Number 3,13,9,4
2010-09-09,1,Bed Number 1,90,88,2
2010-09-09,2,Bed Number 2,71,42,29
2010-09-09,3,Bed Number 3,96,58,38
2010-09-10,1,Bed Number 1,57,7,50
2010-09-10,2,Bed Number 2,69,69,0
2010-09-10,3,Bed Number 3,97,42,55
2010-09-11,1,Bed Number 1,86,27,59
2010-09-11,2,Bed Number 2,90,47,43
2010-09-11,3,Bed Number 3,18,3,15
2010-09-12,1,Bed Number 1,40,17,23
2010-09-12,2,Bed Number 2,59,7,52
2010-09-12,3,Bed Number 3,80,67,13
2010-09-13,1,Bed Number 1,25,5,20
2010-09-13,2,Bed Number 2,36,34,2
2010-09-13,3,Bed Number 3,43,3,40
2010-09-14,1,Bed Number 1,33,26,7
2010-09-14,2,Bed Number 2,38,24,14
2010-09-14,3,Bed Number 3,18,8,10
2010-09-15,1,Bed Number 1,98,56,42
2010-09-15,2,Bed Number 2,55,39,16
2010-09-15,3,Bed Number 3,80,6,74
2010-09-16,1,Bed Number 1,97,74,23
2010-09-16,2,Bed Number 2,70,40,30
2010-09-16,3,Bed Number 3,18,11,7
2010-09-17,1,Bed Number 1,90,8,82
2010-09-17,2,Bed Number 2,22,16,6
2010-09-17,3,Bed Number 3,73,21,52
2010-09-18,1,Bed Number 1,25,1,24
2010-09-18,2,Bed Number 2,15,5,10
2010-09-18,3,Bed Number 3,29,10,19
2010-09-19,1,Bed Number 1,49,47,2
2010-09-19,2,Bed Number 2,57,46,11
2010-09-19,3,Bed Number 3,42,33,9
2010-09-20,1,Bed Number 1,25,22,3
2010-09-20,2,Bed Number 2,58,47,11
2010-09-20,3,Bed Number 3,59,15,44
2010-09-21,1,Bed Number 1,12,7,5
2010-09-21,2,Bed Number 2,91,32,59
2010-09-21,3,Bed Number 3,34,5,29
2010-09-22,1,Bed Number 1,93,71,22
2010-09-22,2,Bed Number 2,59,31,28
2010-09-22,3,Bed Number 3,47,5,42
2010-09-23,1,Bed Number 1,11,2,9
2010-09-23,2,Bed Number 2,78,51,27
2010-09-23,3,Bed Number 3,21,13,8
2010-09-24,1,Bed Number 1,45,40,5
2010-09-24,2,Bed Number 2,87,7,80
2010-09-24,3,Bed Number 3,18,15,3
2010-09-25,1,Bed Number 1,85,67,18
2010-09-25,2,Bed Number 2,30,21,9
2010-09-25,3,Bed Number 3,66,40,26
2010-09-26,1,Bed Number 1,20,19,1
2010-09-26,2,Bed Number 2,17,12,5
2010-09-26,3,Bed Number 3,58,12,46
2010-09-27,1,Bed Number 1,63,20,43
2010-09-27,2,Bed Number 2,75,68,7
2010-09-27,3,Bed Number 3,92,75,17
2010-09-28,1,Bed Number 1,73,41,32
2010-09-28,2,Bed Number 2,66,29,37
2010-09-28,3,Bed Number 3,56,0,56
2010-09-29,1,Bed Number 1,83,31,52
2010-09-29,2,Bed Number 2,80,71,9
2010-09-29,3,Bed Number 3,58,47,11
2010-09-30,1,Bed Number 1,23,17,6
2010-09-30,2,Bed Number 2,32,29,3
2010-09-30,3,Bed Number 3,15,13,2
2010-10-01,1,Bed Number 1,38,16,22
2010-10-01,2,Bed Number 2,27,18,9
2010-10-01,3,Bed Number 3,39,20,19
2010-10-02,1,Bed Number 1,90,18,72
2010-10-02,2,Bed Number 2,63,32,31
2010-10-02,3,Bed Number 3,33,26,7
2010-10-03,1,Bed Number 1,53,35,18
2010-10-03,2,Bed Number 2,35,31,4
2010-10-03,3,Bed Number 3,34,34,0
2010-10-04,1,Bed Number 1,29,23,6
2010-10-04,2,Bed Number 2,68,56,12
2010-10-04,3,Bed Number 3,44,43,1
2010-10-05,1,Bed Number 1,75,39,36
2010-10-05,2,Bed Number 2,49,5,44
2010-10-05,3,Bed Number 3,71,0,71
2010-10-06,1,Bed Number 1,52,24,28
2010-10-06,2,Bed Number 2,79,19,60
2010-10-06,3,Bed Number 3,48,4,44
2010-10-07,1,Bed Number 1,24,10,14
2010-10-07,2,Bed Number 2,90,84,6
2010-10-07,3,Bed Number 3,29,8,21
2010-10-08,1,Bed Number 1,72,72,0
2010-10-08,2,Bed Number 2,89,9,80
2010-10-08,3,Bed Number 3,22,12,10
2010-10-09,1,Bed Number 1,29,23,6
2010-10-09,2,Bed Number 2,47,4,43
2010-10-09,3,Bed Number 3,20,15,5
2010-10-10,1,Bed Number 1,86,26,60
2010-10-10,2,Bed Number 2,85,13,72
2010-10-10,3,Bed Number 3,74,53,21
2010-10-11,1,Bed Number 1,95,82,13
2010-10-11,2,Bed Number 2,19,0,19
2010-10-11,3,Bed Number 3,12,5,7
2010-10-12,1,Bed Number 1,25,15,10
2010-10-12,2,Bed Number 2,13,2,11
2010-10-12,3,Bed Number 3,64,43,21
2010-10-13,1,Bed Number 1,58,44,14
2010-10-13,2,Bed Number 2,95,69,26
2010-10-13,3,Bed Number 3,84,0,84
2010-10-14,1,Bed Number 1,98,96,2
2010-10-14,2,Bed Number 2,60,44,16
2010-10-14,3,Bed Number 3,86,78,8
2010-10-15,1,Bed Number 1,39,3,36
2010-10-15,2,Bed Number 2,31,22,9
2010-10-15,3,Bed Number 3,19,4,15
2010-10-16,1,Bed Number 1,62,3,59
2010-10-16,2,Bed Number 2,47,9,38
2010-10-16,3,Bed Number 3,24,5,19
2010-10-17,1,Bed Number 1,94,6,88
2010-10-17,2,Bed Number 2,99,98,1
2010-10-17,3,Bed Number 3,87,13,74
2010-10-18,1,Bed Number 1,18,17,1
2010-10-18,2,Bed Number 2,15,7,8
2010-10-18,3,Bed Number 3,52,22,30
2010-10-19,1,Bed Number 1,94,53,41
2010-10-19,2,Bed Number 2,43,6,37
2010-10-19,3,Bed Number 3,44,22,22
2010-10-20,1,Bed Number 1,42,2,40
2010-10-20,2,Bed Number 2,24,5,19
2010-10-20,3,Bed Number 3,35,11,24
2010-10-21,1,Bed Number 1,59,22,37
2010-10-21,2,Bed Number 2,35,22,13
2010-10-21,3,Bed Number 3,46,21,25
2010-10-22,1,Bed Number 1,55,40,15
2010-10-22,2,Bed Number 2,64,64,0
2010-10-22,3,Bed Number 3,38,20,18
2010-10-23,1,Bed Number 1,27,18,9
2010-10-23,2,Bed Number 2,79,28,51
2010-10-23,3,Bed Number 3,54,25,29
2010-10-24,1,Bed Number 1,33,18,15
2010-10-24,2,Bed Number 2,31,26,5
2010-10-24,3,Bed Number 3,61,39,22
2010-10-25,1,Bed Number 1,34,0,34
2010-10-25,2,Bed Number 2,66,9,57
2010-10-25,3,Bed Number 3,20,2,18
2010-10-26,1,Bed Number 1,35,9,26
2010-10-26,2,Bed Number 2,85,85,0
2010-10-26,3,Bed Number 3,93,12,81
2010-10-27,1,Bed Number 1,89,8,81
2010-10-27,2,Bed Number 2,33,12,21
2010-10-27,3,Bed Number 3,11,7,4
2010-10-28,1,Bed Number 1,84,6,78
2010-10-28,2,Bed Number 2,51,4,47
2010-10-28,3,Bed Number 3,86,31,55
2010-10-29,1,Bed Number 1,57,1,56
2010-10-29,2,Bed Number 2,34,30,4
2010-10-29,3,Bed Number 3,55,38,17
2010-10-30,1,Bed Number 1,47,7,40
2010-10-30,2,Bed Number 2,39,36,3
2010-10-30,3,Bed Number 3,69,23,46
2010-10-31,1,Bed Number 1,35,20,15
2010-10-31,2,Bed Number 2,94,12,82
2010-10-31,3,Bed Number 3,68,21,47
2010-11-01,1,Bed Number 1,14,6,8
2010-11-01,2,Bed Number 2,21,3,18
2010-11-01,3,Bed Number 3,99,18,81
2010-11-02,1,Bed Number 1,95,23,72
2010-11-02,2,Bed Number 2,40,40,0
2010-11-02,3,Bed Number 3,83,66,17
2010-11-03,1,Bed Number 1,99,42,57
2010-11-03,2,Bed Number 2,78,4,74
2010-11-03,3,Bed Number 3,73,20,53
2010-11-04,1,Bed Number 1,65,63,2
2010-11-04,2,Bed Number 2,12,8,4
2010-11-04,3,Bed Number 3,27,14,13
2010-11-05,1,Bed Number 1,34,9,25
2010-11-05,2,Bed Number 2,31,16,15
2010-11-05,3,Bed Number 3,76,2,74
2010-11-06,1,Bed Number 1,96,94,2
2010-11-06,2,Bed Number 2,74,69,5
2010-11-06,3,Bed Number 3,40,27,13
2010-11-07,1,Bed Number 1,18,12,6
2010-11-07,2,Bed Number 2,44,40,4
2010-11-07,3,Bed Number 3,92,44,48
2010-11-08,1,Bed Number 1,88,57,31
2010-11-08,2,Bed Number 2,18,5,13
2010-11-08,3,Bed Number 3,40,23,17
2010-11-09,1,Bed Number 1,31,16,15
2010-11-09,2,Bed Number 2,26,10,16
2010-11-09,3,Bed Number 3,41,18,23
2010-11-10,1,Bed Number 1,20,10,10
2010-11-10,2,Bed Number 2,29,26,3
2010-11-10,3,Bed Number 3,48,8,40
2010-11-11,1,Bed Number 1,66,10,56
2010-11-11,2,Bed Number 2,50,21,29
2010-11-11,3,Bed Number 3,57,24,33
2010-11-12,1,Bed Number 1,94,55,39
2010-11-12,2,Bed Number 2,51,0,51
2010-11-12,3,Bed Number 3,55,29,26
2010-11-13,1,Bed Number 1,76,7,69
2010-11-13,2,Bed Number 2,22,12,10
2010-11-13,3,Bed Number 3,25,13,12
2010-11-14,1,Bed Number 1,62,46,16
2010-11-14,2,Bed Number 2,61,45,16
2010-11-14,3,Bed Number 3,88,16,72
2010-11-15,1,Bed Number 1,76,62,14
2010-11-15,2,Bed Number 2,75,56,19
2010-11-15,3,Bed Number 3,14,4,10
2010-11-16,1,Bed Number 1,48,12,36
2010-11-16,2,Bed Number 2,48,26,22
2010-11-16,3,Bed Number 3,24,2,22
2010-11-17,1,Bed Number 1,93,72,21
2010-11-17,2,Bed Number 2,41,16,25
2010-11-17,3,Bed Number 3,94,85,9
2010-11-18,1,Bed Number 1,56,39,17
2010-11-18,2,Bed Number 2,37,21,16
2010-11-18,3,Bed Number 3,13,0,13
2010-11-19,1,Bed Number 1,91,49,42
2010-11-19,2,Bed Number 2,45,14,31
2010-11-19,3,Bed Number 3,81,44,37
2010-11-20,1,Bed Number 1,91,40,51
2010-11-20,2,Bed Number 2,72,69,3
2010-11-20,3,Bed Number 3,61,51,10
2010-11-21,1,Bed Number 1,32,24,8
2010-11-21,2,Bed Number 2,35,19,16
2010-11-21,3,Bed Number 3,51,6,45
2010-11-22,1,Bed Number 1,69,55,14
2010-11-22,2,Bed Number 2,15,13,2
2010-11-22,3,Bed Number 3,71,49,22
2010-11-23,1,Bed Number 1,86,11,75
2010-11-23,2,Bed Number 2,13,5,8
2010-11-23,3,Bed Number 3,39,38,1
2010-11-24,1,Bed Number 1,21,20,1
2010-11-24,2,Bed Number 2,19,15,4
2010-11-24,3,Bed Number 3,100,32,68
2010-11-25,1,Bed Number 1,83,56,27
2010-11-25,2,Bed Number 2,83,4,79
2010-11-25,3,Bed Number 3,31,10,21
2010-11-26,1,Bed Number 1,45,8,37
2010-11-26,2,Bed Number 2,87,23,64
2010-11-26,3,Bed Number 3,71,6,65
2010-11-27,1,Bed Number 1,54,1,53
2010-11-27,2,Bed Number 2,55,13,42
2010-11-27,3,Bed Number 3,65,62,3
2010-11-28,1,Bed Number 1,62,34,28
2010-11-28,2,Bed Number 2,69,21,48
2010-11-28,3,Bed Number 3,13,3,10
2010-11-29,1,Bed Number 1,68,5,63
2010-11-29,2,Bed Number 2,93,53,40
2010-11-29,3,Bed Number 3,36,31,5
2010-11-30,1,Bed Number 1,60,38,22
2010-11-30,2,Bed Number 2,15,7,8
2010-11-30,3,Bed Number 3,60,42,18
2010-12-01,1,Bed Number 1,57,18,39
2010-12-01,2,Bed Number 2,97,65,32
2010-12-01,3,Bed Number 3,61,13,48
2010-12-02,1,Bed Number 1,56,56,0
2010-12-02,2,Bed Number 2,55,37,18
2010-12-02,3,Bed Number 3,82,23,59
2010-12-03,1,Bed Number 1,48,12,36
2010-12-03,2,Bed Number 2,23,5,18
2010-12-03,3,Bed Number 3,92,64,28
2010-12-04,1,Bed Number 1,17,11,6
2010-12-04,2,Bed Number 2,77,13,64
2010-12-04,3,Bed Number 3,39,14,25
2010-12-05,1,Bed Number 1,19,3,16
2010-12-05,2,Bed Number 2,47,38,9
2010-12-05,3,Bed Number 3,46,8,38
2010-12-06,1,Bed Number 1,19,10,9
2010-12-06,2,Bed Number 2,88,12,76
2010-12-06,3,Bed Number 3,96,14,82
2010-12-07,1,Bed Number 1,69,15,54
2010-12-07,2,Bed Number 2,62,51,11
2010-12-07,3,Bed Number 3,19,6,13
2010-12-08,1,Bed Number 1,14,1,13
2010-12-08,2,Bed Number 2,32,21,11
2010-12-08,3,Bed Number 3,47,13,34
2010-12-09,1,Bed Number 1,98,28,70
2010-12-09,2,Bed Number 2,32,0,32
2010-12-09,3,Bed Number 3,74,44,30
2010-12-10,1,Bed Number 1,22,7,15
2010-12-10,2,Bed Number 2,79,38,41
2010-12-10,3,Bed Number 3,15,13,2
2010-12-11,1,Bed Number 1,38,19,19
2010-12-11,2,Bed Number 2,100,23,77
2010-12-11,3,Bed Number 3,92,68,24
2010-12-12,1,Bed Number 1,68,36,32
2010-12-12,2,Bed Number 2,11,7,4
2010-12-12,3,Bed Number 3,84,30,54
2010-12-13,1,Bed Number 1,78,13,65
2010-12-13,2,Bed Number 2,41,9,32
2010-12-13,3,Bed Number 3,91,48,43
2010-12-14,1,Bed Number 1,74,32,42
2010-12-14,2,Bed Number 2,92,44,48
2010-12-14,3,Bed Number 3,80,13,67
2010-12-15,1,Bed Number 1,93,42,51
2010-12-15,2,Bed Number 2,12,12,0
2010-12-15,3,Bed Number 3,26,23,3
2010-12-16,1,Bed Number 1,71,40,31
2010-12-16,2,Bed Number 2,79,72,7
2010-12-16,3,Bed Number 3,36,36,0
2010-12-17,1,Bed Number 1,10,1,9
2010-12-17,2,Bed Number 2,93,43,50
2010-12-17,3,Bed Number 3,63,1,62
2010-12-18,1,Bed Number 1,40,8,32
2010-12-18,2,Bed Number 2,14,8,6
2010-12-18,3,Bed Number 3,53,3,50
2010-12-19,1,Bed Number 1,78,61,17
2010-12-19,2,Bed Number 2,43,5,38
2010-12-19,3,Bed Number 3,26,14,12
2010-12-20,1,Bed Number 1,32,4,28
2010-12-20,2,Bed Number 2,14,4,10
2010-12-20,3,Bed Number 3,20,18,2
2010-12-21,1,Bed Number 1,57,34,23
2010-12-21,2,Bed Number 2,44,31,13
2010-12-21,3,Bed Number 3,51,9,42
2010-12-22,1,Bed Number 1,55,44,11
2010-12-22,2,Bed Number 2,59,56,3
2010-12-22,3,Bed Number 3,90,67,23
2010-12-23,1,Bed Number 1,97,60,37
2010-12-23,2,Bed Number 2,100,91,9
2010-12-23,3,Bed Number 3,29,13,16
2010-12-24,1,Bed Number 1,54,4,50
2010-12-24,2,Bed Number 2,44,19,25
2010-12-24,3,Bed Number 3,43,6,37
2010-12-25,1,Bed Number 1,41,36,5
2010-12-25,2,Bed Number 2,57,54,3
2010-12-25,3,Bed Number 3,82,46,36
2010-12-26,1,Bed Number 1,41,23,18
2010-12-26,2,Bed Number 2,62,11,51
2010-12-26,3,Bed Number 3,31,24,7
2010-12-27,1,Bed Number 1,82,55,27
2010-12-27,2,Bed Number 2,24,9,15
2010-12-27,3,Bed Number 3,50,26,24
2010-12-28,1,Bed Number 1,33,15,18
2010-12-28,2,Bed Number 2,40,34,6
2010-12-28,3,Bed Number 3,78,53,25
2010-12-29,1,Bed Number 1,47,13,34
2010-12-29,2,Bed Number 2,55,42,13
2010-12-29,3,Bed Number 3,36,21,15
2010-12-30,1,Bed Number 1,89,53,36
2010-12-30,2,Bed Number 2,78,78,0
2010-12-30,3,Bed Number 3,73,57,16
2010-12-31,1,Bed Number 1,23,1,22
2010-12-31,2,Bed Number 2,72,29,43
2010-12-31,3,Bed Number 3,75,56,19
2011-01-01,1,Bed Number 1,77,21,56
2011-01-01,2,Bed Number 2,83,64,19
2011-01-01,3,Bed Number 3,62,36,26
2011-01-02,1,Bed Number 1,67,42,25
2011-01-02,2,Bed Number 2,80,18,62
2011-01-02,3,Bed Number 3,32,15,17
2011-01-03,1,Bed Number 1,30,9,21
2011-01-03,2,Bed Number 2,63,18,45
2011-01-03,3,Bed Number 3,14,5,9
2011-01-04,1,Bed Number 1,99,48,51
2011-01-04,2,Bed Number 2,11,7,4
2011-01-04,3,Bed Number 3,50,3,47
2011-01-05,1,Bed Number 1,96,2,94
2011-01-05,2,Bed Number 2,51,12,39
2011-01-05,3,Bed Number 3,62,16,46
2011-01-06,1,Bed Number 1,91,40,51
2011-01-06,2,Bed Number 2,92,87,5
2011-01-06,3,Bed Number 3,68,13,55
2011-01-07,1,Bed Number 1,15,10,5
2011-01-07,2,Bed Number 2,55,16,39
2011-01-07,3,Bed Number 3,74,37,37
2011-01-08,1,Bed Number 1,96,86,10
2011-01-08,2,Bed Number 2,12,4,8
2011-01-08,3,Bed Number 3,92,4,88
2011-01-09,1,Bed Number 1,52,47,5
2011-01-09,2,Bed Number 2,48,13,35
2011-01-09,3,Bed Number 3,49,4,45
2011-01-10,1,Bed Number 1,22,7,15
2011-01-10,2,Bed Number 2,71,47,24
2011-01-10,3,Bed Number 3,97,95,2
2011-01-11,1,Bed Number 1,38,35,3
2011-01-11,2,Bed Number 2,43,32,11
2011-01-11,3,Bed Number 3,14,2,12
2011-01-12,1,Bed Number 1,67,50,17
2011-01-12,2,Bed Number 2,14,1,13
2011-01-12,3,Bed Number 3,72,58,14
2011-01-13,1,Bed Number 1,68,43,25
2011-01-13,2,Bed Number 2,97,27,70
2011-01-13,3,Bed Number 3,46,37,9
2011-01-14,1,Bed Number 1,23,19,4
2011-01-14,2,Bed Number 2,44,42,2
2011-01-14,3,Bed Number 3,41,38,3
2011-01-15,1,Bed Number 1,19,13,6
2011-01-15,2,Bed Number 2,89,15,74
2011-01-15,3,Bed Number 3,87,2,85
2011-01-16,1,Bed Number 1,58,6,52
2011-01-16,2,Bed Number 2,99,9,90
2011-01-16,3,Bed Number 3,99,36,63
2011-01-17,1,Bed Number 1,72,48,24
2011-01-17,2,Bed Number 2,14,5,9
2011-01-17,3,Bed Number 3,22,12,10
2011-01-18,1,Bed Number 1,87,79,8
2011-01-18,2,Bed Number 2,74,20,54
2011-01-18,3,Bed Number 3,74,55,19
2011-01-19,1,Bed Number 1,24,24,0
2011-01-19,2,Bed Number 2,17,7,10
2011-01-19,3,Bed Number 3,90,81,9
2011-01-20,1,Bed Number 1,33,9,24
2011-01-20,2,Bed Number 2,49,47,2
2011-01-20,3,Bed Number 3,21,19,2
2011-01-21,1,Bed Number 1,96,50,46
2011-01-21,2,Bed Number 2,36,16,20
2011-01-21,3,Bed Number 3,59,58,1
2011-01-22,1,Bed Number 1,53,29,24
2011-01-22,2,Bed Number 2,55,51,4
2011-01-22,3,Bed Number 3,43,43,0
2011-01-23,1,Bed Number 1,93,52,41
2011-01-23,2,Bed Number 2,45,20,25
2011-01-23,3,Bed Number 3,29,1,28
2011-01-24,1,Bed Number 1,23,9,14
2011-01-24,2,Bed Number 2,35,28,7
2011-01-24,3,Bed Number 3,16,14,2
2011-01-25,1,Bed Number 1,41,33,8
2011-01-25,2,Bed Number 2,81,41,40
2011-01-25,3,Bed Number 3,35,17,18
2011-01-26,1,Bed Number 1,91,55,36
2011-01-26,2,Bed Number 2,68,21,47
2011-01-26,3,Bed Number 3,98,85,13
2011-01-27,1,Bed Number 1,50,12,38
2011-01-27,2,Bed Number 2,21,12,9
2011-01-27,3,Bed Number 3,62,27,35
2011-01-28,1,Bed Number 1,48,26,22
2011-01-28,2,Bed Number 2,93,75,18
2011-01-28,3,Bed Number 3,88,3,85
2011-01-29,1,Bed Number 1,88,19,69
2011-01-29,2,Bed Number 2,25,2,23
2011-01-29,3,Bed Number 3,58,37,21
2011-01-30,1,Bed Number 1,100,36,64
2011-01-30,2,Bed Number 2,63,31,32
2011-01-30,3,Bed Number 3,43,15,28
2011-01-31,1,Bed Number 1,59,43,16
2011-01-31,2,Bed Number 2,64,33,31
2011-01-31,3,Bed Number 3,30,2,28
2011-02-01,1,Bed Number 1,66,25,41
2011-02-01,2,Bed Number 2,41,14,27
2011-02-01,3,Bed Number 3,21,4,17
2011-02-02,1,Bed Number 1,19,6,13
2011-02-02,2,Bed Number 2,66,19,47
2011-02-02,3,Bed Number 3,43,23,20
2011-02-03,1,Bed Number 1,63,63,0
2011-02-03,2,Bed Number 2,39,33,6
2011-02-03,3,Bed Number 3,45,23,22
2011-02-04,1,Bed Number 1,21,8,13
2011-02-04,2,Bed Number 2,64,35,29
2011-02-04,3,Bed Number 3,18,3,15
2011-02-05,1,Bed Number 1,87,29,58
2011-02-05,2,Bed Number 2,53,31,22
2011-02-05,3,Bed Number 3,17,7,10
2011-02-06,1,Bed Number 1,59,27,32
2011-02-06,2,Bed Number 2,74,6,68
2011-02-06,3,Bed Number 3,10,5,5
2011-02-07,1,Bed Number 1,55,27,28
2011-02-07,2,Bed Number 2,19,10,9
2011-02-07,3,Bed Number 3,87,68,19
2011-02-08,1,Bed Number 1,57,21,36
2011-02-08,2,Bed Number 2,80,28,52
2011-02-08,3,Bed Number 3,67,12,55
2011-02-09,1,Bed Number 1,44,24,20
2011-02-09,2,Bed Number 2,54,40,14
2011-02-09,3,Bed Number 3,59,37,22
2011-02-10,1,Bed Number 1,88,10,78
2011-02-10,2,Bed Number 2,11,0,11
2011-02-10,3,Bed Number 3,77,60,17
2011-02-11,1,Bed Number 1,84,76,8
2011-02-11,2,Bed Number 2,12,7,5
2011-02-11,3,Bed Number 3,17,0,17
2011-02-12,1,Bed Number 1,61,15,46
2011-02-12,2,Bed Number 2,48,45,3
2011-02-12,3,Bed Number 3,100,47,53
2011-02-13,1,Bed Number 1,48,42,6
2011-02-13,2,Bed Number 2,29,17,12
2011-02-13,3,Bed Number 3,73,7,66
2011-02-14,1,Bed Number 1,39,29,10
2011-02-14,2,Bed Number 2,17,14,3
2011-02-14,3,Bed Number 3,67,59,8
2011-02-15,1,Bed Number 1,11,3,8
2011-02-15,2,Bed Number 2,100,57,43
2011-02-15,3,Bed Number 3,52,52,0
2011-02-16,1,Bed Number 1,22,5,17
2011-02-16,2,Bed Number 2,60,60,0
2011-02-16,3,Bed Number 3,72,51,21
2011-02-17,1,Bed Number 1,100,22,78
2011-02-17,2,Bed Number 2,50,6,44
2011-02-17,3,Bed Number 3,25,22,3
2011-02-18,1,Bed Number 1,86,21,65
2011-02-18,2,Bed Number 2,70,24,46
2011-02-18,3,Bed Number 3,78,72,6
2011-02-19,1,Bed Number 1,87,68,19
2011-02-19,2,Bed Number 2,41,26,15
2011-02-19,3,Bed Number 3,58,53,5
2011-02-20,1,Bed Number 1,87,38,49
2011-02-20,2,Bed Number 2,84,47,37
2011-02-20,3,Bed Number 3,25,4,21
2011-02-21,1,Bed Number 1,76,26,50
2011-02-21,2,Bed Number 2,61,61,0
2011-02-21,3,Bed Number 3,18,9,9
2011-02-22,1,Bed Number 1,67,39,28
2011-02-22,2,Bed Number 2,72,9,63
2011-02-22,3,Bed Number 3,89,47,42
2011-02-23,1,Bed Number 1,50,6,44
2011-02-23,2,Bed Number 2,64,7,57
2011-02-23,3,Bed Number 3,38,37,1
2011-02-24,1,Bed Number 1,69,33,36
2011-02-24,2,Bed Number 2,39,39,0
2011-02-24,3,Bed Number 3,68,64,4
2011-02-25,1,Bed Number 1,77,30,47
2011-02-25,2,Bed Number 2,88,30,58
2011-02-25,3,Bed Number 3,25,1,24
2011-02-26,1,Bed Number 1,16,14,2
2011-02-26,2,Bed Number 2,91,20,71
2011-02-26,3,Bed Number 3,43,5,38
2011-02-27,1,Bed Number 1,60,18,42
2011-02-27,2,Bed Number 2,52,28,24
2011-02-27,3,Bed Number 3,17,11,6
2011-02-28,1,Bed Number 1,60,42,18
2011-02-28,2,Bed Number 2,40,8,32
2011-02-28,3,Bed Number 3,74,10,64
2011-03-01,1,Bed Number 1,24,23,1
2011-03-01,2,Bed Number 2,31,17,14
2011-03-01,3,Bed Number 3,16,14,2
2011-03-02,1,Bed Number 1,40,15,25
2011-03-02,2,Bed Number 2,74,72,2
2011-03-02,3,Bed Number 3,53,15,38
2011-03-03,1,Bed Number 1,19,4,15
2011-03-03,2,Bed Number 2,41,10,31
2011-03-03,3,Bed Number 3,64,45,19
2011-03-04,1,Bed Number 1,36,2,34
2011-03-04,2,Bed Number 2,90,51,39
2011-03-04,3,Bed Number 3,21,11,10
2011-03-05,1,Bed Number 1,15,15,0
2011-03-05,2,Bed Number 2,44,8,36
2011-03-05,3,Bed Number 3,73,72,1
2011-03-06,1,Bed Number 1,24,2,22
2011-03-06,2,Bed Number 2,23,23,0
2011-03-06,3,Bed Number 3,39,15,24
2011-03-07,1,Bed Number 1,26,24,2
2011-03-07,2,Bed Number 2,90,32,58
2011-03-07,3,Bed Number 3,74,61,13
2011-03-08,1,Bed Number 1,68,11,57
2011-03-08,2,Bed Number 2,50,17,33
2011-03-08,3,Bed Number 3,50,18,32
2011-03-09,1,Bed Number 1,85,10,75
2011-03-09,2,Bed Number 2,83,76,7
2011-03-09,3,Bed Number 3,42,1,41
2011-03-10,1,Bed Number 1,52,41,11
2011-03-10,2,Bed Number 2,93,61,32
2011-03-10,3,Bed Number 3,95,75,20
2011-03-11,1,Bed Number 1,84,29,55
2011-03-11,2,Bed Number 2,47,6,41
2011-03-11,3,Bed Number 3,47,11,36
2011-03-12,1,Bed Number 1,26,25,1
2011-03-12,2,Bed Number 2,89,76,13
2011-03-12,3,Bed Number 3,28,16,12
2011-03-13,1,Bed Number 1,99,12,87
2011-03-13,2,Bed Number 2,20,8,12
2011-03-13,3,Bed Number 3,43,11,32
2011-03-14,1,Bed Number 1,35,26,9
2011-03-14,2,Bed Number 2,95,39,56
2011-03-14,3,Bed Number 3,22,4,18
2011-03-15,1,Bed Number 1,96,19,77
2011-03-15,2,Bed Number 2,17,15,2
2011-03-15,3,Bed Number 3,58,14,44
2011-03-16,1,Bed Number 1,93,85,8
2011-03-16,2,Bed Number 2,99,47,52
2011-03-16,3,Bed Number 3,67,5,62
2011-03-17,1,Bed Number 1,66,54,12
2011-03-17,2,Bed Number 2,27,14,13
2011-03-17,3,Bed Number 3,26,18,8
2011-03-18,1,Bed Number 1,19,6,13
2011-03-18,2,Bed Number 2,23,21,2
2011-03-18,3,Bed Number 3,67,50,17
2011-03-19,1,Bed Number 1,77,45,32
2011-03-19,2,Bed Number 2,83,56,27
2011-03-19,3,Bed Number 3,61,55,6
2011-03-20,1,Bed Number 1,97,89,8
2011-03-20,2,Bed Number 2,19,18,1
2011-03-20,3,Bed Number 3,61,1,60
2011-03-21,1,Bed Number 1,58,27,31
2011-03-21,2,Bed Number 2,79,41,38
2011-03-21,3,Bed Number 3,57,36,21
2011-03-22,1,Bed Number 1,24,24,0
2011-03-22,2,Bed Number 2,52,50,2
2011-03-22,3,Bed Number 3,26,25,1
2011-03-23,1,Bed Number 1,55,3,52
2011-03-23,2,Bed Number 2,98,1,97
2011-03-23,3,Bed Number 3,43,4,39
2011-03-24,1,Bed Number 1,94,46,48
2011-03-24,2,Bed Number 2,76,63,13
2011-03-24,3,Bed Number 3,45,6,39
2011-03-25,1,Bed Number 1,26,1,25
2011-03-25,2,Bed Number 2,29,21,8
2011-03-25,3,Bed Number 3,23,18,5
2011-03-26,1,Bed Number 1,91,82,9
2011-03-26,2,Bed Number 2,26,2,24
2011-03-26,3,Bed Number 3,88,40,48
2011-03-27,1,Bed Number 1,20,9,11
2011-03-27,2,Bed Number 2,61,55,6
2011-03-27,3,Bed Number 3,36,11,25
2011-03-28,1,Bed Number 1,85,81,4
2011-03-28,2,Bed Number 2,68,2,66
2011-03-28,3,Bed Number 3,83,11,72
2011-03-29,1,Bed Number 1,55,35,20
2011-03-29,2,Bed Number 2,69,51,18
2011-03-29,3,Bed Number 3,27,22,5
2011-03-30,1,Bed Number 1,66,45,21
2011-03-30,2,Bed Number 2,75,70,5
2011-03-30,3,Bed Number 3,95,24,71
2011-03-31,1,Bed Number 1,94,80,14
2011-03-31,2,Bed Number 2,12,4,8
2011-03-31,3,Bed Number 3,44,41,3
2011-04-01,1,Bed Number 1,98,2,96
2011-04-01,2,Bed Number 2,33,8,25
2011-04-01,3,Bed Number 3,62,10,52
2011-04-02,1,Bed Number 1,62,50,12
2011-04-02,2,Bed Number 2,81,45,36
2011-04-02,3,Bed Number 3,70,53,17
2011-04-03,1,Bed Number 1,86,9,77
2011-04-03,2,Bed Number 2,65,4,61
2011-04-03,3,Bed Number 3,37,21,16
2011-04-04,1,Bed Number 1,29,4,25
2011-04-04,2,Bed Number 2,37,11,26
2011-04-04,3,Bed Number 3,70,29,41
2011-04-05,1,Bed Number 1,87,51,36
2011-04-05,2,Bed Number 2,76,60,16
2011-04-05,3,Bed Number 3,59,24,35
2011-04-06,1,Bed Number 1,63,7,56
2011-04-06,2,Bed Number 2,10,6,4
2011-04-06,3,Bed Number 3,89,72,17
2011-04-07,1,Bed Number 1,91,14,77
2011-04-07,2,Bed Number 2,49,49,0
2011-04-07,3,Bed Number 3,81,67,14
2011-04-08,1,Bed Number 1,91,17,74
2011-04-08,2,Bed Number 2,91,84,7
2011-04-08,3,Bed Number 3,42,7,35
2011-04-09,1,Bed Number 1,31,3,28
2011-04-09,2,Bed Number 2,66,36,30
2011-04-09,3,Bed Number 3,28,10,18
2011-04-10,1,Bed Number 1,91,30,61
2011-04-10,2,Bed Number 2,25,20,5
2011-04-10,3,Bed Number 3,34,23,11
2011-04-11,1,Bed Number 1,36,7,29
2011-04-11,2,Bed Number 2,99,97,2
2011-04-11,3,Bed Number 3,20,3,17
2011-04-12,1,Bed Number 1,18,16,2
2011-04-12,2,Bed Number 2,50,31,19
2011-04-12,3,Bed Number 3,26,8,18
2011-04-13,1,Bed Number 1,23,17,6
2011-04-13,2,Bed Number 2,55,48,7
2011-04-13,3,Bed Number 3,15,3,12
2011-04-14,1,Bed Number 1,63,54,9
2011-04-14,2,Bed Number 2,88,55,33
2011-04-14,3,Bed Number 3,81,29,52
2011-04-15,1,Bed Number 1,27,16,11
2011-04-15,2,Bed Number 2,92,39,53
2011-04-15,3,Bed Number 3,43,7,36
2011-04-16,1,Bed Number 1,52,34,18
2011-04-16,2,Bed Number 2,37,32,5
2011-04-16,3,Bed Number 3,21,6,15
2011-04-17,1,Bed Number 1,82,20,62
2011-04-17,2,Bed Number 2,24,1,23
2011-04-17,3,Bed Number 3,65,7,58
2011-04-18,1,Bed Number 1,67,4,63
2011-04-18,2,Bed Number 2,15,13,2
2011-04-18,3,Bed Number 3,29,5,24
2011-04-19,1,Bed Number 1,49,5,44
2011-04-19,2,Bed Number 2,88,11,77
2011-04-19,3,Bed Number 3,38,7,31
2011-04-20,1,Bed Number 1,72,69,3
2011-04-20,2,Bed Number 2,43,25,18
2011-04-20,3,Bed Number 3,57,3,54
2011-04-21,1,Bed Number 1,42,41,1
2011-04-21,2,Bed Number 2,56,42,14
2011-04-21,3,Bed Number 3,33,32,1
2011-04-22,1,Bed Number 1,20,1,19
2011-04-22,2,Bed Number 2,26,5,21
2011-04-22,3,Bed Number 3,17,0,17
2011-04-23,1,Bed Number 1,62,39,23
2011-04-23,2,Bed Number 2,24,17,7
2011-04-23,3,Bed Number 3,35,11,24
2011-04-24,1,Bed Number 1,71,38,33
2011-04-24,2,Bed Number 2,98,59,39
2011-04-24,3,Bed Number 3,54,52,2
2011-04-25,1,Bed Number 1,57,19,38
2011-04-25,2,Bed Number 2,47,9,38
2011-04-25,3,Bed Number 3,15,12,3
2011-04-26,1,Bed Number 1,43,43,0
2011-04-26,2,Bed Number 2,33,22,11
2011-04-26,3,Bed Number 3,69,61,8
2011-04-27,1,Bed Number 1,98,19,79
2011-04-27,2,Bed Number 2,81,28,53
2011-04-27,3,Bed Number 3,31,29,2
2011-04-28,1,Bed Number 1,69,61,8
2011-04-28,2,Bed Number 2,27,22,5
2011-04-28,3,Bed Number 3,20,7,13
2011-04-29,1,Bed Number 1,65,17,48
2011-04-29,2,Bed Number 2,64,5,59
2011-04-29,3,Bed Number 3,66,8,58
2011-04-30,1,Bed Number 1,12,4,8
2011-04-30,2,Bed Number 2,85,51,34
2011-04-30,3,Bed Number 3,60,21,39
2011-05-01,1,Bed Number 1,55,35,20
2011-05-01,2,Bed Number 2,10,1,9
2011-05-01,3,Bed Number 3,68,24,44
2011-05-02,1,Bed Number 1,16,9,7
2011-05-02,2,Bed Number 2,72,23,49
2011-05-02,3,Bed Number 3,49,33,16
2011-05-03,1,Bed Number 1,97,24,73
2011-05-03,2,Bed Number 2,53,39,14
2011-05-03,3,Bed Number 3,82,17,65
2011-05-04,1,Bed Number 1,86,29,57
2011-05-04,2,Bed Number 2,23,16,7
2011-05-04,3,Bed Number 3,41,33,8
2011-05-05,1,Bed Number 1,11,7,4
2011-05-05,2,Bed Number 2,99,82,17
2011-05-05,3,Bed Number 3,81,6,75
2011-05-06,1,Bed Number 1,73,14,59
2011-05-06,2,Bed Number 2,60,39,21
2011-05-06,3,Bed Number 3,18,3,15
2011-05-07,1,Bed Number 1,60,16,44
2011-05-07,2,Bed Number 2,59,28,31
2011-05-07,3,Bed Number 3,80,58,22
2011-05-08,1,Bed Number 1,71,3,68
2011-05-08,2,Bed Number 2,69,5,64
2011-05-08,3,Bed Number 3,99,99,0
2011-05-09,1,Bed Number 1,27,10,17
2011-05-09,2,Bed Number 2,82,60,22
2011-05-09,3,Bed Number 3,44,27,17
2011-05-10,1,Bed Number 1,93,85,8
2011-05-10,2,Bed Number 2,10,6,4
2011-05-10,3,Bed Number 3,40,4,36
2011-05-11,1,Bed Number 1,81,41,40
2011-05-11,2,Bed Number 2,16,6,10
2011-05-11,3,Bed Number 3,22,17,5
2011-05-12,1,Bed Number 1,41,30,11
2011-05-12,2,Bed Number 2,71,7,64
2011-05-12,3,Bed Number 3,72,26,46
2011-05-13,1,Bed Number 1,14,6,8
2011-05-13,2,Bed Number 2,23,3,20
2011-05-13,3,Bed Number 3,97,84,13
2011-05-14,1,Bed Number 1,79,42,37
2011-05-14,2,Bed Number 2,69,0,69
2011-05-14,3,Bed Number 3,51,17,34
2011-05-15,1,Bed Number 1,17,5,12
2011-05-15,2,Bed Number 2,43,1,42
2011-05-15,3,Bed Number 3,66,50,16
2011-05-16,1,Bed Number 1,86,83,3
2011-05-16,2,Bed Number 2,85,68,17
2011-05-16,3,Bed Number 3,73,18,55
2011-05-17,1,Bed Number 1,44,17,27
2011-05-17,2,Bed Number 2,95,37,58
2011-05-17,3,Bed Number 3,65,2,63
2011-05-18,1,Bed Number 1,73,56,17
2011-05-18,2,Bed Number 2,43,20,23
2011-05-18,3,Bed Number 3,37,22,15
2011-05-19,1,Bed Number 1,72,71,1
2011-05-19,2,Bed Number 2,88,2,86
2011-05-19,3,Bed Number 3,86,78,8
2011-05-20,1,Bed Number 1,72,3,69
2011-05-20,2,Bed Number 2,69,47,22
2011-05-20,3,Bed Number 3,82,53,29
2011-05-21,1,Bed Number 1,12,6,6
2011-05-21,2,Bed Number 2,88,47,41
2011-05-21,3,Bed Number 3,17,14,3
2011-05-22,1,Bed Number 1,21,8,13
2011-05-22,2,Bed Number 2,98,81,17
2011-05-22,3,Bed Number 3,100,67,33
2011-05-23,1,Bed Number 1,99,37,62
2011-05-23,2,Bed Number 2,46,27,19
2011-05-23,3,Bed Number 3,20,10,10
2011-05-24,1,Bed Number 1,28,4,24
2011-05-24,2,Bed Number 2,35,8,27
2011-05-24,3,Bed Number 3,88,82,6
2011-05-25,1,Bed Number 1,43,7,36
2011-05-25,2,Bed Number 2,18,18,0
2011-05-25,3,Bed Number 3,67,50,17
2011-05-26,1,Bed Number 1,34,32,2
2011-05-26,2,Bed Number 2,32,26,6
2011-05-26,3,Bed Number 3,79,42,37
2011-05-27,1,Bed Number 1,46,20,26
2011-05-27,2,Bed Number 2,42,42,0
2011-05-27,3,Bed Number 3,55,42,13
2011-05-28,1,Bed Number 1,32,21,11
2011-05-28,2,Bed Number 2,19,0,19
2011-05-28,3,Bed Number 3,26,26,0
2011-05-29,1,Bed Number 1,11,3,8
2011-05-29,2,Bed Number 2,71,29,42
2011-05-29,3,Bed Number 3,59,9,50
2011-05-30,1,Bed Number 1,98,37,61
2011-05-30,2,Bed Number 2,66,11,55
2011-05-30,3,Bed Number 3,23,17,6
2011-05-31,1,Bed Number 1,36,18,18
2011-05-31,2,Bed Number 2,73,41,32
2011-05-31,3,Bed Number 3,88,86,2
2011-06-01,1,Bed Number 1,50,23,27
2011-06-01,2,Bed Number 2,45,31,14
2011-06-01,3,Bed Number 3,14,11,3
2011-06-02,1,Bed Number 1,24,17,7
2011-06-02,2,Bed Number 2,43,5,38
2011-06-02,3,Bed Number 3,88,6,82
2011-06-03,1,Bed Number 1,91,17,74
2011-06-03,2,Bed Number 2,23,9,14
2011-06-03,3,Bed Number 3,80,28,52
2011-06-04,1,Bed Number 1,61,17,44
2011-06-04,2,Bed Number 2,64,45,19
2011-06-04,3,Bed Number 3,55,18,37
2011-06-05,1,Bed Number 1,10,0,10
2011-06-05,2,Bed Number 2,22,18,4
2011-06-05,3,Bed Number 3,54,39,15
2011-06-06,1,Bed Number 1,66,33,33
2011-06-06,2,Bed Number 2,66,29,37
2011-06-06,3,Bed Number 3,93,9,84
2011-06-07,1,Bed Number 1,84,53,31
2011-06-07,2,Bed Number 2,66,60,6
2011-06-07,3,Bed Number 3,38,30,8
2011-06-08,1,Bed Number 1,71,63,8
2011-06-08,2,Bed Number 2,15,8,7
2011-06-08,3,Bed Number 3,49,23,26
2011-06-09,1,Bed Number 1,25,18,7
2011-06-09,2,Bed Number 2,19,4,15
2011-06-09,3,Bed Number 3,53,15,38
2011-06-10,1,Bed Number 1,52,46,6
2011-06-10,2,Bed Number 2,10,7,3
2011-06-10,3,Bed Number 3,34,24,10
2011-06-11,1,Bed Number 1,64,48,16
2011-06-11,2,Bed Number 2,64,26,38
2011-06-11,3,Bed Number 3,39,21,18
2011-06-12,1,Bed Number 1,85,37,48
2011-06-12,2,Bed Number 2,99,39,60
2011-06-12,3,Bed Number 3,29,11,18
2011-06-13,1,Bed Number 1,57,25,32
2011-06-13,2,Bed Number 2,72,55,17
2011-06-13,3,Bed Number 3,79,13,66
2011-06-14,1,Bed Number 1,31,16,15
2011-06-14,2,Bed Number 2,27,10,17
2011-06-14,3,Bed Number 3,80,16,64
2011-06-15,1,Bed Number 1,64,28,36
2011-06-15,2,Bed Number 2,62,55,7
2011-06-15,3,Bed Number 3,88,11,77
2011-06-16,1,Bed Number 1,76,13,63
2011-06-16,2,Bed Number 2,20,16,4
2011-06-16,3,Bed Number 3,59,29,30
2011-06-17,1,Bed Number 1,45,16,29
2011-06-17,2,Bed Number 2,49,47,2
2011-06-17,3,Bed Number 3,47,36,11
2011-06-18,1,Bed Number 1,29,27,2
2011-06-18,2,Bed Number 2,55,33,22
2011-06-18,3,Bed Number 3,26,15,11
2011-06-19,1,Bed Number 1,18,6,12
2011-06-19,2,Bed Number 2,40,1,39
2011-06-19,3,Bed Number 3,57,45,12
2011-06-20,1,Bed Number 1,68,21,47
2011-06-20,2,Bed Number 2,82,48,34
2011-06-20,3,Bed Number 3,20,6,14
2011-06-21,1,Bed Number 1,99,71,28
2011-06-21,2,Bed Number 2,53,1,52
2011-06-21,3,Bed Number 3,31,12,19
2011-06-22,1,Bed Number 1,79,62,17
2011-06-22,2,Bed Number 2,47,6,41
2011-06-22,3,Bed Number 3,13,8,5
2011-06-23,1,Bed Number 1,33,30,3
2011-06-23,2,Bed Number 2,88,75,13
2011-06-23,3,Bed Number 3,15,15,0
2011-06-24,1,Bed Number 1,58,35,23
2011-06-24,2,Bed Number 2,72,35,37
2011-06-24,3,Bed Number 3,98,87,11
2011-06-25,1,Bed Number 1,70,16,54
2011-06-25,2,Bed Number 2,58,52,6
2011-06-25,3,Bed Number 3,80,77,3
2011-06-26,1,Bed Number 1,39,13,26
2011-06-26,2,Bed Number 2,14,5,9
2011-06-26,3,Bed Number 3,16,2,14
2011-06-27,1,Bed Number 1,43,30,13
2011-06-27,2,Bed Number 2,49,0,49
2011-06-27,3,Bed Number 3,45,5,40
2011-06-28,1,Bed Number 1,76,45,31
2011-06-28,2,Bed Number 2,59,38,21
2011-06-28,3,Bed Number 3,51,25,26
2011-06-29,1,Bed Number 1,96,71,25
2011-06-29,2,Bed Number 2,20,8,12
2011-06-29,3,Bed Number 3,32,10,22
2011-06-30,1,Bed Number 1,47,17,30
2011-06-30,2,Bed Number 2,26,7,19
2011-06-30,3,Bed Number 3,29,11,18
2011-07-01,1,Bed Number 1,47,16,31
2011-07-01,2,Bed Number 2,66,50,16
2011-07-01,3,Bed Number 3,83,2,81
2011-07-02,1,Bed Number 1,54,54,0
2011-07-02,2,Bed Number 2,82,26,56
2011-07-02,3,Bed Number 3,83,69,14
2011-07-03,1,Bed Number 1,39,2,37
2011-07-03,2,Bed Number 2,99,45,54
2011-07-03,3,Bed Number 3,19,11,8
2011-07-04,1,Bed Number 1,94,68,26
2011-07-04,2,Bed Number 2,38,13,25
2011-07-04,3,Bed Number 3,53,14,39
2011-07-05,1,Bed Number 1,34,12,22
2011-07-05,2,Bed Number 2,42,5,37
2011-07-05,3,Bed Number 3,66,39,27
2011-07-06,1,Bed Number 1,65,64,1
2011-07-06,2,Bed Number 2,10,9,1
2011-07-06,3,Bed Number 3,42,2,40
2011-07-07,1,Bed Number 1,56,19,37
2011-07-07,2,Bed Number 2,42,42,0
2011-07-07,3,Bed Number 3,37,36,1
2011-07-08,1,Bed Number 1,35,0,35
2011-07-08,2,Bed Number 2,80,65,15
2011-07-08,3,Bed Number 3,21,19,2
2011-07-09,1,Bed Number 1,69,54,15
2011-07-09,2,Bed Number 2,90,17,73
2011-07-09,3,Bed Number 3,71,41,30
2011-07-10,1,Bed Number 1,95,67,28
2011-07-10,2,Bed Number 2,88,64,24
2011-07-10,3,Bed Number 3,40,5,35
2011-07-11,1,Bed Number 1,18,0,18
2011-07-11,2,Bed Number 2,24,16,8
2011-07-11,3,Bed Number 3,61,47,14
2011-07-12,1,Bed Number 1,94,2,92
2011-07-12,2,Bed Number 2,60,53,7
2011-07-12,3,Bed Number 3,68,30,38
2011-07-13,1,Bed Number 1,96,42,54
2011-07-13,2,Bed Number 2,49,28,21
2011-07-13,3,Bed Number 3,84,63,21
2011-07-14,1,Bed Number 1,49,42,7
2011-07-14,2,Bed Number 2,53,42,11
2011-07-14,3,Bed Number 3,72,64,8
2011-07-15,1,Bed Number 1,10,2,8
2011-07-15,2,Bed Number 2,79,62,17
2011-07-15,3,Bed Number 3,50,29,21
2011-07-16,1,Bed Number 1,65,45,20
2011-07-16,2,Bed Number 2,44,21,23
2011-07-16,3,Bed Number 3,58,42,16
2011-07-17,1,Bed Number 1,98,85,13
2011-07-17,2,Bed Number 2,53,28,25
2011-07-17,3,Bed Number 3,36,20,16
2011-07-18,1,Bed Number 1,67,44,23
2011-07-18,2,Bed Number 2,54,37,17
2011-07-18,3,Bed Number 3,95,35,60
2011-07-19,1,Bed Number 1,45,11,34
2011-07-19,2,Bed Number 2,15,10,5
2011-07-19,3,Bed Number 3,83,57,26
2011-07-20,1,Bed Number 1,57,40,17
2011-07-20,2,Bed Number 2,78,24,54
2011-07-20,3,Bed Number 3,38,21,17
2011-07-21,1,Bed Number 1,95,1,94
2011-07-21,2,Bed Number 2,12,4,8
2011-07-21,3,Bed Number 3,67,33,34
2011-07-22,1,Bed Number 1,30,24,6
2011-07-22,2,Bed Number 2,40,28,12
2011-07-22,3,Bed Number 3,27,15,12
2011-07-23,1,Bed Number 1,81,75,6
2011-07-23,2,Bed Number 2,57,33,24
2011-07-23,3,Bed Number 3,54,31,23
2011-07-24,1,Bed Number 1,45,31,14
2011-07-24,2,Bed Number 2,52,3,49
2011-07-24,3,Bed Number 3,73,32,41
2011-07-25,1,Bed Number 1,45,15,30
2011-07-25,2,Bed Number 2,57,29,28
2011-07-25,3,Bed Number 3,71,17,54
2011-07-26,1,Bed Number 1,99,98,1
2011-07-26,2,Bed Number 2,57,54,3
2011-07-26,3,Bed Number 3,99,22,77
2011-07-27,1,Bed Number 1,34,11,23
2011-07-27,2,Bed Number 2,63,37,26
2011-07-27,3,Bed Number 3,94,4,90
2011-07-28,1,Bed Number 1,95,15,80
2011-07-28,2,Bed Number 2,73,65,8
2011-07-28,3,Bed Number 3,46,3,43
2011-07-29,1,Bed Number 1,97,88,9
2011-07-29,2,Bed Number 2,89,47,42
2011-07-29,3,Bed Number 3,17,8,9
2011-07-30,1,Bed Number 1,89,27,62
2011-07-30,2,Bed Number 2,12,11,1
2011-07-30,3,Bed Number 3,30,14,16
2011-07-31,1,Bed Number 1,61,22,39
2011-07-31,2,Bed Number 2,15,8,7
2011-07-31,3,Bed Number 3,71,62,9
2011-08-01,1,Bed Number 1,58,10,48
2011-08-01,2,Bed Number 2,18,3,15
2011-08-01,3,Bed Number 3,29,3,26
2011-08-02,1,Bed Number 1,87,7,80
2011-08-02,2,Bed Number 2,23,1,22
2011-08-02,3,Bed Number 3,82,7,75
2011-08-03,1,Bed Number 1,63,26,37
2011-08-03,2,Bed Number 2,24,7,17
2011-08-03,3,Bed Number 3,72,63,9
2011-08-04,1,Bed Number 1,23,16,7
2011-08-04,2,Bed Number 2,100,5,95
2011-08-04,3,Bed Number 3,55,52,3
2011-08-05,1,Bed Number 1,85,52,33
2011-08-05,2,Bed Number 2,46,22,24
2011-08-05,3,Bed Number 3,22,9,13
2011-08-06,1,Bed Number 1,84,21,63
2011-08-06,2,Bed Number 2,76,35,41
2011-08-06,3,Bed Number 3,32,10,22
2011-08-07,1,Bed Number 1,85,48,37
2011-08-07,2,Bed Number 2,97,13,84
2011-08-07,3,Bed Number 3,89,74,15
2011-08-08,1,Bed Number 1,16,13,3
2011-08-08,2,Bed Number 2,78,30,48
2011-08-08,3,Bed Number 3,75,1,74
2011-08-09,1,Bed Number 1,29,17,12
2011-08-09,2,Bed Number 2,44,32,12
2011-08-09,3,Bed Number 3,91,33,58
2011-08-10,1,Bed Number 1,64,24,40
2011-08-10,2,Bed Number 2,37,27,10
2011-08-10,3,Bed Number 3,100,98,2
2011-08-11,1,Bed Number 1,29,6,23
2011-08-11,2,Bed Number 2,70,70,0
2011-08-11,3,Bed Number 3,91,36,55
2011-08-12,1,Bed Number 1,43,23,20
2011-08-12,2,Bed Number 2,18,10,8
2011-08-12,3,Bed Number 3,60,14,46
2011-08-13,1,Bed Number 1,24,13,11
2011-08-13,2,Bed Number 2,73,70,3
2011-08-13,3,Bed Number 3,16,13,3
2011-08-14,1,Bed Number 1,49,36,13
2011-08-14,2,Bed Number 2,50,46,4
2011-08-14,3,Bed Number 3,25,22,3
2011-08-15,1,Bed Number 1,89,17,72
2011-08-15,2,Bed Number 2,96,89,7
2011-08-15,3,Bed Number 3,62,23,39
2011-08-16,1,Bed Number 1,42,19,23
2011-08-16,2,Bed Number 2,73,51,22
2011-08-16,3,Bed Number 3,42,4,38
2011-08-17,1,Bed Number 1,56,53,3
2011-08-17,2,Bed Number 2,95,89,6
2011-08-17,3,Bed Number 3,32,24,8
2011-08-18,1,Bed Number 1,12,2,10
2011-08-18,2,Bed Number 2,10,1,9
2011-08-18,3,Bed Number 3,57,8,49
2011-08-19,1,Bed Number 1,49,28,21
2011-08-19,2,Bed Number 2,75,31,44
2011-08-19,3,Bed Number 3,97,80,17
2011-08-20,1,Bed Number 1,32,8,24
2011-08-20,2,Bed Number 2,86,80,6
2011-08-20,3,Bed Number 3,57,27,30
2011-08-21,1,Bed Number 1,95,34,61
2011-08-21,2,Bed Number 2,44,28,16
2011-08-21,3,Bed Number 3,95,27,68
2011-08-22,1,Bed Number 1,65,19,46
2011-08-22,2,Bed Number 2,70,42,28
2011-08-22,3,Bed Number 3,38,12,26
2011-08-23,1,Bed Number 1,17,8,9
2011-08-23,2,Bed Number 2,50,37,13
2011-08-23,3,Bed Number 3,14,6,8
2011-08-24,1,Bed Number 1,65,5,60
2011-08-24,2,Bed Number 2,93,18,75
2011-08-24,3,Bed Number 3,86,27,59
2011-08-25,1,Bed Number 1,83,45,38
2011-08-25,2,Bed Number 2,86,41,45
2011-08-25,3,Bed Number 3,92,31,61
2011-08-26,1,Bed Number 1,63,28,35
2011-08-26,2,Bed Number 2,52,23,29
2011-08-26,3,Bed Number 3,21,17,4
2011-08-27,1,Bed Number 1,95,64,31
2011-08-27,2,Bed Number 2,75,54,21
2011-08-27,3,Bed Number 3,55,31,24
2011-08-28,1,Bed Number 1,70,58,12
2011-08-28,2,Bed Number 2,33,20,13
2011-08-28,3,Bed Number 3,73,66,7
2011-08-29,1,Bed Number 1,48,8,40
2011-08-29,2,Bed Number 2,43,3,40
2011-08-29,3,Bed Number 3,99,72,27
2011-08-30,1,Bed Number 1,54,7,47
2011-08-30,2,Bed Number 2,45,0,45
2011-08-30,3,Bed Number 3,47,47,0
2011-08-31,1,Bed Number 1,23,23,0
2011-08-31,2,Bed Number 2,31,15,16
2011-08-31,3,Bed Number 3,82,65,17
2011-09-01,1,Bed Number 1,55,55,0
2011-09-01,2,Bed Number 2,22,3,19
2011-09-01,3,Bed Number 3,23,14,9
2011-09-02,1,Bed Number 1,82,13,69
2011-09-02,2,Bed Number 2,92,37,55
2011-09-02,3,Bed Number 3,90,88,2
2011-09-03,1,Bed Number 1,59,28,31
2011-09-03,2,Bed Number 2,34,17,17
2011-09-03,3,Bed Number 3,95,40,55
2011-09-04,1,Bed Number 1,67,5,62
2011-09-04,2,Bed Number 2,77,71,6
2011-09-04,3,Bed Number 3,25,13,12
2011-09-05,1,Bed Number 1,83,64,19
2011-09-05,2,Bed Number 2,41,10,31
2011-09-05,3,Bed Number 3,58,13,45
2011-09-06,1,Bed Number 1,48,26,22
2011-09-06,2,Bed Number 2,97,62,35
2011-09-06,3,Bed Number 3,87,20,67
2011-09-07,1,Bed Number 1,55,51,4
2011-09-07,2,Bed Number 2,86,57,29
2011-09-07,3,Bed Number 3,31,20,11
2011-09-08,1,Bed Number 1,35,29,6
2011-09-08,2,Bed Number 2,61,43,18
2011-09-08,3,Bed Number 3,81,25,56
2011-09-09,1,Bed Number 1,80,46,34
2011-09-09,2,Bed Number 2,88,27,61
2011-09-09,3,Bed Number 3,45,26,19
2011-09-10,1,Bed Number 1,27,21,6
2011-09-10,2,Bed Number 2,76,40,36
2011-09-10,3,Bed Number 3,57,35,22
2011-09-11,1,Bed Number 1,38,20,18
2011-09-11,2,Bed Number 2,29,20,9
2011-09-11,3,Bed Number 3,80,68,12
2011-09-12,1,Bed Number 1,66,36,30
2011-09-12,2,Bed Number 2,69,24,45
2011-09-12,3,Bed Number 3,56,22,34
2011-09-13,1,Bed Number 1,49,1,48
2011-09-13,2,Bed Number 2,61,12,49
2011-09-13,3,Bed Number 3,11,5,6
2011-09-14,1,Bed Number 1,27,2,25
2011-09-14,2,Bed Number 2,80,29,51
2011-09-14,3,Bed Number 3,94,32,62
2011-09-15,1,Bed Number 1,42,42,0
2011-09-15,2,Bed Number 2,19,4,15
2011-09-15,3,Bed Number 3,45,14,31
2011-09-16,1,Bed Number 1,50,3,47
2011-09-16,2,Bed Number 2,21,15,6
2011-09-16,3,Bed Number 3,71,23,48
2011-09-17,1,Bed Number 1,30,16,14
2011-09-17,2,Bed Number 2,60,1,59
2011-09-17,3,Bed Number 3,32,14,18
2011-09-18,1,Bed Number 1,85,28,57
2011-09-18,2,Bed Number 2,45,32,13
2011-09-18,3,Bed Number 3,31,26,5
2011-09-19,1,Bed Number 1,31,23,8
2011-09-19,2,Bed Number 2,42,18,24
2011-09-19,3,Bed Number 3,39,5,34
2011-09-20,1,Bed Number 1,90,80,10
2011-09-20,2,Bed Number 2,65,5,60
2011-09-20,3,Bed Number 3,95,19,76
2011-09-21,1,Bed Number 1,87,45,42
2011-09-21,2,Bed Number 2,62,16,46
2011-09-21,3,Bed Number 3,55,22,33
2011-09-22,1,Bed Number 1,43,30,13
2011-09-22,2,Bed Number 2,97,18,79
2011-09-22,3,Bed Number 3,42,7,35
2011-09-23,1,Bed Number 1,78,50,28
2011-09-23,2,Bed Number 2,99,1,98
2011-09-23,3,Bed Number 3,60,10,50
2011-09-24,1,Bed Number 1,43,7,36
2011-09-24,2,Bed Number 2,13,1,12
2011-09-24,3,Bed Number 3,87,50,37
2011-09-25,1,Bed Number 1,25,15,10
2011-09-25,2,Bed Number 2,54,21,33
2011-09-25,3,Bed Number 3,47,5,42
2011-09-26,1,Bed Number 1,63,35,28
2011-09-26,2,Bed Number 2,75,5,70
2011-09-26,3,Bed Number 3,13,7,6
2011-09-27,1,Bed Number 1,38,12,26
2011-09-27,2,Bed Number 2,40,16,24
2011-09-27,3,Bed Number 3,82,63,19
2011-09-28,1,Bed Number 1,40,37,3
2011-09-28,2,Bed Number 2,60,25,35
2011-09-28,3,Bed Number 3,83,56,27
2011-09-29,1,Bed Number 1,33,25,8
2011-09-29,2,Bed Number 2,74,30,44
2011-09-29,3,Bed Number 3,76,60,16
2011-09-30,1,Bed Number 1,50,22,28
2011-09-30,2,Bed Number 2,99,0,99
2011-09-30,3,Bed Number 3,24,23,1
2011-10-01,1,Bed Number 1,19,16,3
2011-10-01,2,Bed Number 2,63,16,47
2011-10-01,3,Bed Number 3,98,2,96
2011-10-02,1,Bed Number 1,54,14,40
2011-10-02,2,Bed Number 2,21,15,6
2011-10-02,3,Bed Number 3,40,16,24
2011-10-03,1,Bed Number 1,33,1,32
2011-10-03,2,Bed Number 2,54,51,3
2011-10-03,3,Bed Number 3,63,48,15
2011-10-04,1,Bed Number 1,35,16,19
2011-10-04,2,Bed Number 2,87,59,28
2011-10-04,3,Bed Number 3,66,59,7
2011-10-05,1,Bed Number 1,53,47,6
2011-10-05,2,Bed Number 2,78,1,77
2011-10-05,3,Bed Number 3,29,3,26
2011-10-06,1,Bed Number 1,96,55,41
2011-10-06,2,Bed Number 2,35,33,2
2011-10-06,3,Bed Number 3,24,23,1
2011-10-07,1,Bed Number 1,67,44,23
2011-10-07,2,Bed Number 2,12,4,8
2011-10-07,3,Bed Number 3,56,28,28
2011-10-08,1,Bed Number 1,12,9,3
2011-10-08,2,Bed Number 2,100,78,22
2011-10-08,3,Bed Number 3,12,7,5
2011-10-09,1,Bed Number 1,20,10,10
2011-10-09,2,Bed Number 2,41,5,36
2011-10-09,3,Bed Number 3,77,68,9
2011-10-10,1,Bed Number 1,14,9,5
2011-10-10,2,Bed Number 2,68,55,13
2011-10-10,3,Bed Number 3,35,23,12
2011-10-11,1,Bed Number 1,26,18,8
2011-10-11,2,Bed Number 2,100,68,32
2011-10-11,3,Bed Number 3,38,28,10
2011-10-12,1,Bed Number 1,32,1,31
2011-10-12,2,Bed Number 2,14,5,9
2011-10-12,3,Bed Number 3,10,9,1
2011-10-13,1,Bed Number 1,97,23,74
2011-10-13,2,Bed Number 2,56,39,17
2011-10-13,3,Bed Number 3,15,13,2
2011-10-14,1,Bed Number 1,82,74,8
2011-10-14,2,Bed Number 2,98,32,66
2011-10-14,3,Bed Number 3,33,13,20
2011-10-15,1,Bed Number 1,86,55,31
2011-10-15,2,Bed Number 2,72,5,67
2011-10-15,3,Bed Number 3,55,23,32
2011-10-16,1,Bed Number 1,12,8,4
2011-10-16,2,Bed Number 2,96,42,54
2011-10-16,3,Bed Number 3,33,24,9
2011-10-17,1,Bed Number 1,45,23,22
2011-10-17,2,Bed Number 2,55,19,36
2011-10-17,3,Bed Number 3,54,1,53
2011-10-18,1,Bed Number 1,57,41,16
2011-10-18,2,Bed Number 2,38,11,27
2011-10-18,3,Bed Number 3,77,66,11
2011-10-19,1,Bed Number 1,56,47,9
2011-10-19,2,Bed Number 2,49,31,18
2011-10-19,3,Bed Number 3,65,5,60
2011-10-20,1,Bed Number 1,17,1,16
2011-10-20,2,Bed Number 2,44,1,43
2011-10-20,3,Bed Number 3,73,46,27
2011-10-21,1,Bed Number 1,70,4,66
2011-10-21,2,Bed Number 2,79,70,9
2011-10-21,3,Bed Number 3,95,46,49
2011-10-22,1,Bed Number 1,66,39,27
2011-10-22,2,Bed Number 2,25,21,4
2011-10-22,3,Bed Number 3,56,43,13
2011-10-23,1,Bed Number 1,46,21,25
2011-10-23,2,Bed Number 2,98,47,51
2011-10-23,3,Bed Number 3,82,35,47
2011-10-24,1,Bed Number 1,36,5,31
2011-10-24,2,Bed Number 2,96,35,61
2011-10-24,3,Bed Number 3,100,19,81
2011-10-25,1,Bed Number 1,91,30,61
2011-10-25,2,Bed Number 2,88,71,17
2011-10-25,3,Bed Number 3,98,44,54
2011-10-26,1,Bed Number 1,57,5,52
2011-10-26,2,Bed Number 2,13,4,9
2011-10-26,3,Bed Number 3,76,31,45
2011-10-27,1,Bed Number 1,30,22,8
2011-10-27,2,Bed Number 2,29,25,4
2011-10-27,3,Bed Number 3,30,26,4
2011-10-28,1,Bed Number 1,10,6,4
2011-10-28,2,Bed Number 2,96,72,24
2011-10-28,3,Bed Number 3,13,13,0
2011-10-29,1,Bed Number 1,94,7,87
2011-10-29,2,Bed Number 2,69,53,16
2011-10-29,3,Bed Number 3,49,44,5
2011-10-30,1,Bed Number 1,70,61,9
2011-10-30,2,Bed Number 2,70,51,19
2011-10-30,3,Bed Number 3,20,10,10
2011-10-31,1,Bed Number 1,70,68,2
2011-10-31,2,Bed Number 2,18,13,5
2011-10-31,3,Bed Number 3,42,39,3
2011-11-01,1,Bed Number 1,15,1,14
2011-11-01,2,Bed Number 2,60,29,31
2011-11-01,3,Bed Number 3,69,30,39
2011-11-02,1,Bed Number 1,27,13,14
2011-11-02,2,Bed Number 2,39,7,32
2011-11-02,3,Bed Number 3,83,71,12
2011-11-03,1,Bed Number 1,98,7,91
2011-11-03,2,Bed Number 2,77,47,30
2011-11-03,3,Bed Number 3,23,23,0
2011-11-04,1,Bed Number 1,67,59,8
2011-11-04,2,Bed Number 2,49,36,13
2011-11-04,3,Bed Number 3,97,64,33
2011-11-05,1,Bed Number 1,80,25,55
2011-11-05,2,Bed Number 2,55,16,39
2011-11-05,3,Bed Number 3,43,28,15
2011-11-06,1,Bed Number 1,51,46,5
2011-11-06,2,Bed Number 2,46,43,3
2011-11-06,3,Bed Number 3,25,25,0
2011-11-07,1,Bed Number 1,98,48,50
2011-11-07,2,Bed Number 2,69,15,54
2011-11-07,3,Bed Number 3,29,29,0
2011-11-08,1,Bed Number 1,51,46,5
2011-11-08,2,Bed Number 2,37,33,4
2011-11-08,3,Bed Number 3,20,17,3
2011-11-09,1,Bed Number 1,25,14,11
2011-11-09,2,Bed Number 2,48,3,45
2011-11-09,3,Bed Number 3,94,73,21
2011-11-10,1,Bed Number 1,71,65,6
2011-11-10,2,Bed Number 2,60,32,28
2011-11-10,3,Bed Number 3,84,62,22
2011-11-11,1,Bed Number 1,94,1,93
2011-11-11,2,Bed Number 2,74,5,69
2011-11-11,3,Bed Number 3,69,22,47
2011-11-12,1,Bed Number 1,100,54,46
2011-11-12,2,Bed Number 2,76,6,70
2011-11-12,3,Bed Number 3,57,8,49
2011-11-13,1,Bed Number 1,42,40,2
2011-11-13,2,Bed Number 2,20,6,14
2011-11-13,3,Bed Number 3,40,10,30
2011-11-14,1,Bed Number 1,38,9,29
2011-11-14,2,Bed Number 2,87,78,9
2011-11-14,3,Bed Number 3,72,8,64
2011-11-15,1,Bed Number 1,60,18,42
2011-11-15,2,Bed Number 2,31,24,7
2011-11-15,3,Bed Number 3,57,2,55
2011-11-16,1,Bed Number 1,80,48,32
2011-11-16,2,Bed Number 2,64,36,28
2011-11-16,3,Bed Number 3,57,24,33
2011-11-17,1,Bed Number 1,66,25,41
2011-11-17,2,Bed Number 2,37,20,17
2011-11-17,3,Bed Number 3,81,73,8
2011-11-18,1,Bed Number 1,26,7,19
2011-11-18,2,Bed Number 2,84,18,66
2011-11-18,3,Bed Number 3,66,56,10
2011-11-19,1,Bed Number 1,15,0,15
2011-11-19,2,Bed Number 2,45,21,24
2011-11-19,3,Bed Number 3,57,19,38
2011-11-20,1,Bed Number 1,100,82,18
2011-11-20,2,Bed Number 2,14,2,12
2011-11-20,3,Bed Number 3,23,12,11
2011-11-21,1,Bed Number 1,92,57,35
2011-11-21,2,Bed Number 2,90,74,16
2011-11-21,3,Bed Number 3,20,4,16
2011-11-22,1,Bed Number 1,80,43,37
2011-11-22,2,Bed Number 2,90,88,2
2011-11-22,3,Bed Number 3,50,9,41
2011-11-23,1,Bed Number 1,97,43,54
2011-11-23,2,Bed Number 2,15,13,2
2011-11-23,3,Bed Number 3,16,15,1
2011-11-24,1,Bed Number 1,15,5,10
2011-11-24,2,Bed Number 2,75,8,67
2011-11-24,3,Bed Number 3,92,19,73
2011-11-25,1,Bed Number 1,89,69,20
2011-11-25,2,Bed Number 2,61,13,48
2011-11-25,3,Bed Number 3,99,1,98
2011-11-26,1,Bed Number 1,36,3,33
2011-11-26,2,Bed Number 2,71,6,65
2011-11-26,3,Bed Number 3,25,25,0
2011-11-27,1,Bed Number 1,51,42,9
2011-11-27,2,Bed Number 2,64,45,19
2011-11-27,3,Bed Number 3,30,9,21
2011-11-28,1,Bed Number 1,67,45,22
2011-11-28,2,Bed Number 2,78,12,66
2011-11-28,3,Bed Number 3,14,1,13
2011-11-29,1,Bed Number 1,27,5,22
2011-11-29,2,Bed Number 2,97,46,51
2011-11-29,3,Bed Number 3,19,14,5
2011-11-30,1,Bed Number 1,34,24,10
2011-11-30,2,Bed Number 2,21,10,11
2011-11-30,3,Bed Number 3,92,13,79
2011-12-01,1,Bed Number 1,51,8,43
2011-12-01,2,Bed Number 2,10,2,8
2011-12-01,3,Bed Number 3,72,24,48
2011-12-02,1,Bed Number 1,39,21,18
2011-12-02,2,Bed Number 2,10,10,0
2011-12-02,3,Bed Number 3,88,76,12
2011-12-03,1,Bed Number 1,73,71,2
2011-12-03,2,Bed Number 2,12,9,3
2011-12-03,3,Bed Number 3,27,10,17
2011-12-04,1,Bed Number 1,60,18,42
2011-12-04,2,Bed Number 2,94,74,20
2011-12-04,3,Bed Number 3,93,10,83
2011-12-05,1,Bed Number 1,29,25,4
2011-12-05,2,Bed Number 2,80,31,49
2011-12-05,3,Bed Number 3,39,33,6
2011-12-06,1,Bed Number 1,32,13,19
2011-12-06,2,Bed Number 2,83,11,72
2011-12-06,3,Bed Number 3,79,31,48
2011-12-07,1,Bed Number 1,30,21,9
2011-12-07,2,Bed Number 2,47,31,16
2011-12-07,3,Bed Number 3,30,13,17
2011-12-08,1,Bed Number 1,91,60,31
2011-12-08,2,Bed Number 2,98,66,32
2011-12-08,3,Bed Number 3,40,26,14
2011-12-09,1,Bed Number 1,84,9,75
2011-12-09,2,Bed Number 2,43,18,25
2011-12-09,3,Bed Number 3,15,14,1
2011-12-10,1,Bed Number 1,43,22,21
2011-12-10,2,Bed Number 2,100,2,98
2011-12-10,3,Bed Number 3,51,12,39
2011-12-11,1,Bed Number 1,62,1,61
2011-12-11,2,Bed Number 2,69,7,62
2011-12-11,3,Bed Number 3,63,9,54
2011-12-12,1,Bed Number 1,26,24,2
2011-12-12,2,Bed Number 2,23,8,15
2011-12-12,3,Bed Number 3,63,44,19
2011-12-13,1,Bed Number 1,63,46,17
2011-12-13,2,Bed Number 2,21,21,0
2011-12-13,3,Bed Number 3,62,6,56
2011-12-14,1,Bed Number 1,100,23,77
2011-12-14,2,Bed Number 2,27,0,27
2011-12-14,3,Bed Number 3,21,18,3
2011-12-15,1,Bed Number 1,17,8,9
2011-12-15,2,Bed Number 2,84,75,9
2011-12-15,3,Bed Number 3,84,68,16
2011-12-16,1,Bed Number 1,40,22,18
2011-12-16,2,Bed Number 2,36,31,5
2011-12-16,3,Bed Number 3,57,55,2
2011-12-17,1,Bed Number 1,75,53,22
2011-12-17,2,Bed Number 2,28,14,14
2011-12-17,3,Bed Number 3,99,86,13
2011-12-18,1,Bed Number 1,62,4,58
2011-12-18,2,Bed Number 2,40,19,21
2011-12-18,3,Bed Number 3,22,6,16
2011-12-19,1,Bed Number 1,47,36,11
2011-12-19,2,Bed Number 2,52,2,50
2011-12-19,3,Bed Number 3,95,85,10
2011-12-20,1,Bed Number 1,36,28,8
2011-12-20,2,Bed Number 2,18,11,7
2011-12-20,3,Bed Number 3,75,25,50
2011-12-21,1,Bed Number 1,42,23,19
2011-12-21,2,Bed Number 2,59,6,53
2011-12-21,3,Bed Number 3,29,7,22
2011-12-22,1,Bed Number 1,22,14,8
2011-12-22,2,Bed Number 2,91,68,23
2011-12-22,3,Bed Number 3,91,26,65
2011-12-23,1,Bed Number 1,28,5,23
2011-12-23,2,Bed Number 2,85,36,49
2011-12-23,3,Bed Number 3,90,35,55
2011-12-24,1,Bed Number 1,96,96,0
2011-12-24,2,Bed Number 2,82,34,48
2011-12-24,3,Bed Number 3,70,11,59
2011-12-25,1,Bed Number 1,17,14,3
2011-12-25,2,Bed Number 2,26,18,8
2011-12-25,3,Bed Number 3,57,4,53
2011-12-26,1,Bed Number 1,92,65,27
2011-12-26,2,Bed Number 2,37,22,15
2011-12-26,3,Bed Number 3,76,31,45
2011-12-27,1,Bed Number 1,70,38,32
2011-12-27,2,Bed Number 2,89,34,55
2011-12-27,3,Bed Number 3,19,9,10
2011-12-28,1,Bed Number 1,75,71,4
2011-12-28,2,Bed Number 2,66,44,22
2011-12-28,3,Bed Number 3,15,10,5
2011-12-29,1,Bed Number 1,15,7,8
2011-12-29,2,Bed Number 2,90,17,73
2011-12-29,3,Bed Number 3,26,4,22
2011-12-30,1,Bed Number 1,58,39,19
2011-12-30,2,Bed Number 2,29,10,19
2011-12-30,3,Bed Number 3,51,27,24
2011-12-31,1,Bed Number 1,57,3,54
2011-12-31,2,Bed Number 2,92,67,25
2011-12-31,3,Bed Number 3,18,16,2
2012-01-01,1,Bed Number 1,92,17,75
2012-01-01,2,Bed Number 2,36,1,35
2012-01-01,3,Bed Number 3,80,52,28
2012-01-02,1,Bed Number 1,14,4,10
2012-01-02,2,Bed Number 2,22,14,8
2012-01-02,3,Bed Number 3,81,79,2
2012-01-03,1,Bed Number 1,17,6,11
2012-01-03,2,Bed Number 2,80,46,34
2012-01-03,3,Bed Number 3,24,8,16
2012-01-04,1,Bed Number 1,90,62,28
2012-01-04,2,Bed Number 2,69,20,49
2012-01-04,3,Bed Number 3,92,91,1
2012-01-05,1,Bed Number 1,91,77,14
2012-01-05,2,Bed Number 2,22,22,0
2012-01-05,3,Bed Number 3,73,11,62
2012-01-06,1,Bed Number 1,31,5,26
2012-01-06,2,Bed Number 2,34,16,18
2012-01-06,3,Bed Number 3,28,7,21
2012-01-07,1,Bed Number 1,14,13,1
2012-01-07,2,Bed Number 2,96,83,13
2012-01-07,3,Bed Number 3,50,14,36
2012-01-08,1,Bed Number 1,82,40,42
2012-01-08,2,Bed Number 2,39,24,15
2012-01-08,3,Bed Number 3,28,25,3
2012-01-09,1,Bed Number 1,48,3,45
2012-01-09,2,Bed Number 2,38,21,17
2012-01-09,3,Bed Number 3,45,2,43
2012-01-10,1,Bed Number 1,83,54,29
2012-01-10,2,Bed Number 2,29,11,18
2012-01-10,3,Bed Number 3,50,42,8
2012-01-11,1,Bed Number 1,11,6,5
2012-01-11,2,Bed Number 2,65,32,33
2012-01-11,3,Bed Number 3,20,3,17
2012-01-12,1,Bed Number 1,29,15,14
2012-01-12,2,Bed Number 2,75,74,1
2012-01-12,3,Bed Number 3,86,52,34
2012-01-13,1,Bed Number 1,75,34,41
2012-01-13,2,Bed Number 2,74,58,16
2012-01-13,3,Bed Number 3,12,8,4
2012-01-14,1,Bed Number 1,81,48,33
2012-01-14,2,Bed Number 2,95,41,54
2012-01-14,3,Bed Number 3,60,9,51
2012-01-15,1,Bed Number 1,87,54,33
2012-01-15,2,Bed Number 2,91,57,34
2012-01-15,3,Bed Number 3,63,8,55
2012-01-16,1,Bed Number 1,64,10,54
2012-01-16,2,Bed Number 2,23,3,20
2012-01-16,3,Bed Number 3,29,18,11
2012-01-17,1,Bed Number 1,68,23,45
2012-01-17,2,Bed Number 2,23,2,21
2012-01-17,3,Bed Number 3,50,15,35
2012-01-18,1,Bed Number 1,89,33,56
2012-01-18,2,Bed Number 2,53,6,47
2012-01-18,3,Bed Number 3,76,69,7
2012-01-19,1,Bed Number 1,51,14,37
2012-01-19,2,Bed Number 2,16,6,10
2012-01-19,3,Bed Number 3,19,4,15
2012-01-20,1,Bed Number 1,92,86,6
2012-01-20,2,Bed Number 2,43,6,37
2012-01-20,3,Bed Number 3,31,6,25
2012-01-21,1,Bed Number 1,30,5,25
2012-01-21,2,Bed Number 2,13,0,13
2012-01-21,3,Bed Number 3,45,27,18
2012-01-22,1,Bed Number 1,12,0,12
2012-01-22,2,Bed Number 2,92,66,26
2012-01-22,3,Bed Number 3,63,63,0
2012-01-23,1,Bed Number 1,79,50,29
2012-01-23,2,Bed Number 2,48,13,35
2012-01-23,3,Bed Number 3,60,33,27
2012-01-24,1,Bed Number 1,18,5,13
2012-01-24,2,Bed Number 2,81,25,56
2012-01-24,3,Bed Number 3,47,28,19
2012-01-25,1,Bed Number 1,88,23,65
2012-01-25,2,Bed Number 2,67,39,28
2012-01-25,3,Bed Number 3,38,31,7
2012-01-26,1,Bed Number 1,86,10,76
2012-01-26,2,Bed Number 2,65,21,44
2012-01-26,3,Bed Number 3,19,16,3
2012-01-27,1,Bed Number 1,94,7,87
2012-01-27,2,Bed Number 2,72,17,55
2012-01-27,3,Bed Number 3,47,1,46
2012-01-28,1,Bed Number 1,57,45,12
2012-01-28,2,Bed Number 2,43,3,40
2012-01-28,3,Bed Number 3,51,36,15
2012-01-29,1,Bed Number 1,22,3,19
2012-01-29,2,Bed Number 2,30,25,5
2012-01-29,3,Bed Number 3,15,14,1
2012-01-30,1,Bed Number 1,96,90,6
2012-01-30,2,Bed Number 2,56,56,0
2012-01-30,3,Bed Number 3,18,0,18
2012-01-31,1,Bed Number 1,13,11,2
2012-01-31,2,Bed Number 2,19,7,12
2012-01-31,3,Bed Number 3,65,4,61
2012-02-01,1,Bed Number 1,62,40,22
2012-02-01,2,Bed Number 2,95,74,21
2012-02-01,3,Bed Number 3,42,36,6
2012-02-02,1,Bed Number 1,57,10,47
2012-02-02,2,Bed Number 2,56,2,54
2012-02-02,3,Bed Number 3,100,57,43
2012-02-03,1,Bed Number 1,18,7,11
2012-02-03,2,Bed Number 2,67,60,7
2012-02-03,3,Bed Number 3,35,20,15
2012-02-04,1,Bed Number 1,48,5,43
2012-02-04,2,Bed Number 2,87,65,22
2012-02-04,3,Bed Number 3,16,2,14
2012-02-05,1,Bed Number 1,61,15,46
2012-02-05,2,Bed Number 2,33,6,27
2012-02-05,3,Bed Number 3,54,12,42
2012-02-06,1,Bed Number 1,40,7,33
2012-02-06,2,Bed Number 2,59,51,8
2012-02-06,3,Bed Number 3,32,14,18
2012-02-07,1,Bed Number 1,41,19,22
2012-02-07,2,Bed Number 2,96,24,72
2012-02-07,3,Bed Number 3,40,36,4
2012-02-08,1,Bed Number 1,98,51,47
2012-02-08,2,Bed Number 2,93,49,44
2012-02-08,3,Bed Number 3,48,46,2
2012-02-09,1,Bed Number 1,77,1,76
2012-02-09,2,Bed Number 2,32,25,7
2012-02-09,3,Bed Number 3,85,84,1
2012-02-10,1,Bed Number 1,42,40,2
2012-02-10,2,Bed Number 2,18,17,1
2012-02-10,3,Bed Number 3,22,10,12
2012-02-11,1,Bed Number 1,81,3,78
2012-02-11,2,Bed Number 2,75,55,20
2012-02-11,3,Bed Number 3,77,4,73
2012-02-12,1,Bed Number 1,24,6,18
2012-02-12,2,Bed Number 2,42,37,5
2012-02-12,3,Bed Number 3,16,5,11
2012-02-13,1,Bed Number 1,20,12,8
2012-02-13,2,Bed Number 2,25,8,17
2012-02-13,3,Bed Number 3,69,2,67
2012-02-14,1,Bed Number 1,87,26,61
2012-02-14,2,Bed Number 2,17,14,3
2012-02-14,3,Bed Number 3,95,77,18
2012-02-15,1,Bed Number 1,34,30,4
2012-02-15,2,Bed Number 2,30,11,19
2012-02-15,3,Bed Number 3,64,62,2
2012-02-16,1,Bed Number 1,94,81,13
2012-02-16,2,Bed Number 2,14,7,7
2012-02-16,3,Bed Number 3,17,6,11
2012-02-17,1,Bed Number 1,37,20,17
2012-02-17,2,Bed Number 2,87,44,43
2012-02-17,3,Bed Number 3,85,61,24
2012-02-18,1,Bed Number 1,92,34,58
2012-02-18,2,Bed Number 2,70,23,47
2012-02-18,3,Bed Number 3,23,15,8
2012-02-19,1,Bed Number 1,31,23,8
2012-02-19,2,Bed Number 2,24,7,17
2012-02-19,3,Bed Number 3,93,37,56
2012-02-20,1,Bed Number 1,31,18,13
2012-02-20,2,Bed Number 2,17,9,8
2012-02-20,3,Bed Number 3,38,36,2
2012-02-21,1,Bed Number 1,55,40,15
2012-02-21,2,Bed Number 2,29,8,21
2012-02-21,3,Bed Number 3,66,58,8
2012-02-22,1,Bed Number 1,44,42,2
2012-02-22,2,Bed Number 2,98,3,95
2012-02-22,3,Bed Number 3,37,2,35
2012-02-23,1,Bed Number 1,44,43,1
2012-02-23,2,Bed Number 2,73,29,44
2012-02-23,3,Bed Number 3,10,1,9
2012-02-24,1,Bed Number 1,80,24,56
2012-02-24,2,Bed Number 2,99,45,54
2012-02-24,3,Bed Number 3,83,81,2
2012-02-25,1,Bed Number 1,68,5,63
2012-02-25,2,Bed Number 2,87,26,61
2012-02-25,3,Bed Number 3,69,52,17
2012-02-26,1,Bed Number 1,63,38,25
2012-02-26,2,Bed Number 2,50,28,22
2012-02-26,3,Bed Number 3,69,42,27
2012-02-27,1,Bed Number 1,92,52,40
2012-02-27,2,Bed Number 2,79,26,53
2012-02-27,3,Bed Number 3,47,11,36
2012-02-28,1,Bed Number 1,57,53,4
2012-02-28,2,Bed Number 2,91,66,25
2012-02-28,3,Bed Number 3,100,41,59
2012-02-29,1,Bed Number 1,92,74,18
2012-02-29,2,Bed Number 2,42,2,40
2012-02-29,3,Bed Number 3,38,2,36
2012-03-01,1,Bed Number 1,78,9,69
2012-03-01,2,Bed Number 2,25,17,8
2012-03-01,3,Bed Number 3,96,22,74
2012-03-02,1,Bed Number 1,82,18,64
2012-03-02,2,Bed Number 2,83,62,21
2012-03-02,3,Bed Number 3,31,21,10
2012-03-03,1,Bed Number 1,51,1,50
2012-03-03,2,Bed Number 2,79,51,28
2012-03-03,3,Bed Number 3,11,3,8
2012-03-04,1,Bed Number 1,35,5,30
2012-03-04,2,Bed Number 2,93,88,5
2012-03-04,3,Bed Number 3,56,7,49
2012-03-05,1,Bed Number 1,76,6,70
2012-03-05,2,Bed Number 2,26,11,15
2012-03-05,3,Bed Number 3,57,39,18
2012-03-06,1,Bed Number 1,37,18,19
2012-03-06,2,Bed Number 2,92,50,42
2012-03-06,3,Bed Number 3,56,9,47
2012-03-07,1,Bed Number 1,53,30,23
2012-03-07,2,Bed Number 2,46,16,30
2012-03-07,3,Bed Number 3,79,30,49
2012-03-08,1,Bed Number 1,81,36,45
2012-03-08,2,Bed Number 2,87,32,55
2012-03-08,3,Bed Number 3,23,16,7
2012-03-09,1,Bed Number 1,54,19,35
2012-03-09,2,Bed Number 2,84,64,20
2012-03-09,3,Bed Number 3,34,14,20
2012-03-10,1,Bed Number 1,73,57,16
2012-03-10,2,Bed Number 2,63,7,56
2012-03-10,3,Bed Number 3,93,32,61
2012-03-11,1,Bed Number 1,11,11,0
2012-03-11,2,Bed Number 2,71,52,19
2012-03-11,3,Bed Number 3,70,63,7
2012-03-12,1,Bed Number 1,23,20,3
2012-03-12,2,Bed Number 2,50,41,9
2012-03-12,3,Bed Number 3,54,34,20
2012-03-13,1,Bed Number 1,52,0,52
2012-03-13,2,Bed Number 2,60,25,35
2012-03-13,3,Bed Number 3,55,13,42
2012-03-14,1,Bed Number 1,31,4,27
2012-03-14,2,Bed Number 2,42,8,34
2012-03-14,3,Bed Number 3,96,2,94
2012-03-15,1,Bed Number 1,75,15,60
2012-03-15,2,Bed Number 2,70,38,32
2012-03-15,3,Bed Number 3,11,7,4
2012-03-16,1,Bed Number 1,31,10,21
2012-03-16,2,Bed Number 2,64,38,26
2012-03-16,3,Bed Number 3,84,24,60
2012-03-17,1,Bed Number 1,100,9,91
2012-03-17,2,Bed Number 2,71,12,59
2012-03-17,3,Bed Number 3,37,8,29
2012-03-18,1,Bed Number 1,87,28,59
2012-03-18,2,Bed Number 2,51,4,47
2012-03-18,3,Bed Number 3,92,18,74
2012-03-19,1,Bed Number 1,90,20,70
2012-03-19,2,Bed Number 2,88,52,36
2012-03-19,3,Bed Number 3,66,52,14
2012-03-20,1,Bed Number 1,23,15,8
2012-03-20,2,Bed Number 2,16,11,5
2012-03-20,3,Bed Number 3,42,13,29
2012-03-21,1,Bed Number 1,21,16,5
2012-03-21,2,Bed Number 2,11,0,11
2012-03-21,3,Bed Number 3,72,28,44
2012-03-22,1,Bed Number 1,34,30,4
2012-03-22,2,Bed Number 2,44,5,39
2012-03-22,3,Bed Number 3,62,0,62
2012-03-23,1,Bed Number 1,87,31,56
2012-03-23,2,Bed Number 2,81,44,37
2012-03-23,3,Bed Number 3,26,9,17
2012-03-24,1,Bed Number 1,51,48,3
2012-03-24,2,Bed Number 2,42,11,31
2012-03-24,3,Bed Number 3,38,26,12
2012-03-25,1,Bed Number 1,71,27,44
2012-03-25,2,Bed Number 2,10,4,6
2012-03-25,3,Bed Number 3,90,41,49
2012-03-26,1,Bed Number 1,12,3,9
2012-03-26,2,Bed Number 2,67,8,59
2012-03-26,3,Bed Number 3,44,37,7
2012-03-27,1,Bed Number 1,57,11,46
2012-03-27,2,Bed Number 2,12,0,12
2012-03-27,3,Bed Number 3,88,46,42
2012-03-28,1,Bed Number 1,22,6,16
2012-03-28,2,Bed Number 2,12,5,7
2012-03-28,3,Bed Number 3,59,29,30
2012-03-29,1,Bed Number 1,34,34,0
2012-03-29,2,Bed Number 2,98,10,88
2012-03-29,3,Bed Number 3,71,27,44
2012-03-30,1,Bed Number 1,72,32,40
2012-03-30,2,Bed Number 2,75,68,7
2012-03-30,3,Bed Number 3,100,20,80
2012-03-31,1,Bed Number 1,42,24,18
2012-03-31,2,Bed Number 2,59,17,42
2012-03-31,3,Bed Number 3,24,6,18
2012-04-01,1,Bed Number 1,86,9,77
2012-04-01,2,Bed Number 2,59,28,31
2012-04-01,3,Bed Number 3,96,82,14
2012-04-02,1,Bed Number 1,95,51,44
2012-04-02,2,Bed Number 2,42,30,12
2012-04-02,3,Bed Number 3,79,11,68
2012-04-03,1,Bed Number 1,20,11,9
2012-04-03,2,Bed Number 2,99,5,94
2012-04-03,3,Bed Number 3,87,58,29
2012-04-04,1,Bed Number 1,49,48,1
2012-04-04,2,Bed Number 2,82,50,32
2012-04-04,3,Bed Number 3,49,9,40
2012-04-05,1,Bed Number 1,38,18,20
2012-04-05,2,Bed Number 2,19,0,19
2012-04-05,3,Bed Number 3,48,26,22
2012-04-06,1,Bed Number 1,93,66,27
2012-04-06,2,Bed Number 2,62,7,55
2012-04-06,3,Bed Number 3,42,19,23
2012-04-07,1,Bed Number 1,59,39,20
2012-04-07,2,Bed Number 2,45,3,42
2012-04-07,3,Bed Number 3,40,10,30
2012-04-08,1,Bed Number 1,78,76,2
2012-04-08,2,Bed Number 2,73,6,67
2012-04-08,3,Bed Number 3,53,3,50
2012-04-09,1,Bed Number 1,23,14,9
2012-04-09,2,Bed Number 2,47,11,36
2012-04-09,3,Bed Number 3,54,7,47
2012-04-10,1,Bed Number 1,74,17,57
2012-04-10,2,Bed Number 2,52,7,45
2012-04-10,3,Bed Number 3,27,14,13
2012-04-11,1,Bed Number 1,88,10,78
2012-04-11,2,Bed Number 2,50,10,40
2012-04-11,3,Bed Number 3,96,3,93
2012-04-12,1,Bed Number 1,49,45,4
2012-04-12,2,Bed Number 2,58,35,23
2012-04-12,3,Bed Number 3,13,13,0
2012-04-13,1,Bed Number 1,89,15,74
2012-04-13,2,Bed Number 2,71,21,50
2012-04-13,3,Bed Number 3,87,23,64
2012-04-14,1,Bed Number 1,30,29,1
2012-04-14,2,Bed Number 2,18,9,9
2012-04-14,3,Bed Number 3,80,69,11
2012-04-15,1,Bed Number 1,80,77,3
2012-04-15,2,Bed Number 2,85,72,13
2012-04-15,3,Bed Number 3,58,29,29
2012-04-16,1,Bed Number 1,31,8,23
2012-04-16,2,Bed Number 2,13,3,10
2012-04-16,3,Bed Number 3,45,29,16
2012-04-17,1,Bed Number 1,54,22,32
2012-04-17,2,Bed Number 2,58,33,25
2012-04-17,3,Bed Number 3,36,6,30
2012-04-18,1,Bed Number 1,96,62,34
2012-04-18,2,Bed Number 2,41,15,26
2012-04-18,3,Bed Number 3,65,59,6
2012-04-19,1,Bed Number 1,33,30,3
2012-04-19,2,Bed Number 2,76,19,57
2012-04-19,3,Bed Number 3,55,28,27
2012-04-20,1,Bed Number 1,66,46,20
2012-04-20,2,Bed Number 2,96,9,87
2012-04-20,3,Bed Number 3,47,12,35
2012-04-21,1,Bed Number 1,32,4,28
2012-04-21,2,Bed Number 2,27,27,0
2012-04-21,3,Bed Number 3,65,64,1
2012-04-22,1,Bed Number 1,41,2,39
2012-04-22,2,Bed Number 2,37,16,21
2012-04-22,3,Bed Number 3,24,17,7
2012-04-23,1,Bed Number 1,77,68,9
2012-04-23,2,Bed Number 2,68,25,43
2012-04-23,3,Bed Number 3,100,40,60
2012-04-24,1,Bed Number 1,89,2,87
2012-04-24,2,Bed Number 2,26,17,9
2012-04-24,3,Bed Number 3,59,26,33
2012-04-25,1,Bed Number 1,30,16,14
2012-04-25,2,Bed Number 2,77,67,10
2012-04-25,3,Bed Number 3,12,4,8
2012-04-26,1,Bed Number 1,10,10,0
2012-04-26,2,Bed Number 2,12,1,11
2012-04-26,3,Bed Number 3,83,40,43
2012-04-27,1,Bed Number 1,25,18,7
2012-04-27,2,Bed Number 2,46,15,31
2012-04-27,3,Bed Number 3,35,17,18
2012-04-28,1,Bed Number 1,83,61,22
2012-04-28,2,Bed Number 2,11,6,5
2012-04-28,3,Bed Number 3,13,7,6
2012-04-29,1,Bed Number 1,80,39,41
2012-04-29,2,Bed Number 2,86,74,12
2012-04-29,3,Bed Number 3,18,9,9
2012-04-30,1,Bed Number 1,89,44,45
2012-04-30,2,Bed Number 2,62,62,0
2012-04-30,3,Bed Number 3,55,41,14
2012-05-01,1,Bed Number 1,32,9,23
2012-05-01,2,Bed Number 2,64,9,55
2012-05-01,3,Bed Number 3,82,71,11
2012-05-02,1,Bed Number 1,84,27,57
2012-05-02,2,Bed Number 2,77,67,10
2012-05-02,3,Bed Number 3,64,52,12
2012-05-03,1,Bed Number 1,73,32,41
2012-05-03,2,Bed Number 2,90,56,34
2012-05-03,3,Bed Number 3,70,58,12
2012-05-04,1,Bed Number 1,87,50,37
2012-05-04,2,Bed Number 2,84,49,35
2012-05-04,3,Bed Number 3,27,14,13
2012-05-05,1,Bed Number 1,70,70,0
2012-05-05,2,Bed Number 2,63,63,0
2012-05-05,3,Bed Number 3,13,5,8
2012-05-06,1,Bed Number 1,24,7,17
2012-05-06,2,Bed Number 2,34,12,22
2012-05-06,3,Bed Number 3,23,15,8
2012-05-07,1,Bed Number 1,50,8,42
2012-05-07,2,Bed Number 2,70,1,69
2012-05-07,3,Bed Number 3,99,58,41
2012-05-08,1,Bed Number 1,15,0,15
2012-05-08,2,Bed Number 2,25,14,11
2012-05-08,3,Bed Number 3,18,18,0
2012-05-09,1,Bed Number 1,34,7,27
2012-05-09,2,Bed Number 2,80,8,72
2012-05-09,3,Bed Number 3,27,17,10
2012-05-10,1,Bed Number 1,82,40,42
2012-05-10,2,Bed Number 2,95,89,6
2012-05-10,3,Bed Number 3,92,1,91
2012-05-11,1,Bed Number 1,18,3,15
2012-05-11,2,Bed Number 2,19,18,1
2012-05-11,3,Bed Number 3,62,42,20
2012-05-12,1,Bed Number 1,68,15,53
2012-05-12,2,Bed Number 2,78,7,71
2012-05-12,3,Bed Number 3,33,10,23
2012-05-13,1,Bed Number 1,44,6,38
2012-05-13,2,Bed Number 2,76,48,28
2012-05-13,3,Bed Number 3,68,18,50
2012-05-14,1,Bed Number 1,25,24,1
2012-05-14,2,Bed Number 2,56,49,7
2012-05-14,3,Bed Number 3,67,62,5
2012-05-15,1,Bed Number 1,63,10,53
2012-05-15,2,Bed Number 2,66,36,30
2012-05-15,3,Bed Number 3,14,2,12
2012-05-16,1,Bed Number 1,18,17,1
2012-05-16,2,Bed Number 2,38,15,23
2012-05-16,3,Bed Number 3,91,80,11
2012-05-17,1,Bed Number 1,80,18,62
2012-05-17,2,Bed Number 2,21,2,19
2012-05-17,3,Bed Number 3,29,14,15
2012-05-18,1,Bed Number 1,38,26,12
2012-05-18,2,Bed Number 2,46,30,16
2012-05-18,3,Bed Number 3,20,5,15
2012-05-19,1,Bed Number 1,94,63,31
2012-05-19,2,Bed Number 2,88,69,19
2012-05-19,3,Bed Number 3,22,12,10
2012-05-20,1,Bed Number 1,31,24,7
2012-05-20,2,Bed Number 2,11,2,9
2012-05-20,3,Bed Number 3,52,8,44
2012-05-21,1,Bed Number 1,44,31,13
2012-05-21,2,Bed Number 2,53,34,19
2012-05-21,3,Bed Number 3,76,37,39
2012-05-22,1,Bed Number 1,56,34,22
2012-05-22,2,Bed Number 2,84,7,77
2012-05-22,3,Bed Number 3,59,47,12
2012-05-23,1,Bed Number 1,75,43,32
2012-05-23,2,Bed Number 2,40,13,27
2012-05-23,3,Bed Number 3,63,40,23
2012-05-24,1,Bed Number 1,90,33,57
2012-05-24,2,Bed Number 2,86,58,28
2012-05-24,3,Bed Number 3,74,45,29
2012-05-25,1,Bed Number 1,64,37,27
2012-05-25,2,Bed Number 2,39,28,11
2012-05-25,3,Bed Number 3,15,10,5
2012-05-26,1,Bed Number 1,83,74,9
2012-05-26,2,Bed Number 2,57,9,48
2012-05-26,3,Bed Number 3,14,9,5
2012-05-27,1,Bed Number 1,35,17,18
2012-05-27,2,Bed Number 2,42,12,30
2012-05-27,3,Bed Number 3,97,47,50
2012-05-28,1,Bed Number 1,31,13,18
2012-05-28,2,Bed Number 2,73,6,67
2012-05-28,3,Bed Number 3,11,9,2
2012-05-29,1,Bed Number 1,39,8,31
2012-05-29,2,Bed Number 2,97,75,22
2012-05-29,3,Bed Number 3,78,40,38
2012-05-30,1,Bed Number 1,78,59,19
2012-05-30,2,Bed Number 2,47,9,38
2012-05-30,3,Bed Number 3,10,9,1
2012-05-31,1,Bed Number 1,41,20,21
2012-05-31,2,Bed Number 2,51,10,41
2012-05-31,3,Bed Number 3,72,56,16
2012-06-01,1,Bed Number 1,71,40,31
2012-06-01,2,Bed Number 2,96,63,33
2012-06-01,3,Bed Number 3,87,42,45
2012-06-02,1,Bed Number 1,55,13,42
2012-06-02,2,Bed Number 2,93,43,50
2012-06-02,3,Bed Number 3,55,44,11
2012-06-03,1,Bed Number 1,21,20,1
2012-06-03,2,Bed Number 2,100,62,38
2012-06-03,3,Bed Number 3,71,45,26
2012-06-04,1,Bed Number 1,31,4,27
2012-06-04,2,Bed Number 2,14,13,1
2012-06-04,3,Bed Number 3,83,4,79
2012-06-05,1,Bed Number 1,44,15,29
2012-06-05,2,Bed Number 2,60,51,9
2012-06-05,3,Bed Number 3,92,4,88
2012-06-06,1,Bed Number 1,63,36,27
2012-06-06,2,Bed Number 2,63,23,40
2012-06-06,3,Bed Number 3,44,4,40
2012-06-07,1,Bed Number 1,16,4,12
2012-06-07,2,Bed Number 2,88,68,20
2012-06-07,3,Bed Number 3,46,24,22
2012-06-08,1,Bed Number 1,88,11,77
2012-06-08,2,Bed Number 2,39,0,39
2012-06-08,3,Bed Number 3,46,28,18
2012-06-09,1,Bed Number 1,15,7,8
2012-06-09,2,Bed Number 2,81,15,66
2012-06-09,3,Bed Number 3,75,46,29
2012-06-10,1,Bed Number 1,61,1,60
2012-06-10,2,Bed Number 2,27,1,26
2012-06-10,3,Bed Number 3,89,41,48
2012-06-11,1,Bed Number 1,99,70,29
2012-06-11,2,Bed Number 2,37,4,33
2012-06-11,3,Bed Number 3,85,80,5
2012-06-12,1,Bed Number 1,54,40,14
2012-06-12,2,Bed Number 2,54,25,29
2012-06-12,3,Bed Number 3,47,12,35
2012-06-13,1,Bed Number 1,11,4,7
2012-06-13,2,Bed Number 2,37,31,6
2012-06-13,3,Bed Number 3,54,17,37
2012-06-14,1,Bed Number 1,65,18,47
2012-06-14,2,Bed Number 2,85,67,18
2012-06-14,3,Bed Number 3,81,75,6
2012-06-15,1,Bed Number 1,93,21,72
2012-06-15,2,Bed Number 2,56,41,15
2012-06-15,3,Bed Number 3,74,62,12
2012-06-16,1,Bed Number 1,39,10,29
2012-06-16,2,Bed Number 2,20,15,5
2012-06-16,3,Bed Number 3,57,30,27
2012-06-17,1,Bed Number 1,20,9,11
2012-06-17,2,Bed Number 2,61,16,45
2012-06-17,3,Bed Number 3,61,0,61
2012-06-18,1,Bed Number 1,30,6,24
2012-06-18,2,Bed Number 2,55,34,21
2012-06-18,3,Bed Number 3,89,48,41
2012-06-19,1,Bed Number 1,93,1,92
2012-06-19,2,Bed Number 2,84,5,79
2012-06-19,3,Bed Number 3,24,4,20
2012-06-20,1,Bed Number 1,97,95,2
2012-06-20,2,Bed Number 2,43,26,17
2012-06-20,3,Bed Number 3,10,6,4
2012-06-21,1,Bed Number 1,82,7,75
2012-06-21,2,Bed Number 2,73,68,5
2012-06-21,3,Bed Number 3,68,23,45
2012-06-22,1,Bed Number 1,84,1,83
2012-06-22,2,Bed Number 2,30,26,4
2012-06-22,3,Bed Number 3,32,28,4
2012-06-23,1,Bed Number 1,54,48,6
2012-06-23,2,Bed Number 2,17,8,9
2012-06-23,3,Bed Number 3,45,10,35
2012-06-24,1,Bed Number 1,31,23,8
2012-06-24,2,Bed Number 2,36,11,25
2012-06-24,3,Bed Number 3,88,63,25
2012-06-25,1,Bed Number 1,22,9,13
2012-06-25,2,Bed Number 2,40,19,21
2012-06-25,3,Bed Number 3,96,89,7
2012-06-26,1,Bed Number 1,83,70,13
2012-06-26,2,Bed Number 2,67,36,31
2012-06-26,3,Bed Number 3,18,1,17
2012-06-27,1,Bed Number 1,68,67,1
2012-06-27,2,Bed Number 2,99,79,20
2012-06-27,3,Bed Number 3,97,88,9
2012-06-28,1,Bed Number 1,91,60,31
2012-06-28,2,Bed Number 2,87,73,14
2012-06-28,3,Bed Number 3,94,4,90
2012-06-29,1,Bed Number 1,70,39,31
2012-06-29,2,Bed Number 2,28,28,0
2012-06-29,3,Bed Number 3,78,20,58
2012-06-30,1,Bed Number 1,91,32,59
2012-06-30,2,Bed Number 2,76,45,31
2012-06-30,3,Bed Number 3,44,41,3
2012-07-01,1,Bed Number 1,42,2,40
2012-07-01,2,Bed Number 2,81,62,19
2012-07-01,3,Bed Number 3,57,52,5
2012-07-02,1,Bed Number 1,65,49,16
2012-07-02,2,Bed Number 2,68,61,7
2012-07-02,3,Bed Number 3,64,38,26
2012-07-03,1,Bed Number 1,28,21,7
2012-07-03,2,Bed Number 2,43,31,12
2012-07-03,3,Bed Number 3,35,1,34
2012-07-04,1,Bed Number 1,30,2,28
2012-07-04,2,Bed Number 2,91,52,39
2012-07-04,3,Bed Number 3,17,4,13
2012-07-05,1,Bed Number 1,94,61,33
2012-07-05,2,Bed Number 2,27,1,26
2012-07-05,3,Bed Number 3,81,53,28
2012-07-06,1,Bed Number 1,15,9,6
2012-07-06,2,Bed Number 2,61,54,7
2012-07-06,3,Bed Number 3,86,63,23
2012-07-07,1,Bed Number 1,37,15,22
2012-07-07,2,Bed Number 2,99,79,20
2012-07-07,3,Bed Number 3,30,20,10
2012-07-08,1,Bed Number 1,35,2,33
2012-07-08,2,Bed Number 2,99,73,26
2012-07-08,3,Bed Number 3,30,14,16
2012-07-09,1,Bed Number 1,27,20,7
2012-07-09,2,Bed Number 2,30,18,12
2012-07-09,3,Bed Number 3,13,11,2
2012-07-10,1,Bed Number 1,83,42,41
2012-07-10,2,Bed Number 2,18,16,2
2012-07-10,3,Bed Number 3,83,65,18
2012-07-11,1,Bed Number 1,80,3,77
2012-07-11,2,Bed Number 2,37,22,15
2012-07-11,3,Bed Number 3,38,15,23
2012-07-12,1,Bed Number 1,57,28,29
2012-07-12,2,Bed Number 2,19,4,15
2012-07-12,3,Bed Number 3,38,33,5
2012-07-13,1,Bed Number 1,31,22,9
2012-07-13,2,Bed Number 2,81,47,34
2012-07-13,3,Bed Number 3,43,43,0
2012-07-14,1,Bed Number 1,20,9,11
2012-07-14,2,Bed Number 2,40,13,27
2012-07-14,3,Bed Number 3,11,4,7
2012-07-15,1,Bed Number 1,68,3,65
2012-07-15,2,Bed Number 2,51,30,21
2012-07-15,3,Bed Number 3,26,21,5
2012-07-16,1,Bed Number 1,99,40,59
2012-07-16,2,Bed Number 2,14,11,3
2012-07-16,3,Bed Number 3,10,5,5
2012-07-17,1,Bed Number 1,58,7,51
2012-07-17,2,Bed Number 2,91,12,79
2012-07-17,3,Bed Number 3,46,33,13
2012-07-18,1,Bed Number 1,51,21,30
2012-07-18,2,Bed Number 2,78,77,1
2012-07-18,3,Bed Number 3,90,8,82
2012-07-19,1,Bed Number 1,82,57,25
2012-07-19,2,Bed Number 2,47,37,10
2012-07-19,3,Bed Number 3,28,26,2
2012-07-20,1,Bed Number 1,21,21,0
2012-07-20,2,Bed Number 2,44,9,35
2012-07-20,3,Bed Number 3,23,3,20
2012-07-21,1,Bed Number 1,23,4,19
2012-07-21,2,Bed Number 2,26,4,22
2012-07-21,3,Bed Number 3,96,60,36
2012-07-22,1,Bed Number 1,39,36,3
2012-07-22,2,Bed Number 2,39,32,7
2012-07-22,3,Bed Number 3,39,10,29
2012-07-23,1,Bed Number 1,75,49,26
2012-07-23,2,Bed Number 2,64,28,36
2012-07-23,3,Bed Number 3,88,68,20
2012-07-24,1,Bed Number 1,54,34,20
2012-07-24,2,Bed Number 2,63,39,24
2012-07-24,3,Bed Number 3,55,46,9
2012-07-25,1,Bed Number 1,61,13,48
2012-07-25,2,Bed Number 2,23,17,6
2012-07-25,3,Bed Number 3,33,28,5
2012-07-26,1,Bed Number 1,98,94,4
2012-07-26,2,Bed Number 2,18,17,1
2012-07-26,3,Bed Number 3,31,5,26
2012-07-27,1,Bed Number 1,68,22,46
2012-07-27,2,Bed Number 2,34,9,25
2012-07-27,3,Bed Number 3,72,24,48
2012-07-28,1,Bed Number 1,90,12,78
2012-07-28,2,Bed Number 2,51,20,31
2012-07-28,3,Bed Number 3,68,6,62
2012-07-29,1,Bed Number 1,51,12,39
2012-07-29,2,Bed Number 2,44,11,33
2012-07-29,3,Bed Number 3,87,21,66
2012-07-30,1,Bed Number 1,33,0,33
2012-07-30,2,Bed Number 2,41,12,29
2012-07-30,3,Bed Number 3,84,47,37
2012-07-31,1,Bed Number 1,17,10,7
2012-07-31,2,Bed Number 2,11,11,0
2012-07-31,3,Bed Number 3,31,23,8
2012-08-01,1,Bed Number 1,78,78,0
2012-08-01,2,Bed Number 2,35,0,35
2012-08-01,3,Bed Number 3,49,2,47
2012-08-02,1,Bed Number 1,75,58,17
2012-08-02,2,Bed Number 2,73,1,72
2012-08-02,3,Bed Number 3,99,60,39
2012-08-03,1,Bed Number 1,58,43,15
2012-08-03,2,Bed Number 2,62,16,46
2012-08-03,3,Bed Number 3,100,3,97
2012-08-04,1,Bed Number 1,91,67,24
2012-08-04,2,Bed Number 2,63,27,36
2012-08-04,3,Bed Number 3,30,4,26
2012-08-05,1,Bed Number 1,90,78,12
2012-08-05,2,Bed Number 2,57,25,32
2012-08-05,3,Bed Number 3,56,29,27
2012-08-06,1,Bed Number 1,98,47,51
2012-08-06,2,Bed Number 2,56,36,20
2012-08-06,3,Bed Number 3,59,21,38
2012-08-07,1,Bed Number 1,27,27,0
2012-08-07,2,Bed Number 2,47,17,30
2012-08-07,3,Bed Number 3,39,5,34
2012-08-08,1,Bed Number 1,98,96,2
2012-08-08,2,Bed Number 2,56,56,0
2012-08-08,3,Bed Number 3,47,23,24
2012-08-09,1,Bed Number 1,38,3,35
2012-08-09,2,Bed Number 2,36,9,27
2012-08-09,3,Bed Number 3,90,67,23
2012-08-10,1,Bed Number 1,25,23,2
2012-08-10,2,Bed Number 2,28,6,22
2012-08-10,3,Bed Number 3,89,17,72
2012-08-11,1,Bed Number 1,24,21,3
2012-08-11,2,Bed Number 2,49,26,23
2012-08-11,3,Bed Number 3,68,56,12
2012-08-12,1,Bed Number 1,29,12,17
2012-08-12,2,Bed Number 2,46,40,6
2012-08-12,3,Bed Number 3,71,26,45
2012-08-13,1,Bed Number 1,81,80,1
2012-08-13,2,Bed Number 2,29,22,7
2012-08-13,3,Bed Number 3,21,14,7
2012-08-14,1,Bed Number 1,87,25,62
2012-08-14,2,Bed Number 2,86,9,77
2012-08-14,3,Bed Number 3,49,37,12
2012-08-15,1,Bed Number 1,85,78,7
2012-08-15,2,Bed Number 2,24,5,19
2012-08-15,3,Bed Number 3,60,22,38
2012-08-16,1,Bed Number 1,52,16,36
2012-08-16,2,Bed Number 2,90,71,19
2012-08-16,3,Bed Number 3,87,58,29
2012-08-17,1,Bed Number 1,62,21,41
2012-08-17,2,Bed Number 2,69,30,39
2012-08-17,3,Bed Number 3,34,20,14
2012-08-18,1,Bed Number 1,23,23,0
2012-08-18,2,Bed Number 2,95,85,10
2012-08-18,3,Bed Number 3,16,9,7
2012-08-19,1,Bed Number 1,49,23,26
2012-08-19,2,Bed Number 2,30,17,13
2012-08-19,3,Bed Number 3,92,31,61
2012-08-20,1,Bed Number 1,44,20,24
2012-08-20,2,Bed Number 2,43,37,6
2012-08-20,3,Bed Number 3,38,24,14
2012-08-21,1,Bed Number 1,31,13,18
2012-08-21,2,Bed Number 2,85,77,8
2012-08-21,3,Bed Number 3,97,10,87
2012-08-22,1,Bed Number 1,95,61,34
2012-08-22,2,Bed Number 2,62,28,34
2012-08-22,3,Bed Number 3,93,62,31
2012-08-23,1,Bed Number 1,61,53,8
2012-08-23,2,Bed Number 2,80,74,6
2012-08-23,3,Bed Number 3,65,28,37
2012-08-24,1,Bed Number 1,70,11,59
2012-08-24,2,Bed Number 2,42,36,6
2012-08-24,3,Bed Number 3,100,84,16
2012-08-25,1,Bed Number 1,97,91,6
2012-08-25,2,Bed Number 2,82,37,45
2012-08-25,3,Bed Number 3,21,0,21
2012-08-26,1,Bed Number 1,41,38,3
2012-08-26,2,Bed Number 2,76,56,20
2012-08-26,3,Bed Number 3,44,1,43
2012-08-27,1,Bed Number 1,93,75,18
2012-08-27,2,Bed Number 2,58,39,19
2012-08-27,3,Bed Number 3,69,38,31
2012-08-28,1,Bed Number 1,41,35,6
2012-08-28,2,Bed Number 2,22,15,7
2012-08-28,3,Bed Number 3,59,38,21
2012-08-29,1,Bed Number 1,54,6,48
2012-08-29,2,Bed Number 2,48,17,31
2012-08-29,3,Bed Number 3,40,25,15
2012-08-30,1,Bed Number 1,56,36,20
2012-08-30,2,Bed Number 2,48,23,25
2012-08-30,3,Bed Number 3,99,2,97
2012-08-31,1,Bed Number 1,45,31,14
2012-08-31,2,Bed Number 2,56,41,15
2012-08-31,3,Bed Number 3,64,37,27
2012-09-01,1,Bed Number 1,98,24,74
2012-09-01,2,Bed Number 2,57,45,12
2012-09-01,3,Bed Number 3,23,18,5
2012-09-02,1,Bed Number 1,27,16,11
2012-09-02,2,Bed Number 2,36,3,33
2012-09-02,3,Bed Number 3,21,9,12
2012-09-03,1,Bed Number 1,71,70,1
2012-09-03,2,Bed Number 2,62,13,49
2012-09-03,3,Bed Number 3,17,16,1
2012-09-04,1,Bed Number 1,44,19,25
2012-09-04,2,Bed Number 2,83,19,64
2012-09-04,3,Bed Number 3,31,1,30
2012-09-05,1,Bed Number 1,86,65,21
2012-09-05,2,Bed Number 2,86,73,13
2012-09-05,3,Bed Number 3,87,78,9
2012-09-06,1,Bed Number 1,62,31,31
2012-09-06,2,Bed Number 2,89,13,76
2012-09-06,3,Bed Number 3,67,61,6
2012-09-07,1,Bed Number 1,85,85,0
2012-09-07,2,Bed Number 2,76,72,4
2012-09-07,3,Bed Number 3,67,59,8
2012-09-08,1,Bed Number 1,46,25,21
2012-09-08,2,Bed Number 2,24,15,9
2012-09-08,3,Bed Number 3,25,4,21
2012-09-09,1,Bed Number 1,91,43,48
2012-09-09,2,Bed Number 2,86,45,41
2012-09-09,3,Bed Number 3,56,18,38
2012-09-10,1,Bed Number 1,59,28,31
2012-09-10,2,Bed Number 2,12,2,10
2012-09-10,3,Bed Number 3,21,6,15
2012-09-11,1,Bed Number 1,18,15,3
2012-09-11,2,Bed Number 2,64,47,17
2012-09-11,3,Bed Number 3,40,30,10
2012-09-12,1,Bed Number 1,79,48,31
2012-09-12,2,Bed Number 2,86,40,46
2012-09-12,3,Bed Number 3,22,3,19
2012-09-13,1,Bed Number 1,17,8,9
2012-09-13,2,Bed Number 2,62,57,5
2012-09-13,3,Bed Number 3,100,99,1
2012-09-14,1,Bed Number 1,99,28,71
2012-09-14,2,Bed Number 2,75,28,47
2012-09-14,3,Bed Number 3,71,13,58
2012-09-15,1,Bed Number 1,39,2,37
2012-09-15,2,Bed Number 2,24,10,14
2012-09-15,3,Bed Number 3,100,0,100
2012-09-16,1,Bed Number 1,29,17,12
2012-09-16,2,Bed Number 2,55,2,53
2012-09-16,3,Bed Number 3,27,7,20
2012-09-17,1,Bed Number 1,79,33,46
2012-09-17,2,Bed Number 2,38,24,14
2012-09-17,3,Bed Number 3,84,6,78
2012-09-18,1,Bed Number 1,38,21,17
2012-09-18,2,Bed Number 2,67,19,48
2012-09-18,3,Bed Number 3,18,17,1
2012-09-19,1,Bed Number 1,23,10,13
2012-09-19,2,Bed Number 2,43,2,41
2012-09-19,3,Bed Number 3,72,6,66
2012-09-20,1,Bed Number 1,53,49,4
2012-09-20,2,Bed Number 2,96,88,8
2012-09-20,3,Bed Number 3,12,1,11
2012-09-21,1,Bed Number 1,69,31,38
2012-09-21,2,Bed Number 2,85,68,17
2012-09-21,3,Bed Number 3,84,27,57
2012-09-22,1,Bed Number 1,60,54,6
2012-09-22,2,Bed Number 2,27,26,1
2012-09-22,3,Bed Number 3,60,37,23
2012-09-23,1,Bed Number 1,86,23,63
2012-09-23,2,Bed Number 2,75,48,27
2012-09-23,3,Bed Number 3,54,54,0
2012-09-24,1,Bed Number 1,72,15,57
2012-09-24,2,Bed Number 2,30,3,27
2012-09-24,3,Bed Number 3,30,26,4
2012-09-25,1,Bed Number 1,92,53,39
2012-09-25,2,Bed Number 2,92,47,45
2012-09-25,3,Bed Number 3,74,71,3
2012-09-26,1,Bed Number 1,45,9,36
2012-09-26,2,Bed Number 2,22,16,6
2012-09-26,3,Bed Number 3,50,21,29
2012-09-27,1,Bed Number 1,36,9,27
2012-09-27,2,Bed Number 2,69,67,2
2012-09-27,3,Bed Number 3,91,11,80
2012-09-28,1,Bed Number 1,84,32,52
2012-09-28,2,Bed Number 2,93,72,21
2012-09-28,3,Bed Number 3,68,16,52
2012-09-29,1,Bed Number 1,64,13,51
2012-09-29,2,Bed Number 2,41,0,41
2012-09-29,3,Bed Number 3,32,11,21
2012-09-30,1,Bed Number 1,97,94,3
2012-09-30,2,Bed Number 2,79,34,45
2012-09-30,3,Bed Number 3,48,17,31
2012-10-01,1,Bed Number 1,42,16,26
2012-10-01,2,Bed Number 2,84,70,14
2012-10-01,3,Bed Number 3,27,12,15
2012-10-02,1,Bed Number 1,77,29,48
2012-10-02,2,Bed Number 2,41,3,38
2012-10-02,3,Bed Number 3,41,9,32
2012-10-03,1,Bed Number 1,61,22,39
2012-10-03,2,Bed Number 2,14,12,2
2012-10-03,3,Bed Number 3,54,31,23
2012-10-04,1,Bed Number 1,97,65,32
2012-10-04,2,Bed Number 2,32,18,14
2012-10-04,3,Bed Number 3,30,0,30
2012-10-05,1,Bed Number 1,74,55,19
2012-10-05,2,Bed Number 2,69,48,21
2012-10-05,3,Bed Number 3,18,8,10
2012-10-06,1,Bed Number 1,78,63,15
2012-10-06,2,Bed Number 2,12,7,5
2012-10-06,3,Bed Number 3,54,29,25
2012-10-07,1,Bed Number 1,86,42,44
2012-10-07,2,Bed Number 2,100,30,70
2012-10-07,3,Bed Number 3,65,58,7
2012-10-08,1,Bed Number 1,73,53,20
2012-10-08,2,Bed Number 2,64,8,56
2012-10-08,3,Bed Number 3,84,54,30
2012-10-09,1,Bed Number 1,68,19,49
2012-10-09,2,Bed Number 2,73,0,73
2012-10-09,3,Bed Number 3,69,61,8
2012-10-10,1,Bed Number 1,69,20,49
2012-10-10,2,Bed Number 2,46,18,28
2012-10-10,3,Bed Number 3,37,30,7
2012-10-11,1,Bed Number 1,44,25,19
2012-10-11,2,Bed Number 2,85,82,3
2012-10-11,3,Bed Number 3,56,32,24
2012-10-12,1,Bed Number 1,85,13,72
2012-10-12,2,Bed Number 2,88,12,76
2012-10-12,3,Bed Number 3,95,59,36
2012-10-13,1,Bed Number 1,37,35,2
2012-10-13,2,Bed Number 2,67,3,64
2012-10-13,3,Bed Number 3,95,22,73
2012-10-14,1,Bed Number 1,91,1,90
2012-10-14,2,Bed Number 2,33,10,23
2012-10-14,3,Bed Number 3,86,77,9
2012-10-15,1,Bed Number 1,46,22,24
2012-10-15,2,Bed Number 2,86,81,5
2012-10-15,3,Bed Number 3,51,40,11
2012-10-16,1,Bed Number 1,92,49,43
2012-10-16,2,Bed Number 2,62,29,33
2012-10-16,3,Bed Number 3,56,35,21
2012-10-17,1,Bed Number 1,10,8,2
2012-10-17,2,Bed Number 2,71,31,40
2012-10-17,3,Bed Number 3,23,20,3
2012-10-18,1,Bed Number 1,31,5,26
2012-10-18,2,Bed Number 2,22,9,13
2012-10-18,3,Bed Number 3,67,12,55
2012-10-19,1,Bed Number 1,35,19,16
2012-10-19,2,Bed Number 2,91,69,22
2012-10-19,3,Bed Number 3,49,37,12
2012-10-20,1,Bed Number 1,51,29,22
2012-10-20,2,Bed Number 2,56,27,29
2012-10-20,3,Bed Number 3,81,22,59
2012-10-21,1,Bed Number 1,51,27,24
2012-10-21,2,Bed Number 2,62,41,21
2012-10-21,3,Bed Number 3,10,1,9
2012-10-22,1,Bed Number 1,14,11,3
2012-10-22,2,Bed Number 2,89,59,30
2012-10-22,3,Bed Number 3,16,0,16
2012-10-23,1,Bed Number 1,24,4,20
2012-10-23,2,Bed Number 2,89,20,69
2012-10-23,3,Bed Number 3,38,36,2
2012-10-24,1,Bed Number 1,73,5,68
2012-10-24,2,Bed Number 2,100,2,98
2012-10-24,3,Bed Number 3,15,15,0
2012-10-25,1,Bed Number 1,52,5,47
2012-10-25,2,Bed Number 2,72,55,17
2012-10-25,3,Bed Number 3,34,20,14
2012-10-26,1,Bed Number 1,72,42,30
2012-10-26,2,Bed Number 2,42,22,20
2012-10-26,3,Bed Number 3,37,14,23
2012-10-27,1,Bed Number 1,81,30,51
2012-10-27,2,Bed Number 2,22,11,11
2012-10-27,3,Bed Number 3,22,17,5
2012-10-28,1,Bed Number 1,28,20,8
2012-10-28,2,Bed Number 2,59,39,20
2012-10-28,3,Bed Number 3,94,18,76
2012-10-29,1,Bed Number 1,95,33,62
2012-10-29,2,Bed Number 2,19,12,7
2012-10-29,3,Bed Number 3,27,16,11
2012-10-30,1,Bed Number 1,54,8,46
2012-10-30,2,Bed Number 2,61,59,2
2012-10-30,3,Bed Number 3,15,13,2
2012-10-31,1,Bed Number 1,83,3,80
2012-10-31,2,Bed Number 2,91,79,12
2012-10-31,3,Bed Number 3,14,0,14
2012-11-01,1,Bed Number 1,92,56,36
2012-11-01,2,Bed Number 2,14,14,0
2012-11-01,3,Bed Number 3,57,12,45
2012-11-02,1,Bed Number 1,39,36,3
2012-11-02,2,Bed Number 2,17,8,9
2012-11-02,3,Bed Number 3,31,3,28
2012-11-03,1,Bed Number 1,37,30,7
2012-11-03,2,Bed Number 2,42,26,16
2012-11-03,3,Bed Number 3,89,69,20
2012-11-04,1,Bed Number 1,58,7,51
2012-11-04,2,Bed Number 2,85,60,25
2012-11-04,3,Bed Number 3,59,30,29
2012-11-05,1,Bed Number 1,21,9,12
2012-11-05,2,Bed Number 2,96,18,78
2012-11-05,3,Bed Number 3,65,58,7
2012-11-06,1,Bed Number 1,51,1,50
2012-11-06,2,Bed Number 2,38,29,9
2012-11-06,3,Bed Number 3,68,59,9
2012-11-07,1,Bed Number 1,92,29,63
2012-11-07,2,Bed Number 2,65,24,41
2012-11-07,3,Bed Number 3,15,11,4
2012-11-08,1,Bed Number 1,20,13,7
2012-11-08,2,Bed Number 2,84,37,47
2012-11-08,3,Bed Number 3,69,4,65
2012-11-09,1,Bed Number 1,14,7,7
2012-11-09,2,Bed Number 2,84,36,48
2012-11-09,3,Bed Number 3,65,53,12
2012-11-10,1,Bed Number 1,14,1,13
2012-11-10,2,Bed Number 2,32,0,32
2012-11-10,3,Bed Number 3,49,2,47
2012-11-11,1,Bed Number 1,70,54,16
2012-11-11,2,Bed Number 2,99,71,28
2012-11-11,3,Bed Number 3,63,8,55
2012-11-12,1,Bed Number 1,66,7,59
2012-11-12,2,Bed Number 2,24,8,16
2012-11-12,3,Bed Number 3,33,2,31
2012-11-13,1,Bed Number 1,93,21,72
2012-11-13,2,Bed Number 2,83,34,49
2012-11-13,3,Bed Number 3,76,31,45
2012-11-14,1,Bed Number 1,62,27,35
2012-11-14,2,Bed Number 2,73,56,17
2012-11-14,3,Bed Number 3,36,19,17
2012-11-15,1,Bed Number 1,52,33,19
2012-11-15,2,Bed Number 2,54,38,16
2012-11-15,3,Bed Number 3,72,22,50
2012-11-16,1,Bed Number 1,68,23,45
2012-11-16,2,Bed Number 2,78,10,68
2012-11-16,3,Bed Number 3,99,52,47
2012-11-17,1,Bed Number 1,36,4,32
2012-11-17,2,Bed Number 2,85,76,9
2012-11-17,3,Bed Number 3,48,24,24
2012-11-18,1,Bed Number 1,79,28,51
2012-11-18,2,Bed Number 2,74,32,42
2012-11-18,3,Bed Number 3,52,49,3
2012-11-19,1,Bed Number 1,40,33,7
2012-11-19,2,Bed Number 2,18,11,7
2012-11-19,3,Bed Number 3,51,47,4
2012-11-20,1,Bed Number 1,33,8,25
2012-11-20,2,Bed Number 2,17,2,15
2012-11-20,3,Bed Number 3,38,12,26
2012-11-21,1,Bed Number 1,58,46,12
2012-11-21,2,Bed Number 2,77,53,24
2012-11-21,3,Bed Number 3,96,53,43
2012-11-22,1,Bed Number 1,85,20,65
2012-11-22,2,Bed Number 2,68,16,52
2012-11-22,3,Bed Number 3,47,1,46
2012-11-23,1,Bed Number 1,51,47,4
2012-11-23,2,Bed Number 2,97,25,72
2012-11-23,3,Bed Number 3,90,14,76
2012-11-24,1,Bed Number 1,68,40,28
2012-11-24,2,Bed Number 2,83,14,69
2012-11-24,3,Bed Number 3,91,35,56
2012-11-25,1,Bed Number 1,73,40,33
2012-11-25,2,Bed Number 2,32,8,24
2012-11-25,3,Bed Number 3,82,33,49
2012-11-26,1,Bed Number 1,57,33,24
2012-11-26,2,Bed Number 2,37,34,3
2012-11-26,3,Bed Number 3,87,24,63
2012-11-27,1,Bed Number 1,90,74,16
2012-11-27,2,Bed Number 2,14,10,4
2012-11-27,3,Bed Number 3,54,39,15
2012-11-28,1,Bed Number 1,53,16,37
2012-11-28,2,Bed Number 2,60,29,31
2012-11-28,3,Bed Number 3,91,60,31
2012-11-29,1,Bed Number 1,28,11,17
2012-11-29,2,Bed Number 2,87,14,73
2012-11-29,3,Bed Number 3,71,71,0
2012-11-30,1,Bed Number 1,43,2,41
2012-11-30,2,Bed Number 2,61,42,19
2012-11-30,3,Bed Number 3,34,21,13
2012-12-01,1,Bed Number 1,20,8,12
2012-12-01,2,Bed Number 2,98,63,35
2012-12-01,3,Bed Number 3,69,25,44
2012-12-02,1,Bed Number 1,85,81,4
2012-12-02,2,Bed Number 2,70,69,1
2012-12-02,3,Bed Number 3,66,30,36
2012-12-03,1,Bed Number 1,80,3,77
2012-12-03,2,Bed Number 2,37,8,29
2012-12-03,3,Bed Number 3,98,3,95
2012-12-04,1,Bed Number 1,99,93,6
2012-12-04,2,Bed Number 2,60,32,28
2012-12-04,3,Bed Number 3,32,23,9
2012-12-05,1,Bed Number 1,32,2,30
2012-12-05,2,Bed Number 2,62,3,59
2012-12-05,3,Bed Number 3,69,19,50
2012-12-06,1,Bed Number 1,86,4,82
2012-12-06,2,Bed Number 2,91,39,52
2012-12-06,3,Bed Number 3,73,3,70
2012-12-07,1,Bed Number 1,51,3,48
2012-12-07,2,Bed Number 2,90,52,38
2012-12-07,3,Bed Number 3,46,30,16
2012-12-08,1,Bed Number 1,76,56,20
2012-12-08,2,Bed Number 2,65,34,31
2012-12-08,3,Bed Number 3,63,33,30
2012-12-09,1,Bed Number 1,63,46,17
2012-12-09,2,Bed Number 2,96,39,57
2012-12-09,3,Bed Number 3,83,28,55
2012-12-10,1,Bed Number 1,78,48,30
2012-12-10,2,Bed Number 2,89,13,76
2012-12-10,3,Bed Number 3,90,36,54
2012-12-11,1,Bed Number 1,80,29,51
2012-12-11,2,Bed Number 2,45,15,30
2012-12-11,3,Bed Number 3,24,21,3
2012-12-12,1,Bed Number 1,59,33,26
2012-12-12,2,Bed Number 2,52,35,17
2012-12-12,3,Bed Number 3,30,1,29
2012-12-13,1,Bed Number 1,59,5,54
2012-12-13,2,Bed Number 2,73,54,19
2012-12-13,3,Bed Number 3,22,13,9
2012-12-14,1,Bed Number 1,95,6,89
2012-12-14,2,Bed Number 2,62,55,7
2012-12-14,3,Bed Number 3,59,40,19
2012-12-15,1,Bed Number 1,85,34,51
2012-12-15,2,Bed Number 2,69,45,24
2012-12-15,3,Bed Number 3,54,27,27
2012-12-16,1,Bed Number 1,58,42,16
2012-12-16,2,Bed Number 2,87,17,70
2012-12-16,3,Bed Number 3,15,8,7
2012-12-17,1,Bed Number 1,28,24,4
2012-12-17,2,Bed Number 2,65,53,12
2012-12-17,3,Bed Number 3,95,35,60
2012-12-18,1,Bed Number 1,68,48,20
2012-12-18,2,Bed Number 2,50,24,26
2012-12-18,3,Bed Number 3,39,35,4
2012-12-19,1,Bed Number 1,46,38,8
2012-12-19,2,Bed Number 2,17,2,15
2012-12-19,3,Bed Number 3,96,84,12
2012-12-20,1,Bed Number 1,31,6,25
2012-12-20,2,Bed Number 2,43,19,24
2012-12-20,3,Bed Number 3,69,13,56
2012-12-21,1,Bed Number 1,35,21,14
2012-12-21,2,Bed Number 2,68,13,55
2012-12-21,3,Bed Number 3,74,27,47
2012-12-22,1,Bed Number 1,79,20,59
2012-12-22,2,Bed Number 2,43,33,10
2012-12-22,3,Bed Number 3,75,26,49
2012-12-23,1,Bed Number 1,21,19,2
2012-12-23,2,Bed Number 2,44,11,33
2012-12-23,3,Bed Number 3,82,28,54
2012-12-24,1,Bed Number 1,40,6,34
2012-12-24,2,Bed Number 2,14,10,4
2012-12-24,3,Bed Number 3,80,26,54
2012-12-25,1,Bed Number 1,24,12,12
2012-12-25,2,Bed Number 2,94,75,19
2012-12-25,3,Bed Number 3,72,50,22
2012-12-26,1,Bed Number 1,54,0,54
2012-12-26,2,Bed Number 2,86,18,68
2012-12-26,3,Bed Number 3,100,86,14
2012-12-27,1,Bed Number 1,26,18,8
2012-12-27,2,Bed Number 2,43,2,41
2012-12-27,3,Bed Number 3,26,12,14
2012-12-28,1,Bed Number 1,78,63,15
2012-12-28,2,Bed Number 2,33,5,28
2012-12-28,3,Bed Number 3,22,19,3
2012-12-29,1,Bed Number 1,52,28,24
2012-12-29,2,Bed Number 2,86,77,9
2012-12-29,3,Bed Number 3,70,70,0
2012-12-30,1,Bed Number 1,55,54,1
2012-12-30,2,Bed Number 2,20,20,0
2012-12-30,3,Bed Number 3,98,72,26
2012-12-31,1,Bed Number 1,40,30,10
2012-12-31,2,Bed Number 2,95,45,50
2012-12-31,3,Bed Number 3,50,31,19
2013-01-01,1,Bed Number 1,75,64,11
2013-01-01,2,Bed Number 2,87,50,37
2013-01-01,3,Bed Number 3,11,1,10
2013-01-02,1,Bed Number 1,47,18,29
2013-01-02,2,Bed Number 2,40,23,17
2013-01-02,3,Bed Number 3,61,20,41
2013-01-03,1,Bed Number 1,59,19,40
2013-01-03,2,Bed Number 2,39,33,6
2013-01-03,3,Bed Number 3,25,7,18
2013-01-04,1,Bed Number 1,26,23,3
2013-01-04,2,Bed Number 2,73,5,68
2013-01-04,3,Bed Number 3,84,1,83
2013-01-05,1,Bed Number 1,39,14,25
2013-01-05,2,Bed Number 2,36,34,2
2013-01-05,3,Bed Number 3,28,10,18
2013-01-06,1,Bed Number 1,11,10,1
2013-01-06,2,Bed Number 2,75,22,53
2013-01-06,3,Bed Number 3,22,13,9
2013-01-07,1,Bed Number 1,14,9,5
2013-01-07,2,Bed Number 2,90,84,6
2013-01-07,3,Bed Number 3,71,44,27
2013-01-08,1,Bed Number 1,13,6,7
2013-01-08,2,Bed Number 2,94,36,58
2013-01-08,3,Bed Number 3,62,28,34
2013-01-09,1,Bed Number 1,33,23,10
2013-01-09,2,Bed Number 2,28,22,6
2013-01-09,3,Bed Number 3,10,2,8
2013-01-10,1,Bed Number 1,98,52,46
2013-01-10,2,Bed Number 2,84,10,74
2013-01-10,3,Bed Number 3,61,38,23
2013-01-11,1,Bed Number 1,67,6,61
2013-01-11,2,Bed Number 2,21,1,20
2013-01-11,3,Bed Number 3,33,18,15
2013-01-12,1,Bed Number 1,80,22,58
2013-01-12,2,Bed Number 2,82,8,74
2013-01-12,3,Bed Number 3,42,24,18
2013-01-13,1,Bed Number 1,65,46,19
2013-01-13,2,Bed Number 2,22,15,7
2013-01-13,3,Bed Number 3,90,47,43
2013-01-14,1,Bed Number 1,86,78,8
2013-01-14,2,Bed Number 2,86,84,2
2013-01-14,3,Bed Number 3,64,62,2
2013-01-15,1,Bed Number 1,72,15,57
2013-01-15,2,Bed Number 2,84,46,38
2013-01-15,3,Bed Number 3,18,17,1
2013-01-16,1,Bed Number 1,84,76,8
2013-01-16,2,Bed Number 2,54,7,47
2013-01-16,3,Bed Number 3,12,10,2
2013-01-17,1,Bed Number 1,99,27,72
2013-01-17,2,Bed Number 2,17,9,8
2013-01-17,3,Bed Number 3,83,30,53
2013-01-18,1,Bed Number 1,91,37,54
2013-01-18,2,Bed Number 2,37,31,6
2013-01-18,3,Bed Number 3,35,7,28
2013-01-19,1,Bed Number 1,15,2,13
2013-01-19,2,Bed Number 2,85,30,55
2013-01-19,3,Bed Number 3,49,1,48
2013-01-20,1,Bed Number 1,40,36,4
2013-01-20,2,Bed Number 2,53,2,51
2013-01-20,3,Bed Number 3,34,32,2
2013-01-21,1,Bed Number 1,49,27,22
2013-01-21,2,Bed Number 2,20,12,8
2013-01-21,3,Bed Number 3,38,16,22
2013-01-22,1,Bed Number 1,28,1,27
2013-01-22,2,Bed Number 2,100,30,70
2013-01-22,3,Bed Number 3,25,0,25
2013-01-23,1,Bed Number 1,40,31,9
2013-01-23,2,Bed Number 2,78,15,63
2013-01-23,3,Bed Number 3,28,4,24
2013-01-24,1,Bed Number 1,12,5,7
2013-01-24,2,Bed Number 2,95,22,73
2013-01-24,3,Bed Number 3,47,1,46
2013-01-25,1,Bed Number 1,29,11,18
2013-01-25,2,Bed Number 2,27,7,20
2013-01-25,3,Bed Number 3,20,5,15
2013-01-26,1,Bed Number 1,58,12,46
2013-01-26,2,Bed Number 2,47,5,42
2013-01-26,3,Bed Number 3,16,12,4
2013-01-27,1,Bed Number 1,25,18,7
2013-01-27,2,Bed Number 2,89,1,88
2013-01-27,3,Bed Number 3,17,15,2
2013-01-28,1,Bed Number 1,24,2,22
2013-01-28,2,Bed Number 2,94,65,29
2013-01-28,3,Bed Number 3,57,20,37
2013-01-29,1,Bed Number 1,29,12,17
2013-01-29,2,Bed Number 2,64,8,56
2013-01-29,3,Bed Number 3,31,14,17
2013-01-30,1,Bed Number 1,71,58,13
2013-01-30,2,Bed Number 2,66,46,20
2013-01-30,3,Bed Number 3,94,72,22
2013-01-31,1,Bed Number 1,74,67,7
2013-01-31,2,Bed Number 2,53,40,13
2013-01-31,3,Bed Number 3,12,8,4
2013-02-01,1,Bed Number 1,87,24,63
2013-02-01,2,Bed Number 2,41,23,18
2013-02-01,3,Bed Number 3,38,4,34
2013-02-02,1,Bed Number 1,95,12,83
2013-02-02,2,Bed Number 2,21,0,21
2013-02-02,3,Bed Number 3,11,2,9
2013-02-03,1,Bed Number 1,42,20,22
2013-02-03,2,Bed Number 2,12,10,2
2013-02-03,3,Bed Number 3,68,20,48
2013-02-04,1,Bed Number 1,69,34,35
2013-02-04,2,Bed Number 2,53,24,29
2013-02-04,3,Bed Number 3,28,7,21
2013-02-05,1,Bed Number 1,94,15,79
2013-02-05,2,Bed Number 2,80,18,62
2013-02-05,3,Bed Number 3,57,14,43
2013-02-06,1,Bed Number 1,11,7,4
2013-02-06,2,Bed Number 2,76,65,11
2013-02-06,3,Bed Number 3,93,51,42
2013-02-07,1,Bed Number 1,17,5,12
2013-02-07,2,Bed Number 2,36,24,12
2013-02-07,3,Bed Number 3,62,15,47
2013-02-08,1,Bed Number 1,27,2,25
2013-02-08,2,Bed Number 2,40,27,13
2013-02-08,3,Bed Number 3,82,12,70
2013-02-09,1,Bed Number 1,98,70,28
2013-02-09,2,Bed Number 2,61,6,55
2013-02-09,3,Bed Number 3,12,7,5
2013-02-10,1,Bed Number 1,81,70,11
2013-02-10,2,Bed Number 2,20,19,1
2013-02-10,3,Bed Number 3,86,46,40
2013-02-11,1,Bed Number 1,87,40,47
2013-02-11,2,Bed Number 2,14,14,0
2013-02-11,3,Bed Number 3,80,77,3
2013-02-12,1,Bed Number 1,58,30,28
2013-02-12,2,Bed Number 2,44,31,13
2013-02-12,3,Bed Number 3,72,68,4
2013-02-13,1,Bed Number 1,89,50,39
2013-02-13,2,Bed Number 2,34,7,27
2013-02-13,3,Bed Number 3,99,36,63
2013-02-14,1,Bed Number 1,71,36,35
2013-02-14,2,Bed Number 2,98,70,28
2013-02-14,3,Bed Number 3,59,52,7
2013-02-15,1,Bed Number 1,33,32,1
2013-02-15,2,Bed Number 2,21,4,17
2013-02-15,3,Bed Number 3,54,10,44
2013-02-16,1,Bed Number 1,81,51,30
2013-02-16,2,Bed Number 2,44,27,17
2013-02-16,3,Bed Number 3,89,19,70
2013-02-17,1,Bed Number 1,96,16,80
2013-02-17,2,Bed Number 2,48,30,18
2013-02-17,3,Bed Number 3,26,14,12
2013-02-18,1,Bed Number 1,60,8,52
2013-02-18,2,Bed Number 2,83,73,10
2013-02-18,3,Bed Number 3,46,31,15
2013-02-19,1,Bed Number 1,90,35,55
2013-02-19,2,Bed Number 2,41,40,1
2013-02-19,3,Bed Number 3,10,1,9
2013-02-20,1,Bed Number 1,79,23,56
2013-02-20,2,Bed Number 2,12,4,8
2013-02-20,3,Bed Number 3,80,79,1
2013-02-21,1,Bed Number 1,25,6,19
2013-02-21,2,Bed Number 2,32,25,7
2013-02-21,3,Bed Number 3,10,8,2
2013-02-22,1,Bed Number 1,64,50,14
2013-02-22,2,Bed Number 2,64,42,22
2013-02-22,3,Bed Number 3,82,71,11
2013-02-23,1,Bed Number 1,89,61,28
2013-02-23,2,Bed Number 2,37,35,2
2013-02-23,3,Bed Number 3,55,31,24
2013-02-24,1,Bed Number 1,95,47,48
2013-02-24,2,Bed Number 2,89,10,79
2013-02-24,3,Bed Number 3,17,15,2
2013-02-25,1,Bed Number 1,87,12,75
2013-02-25,2,Bed Number 2,69,40,29
2013-02-25,3,Bed Number 3,15,13,2
2013-02-26,1,Bed Number 1,20,0,20
2013-02-26,2,Bed Number 2,31,31,0
2013-02-26,3,Bed Number 3,98,2,96
2013-02-27,1,Bed Number 1,84,80,4
2013-02-27,2,Bed Number 2,31,30,1
2013-02-27,3,Bed Number 3,24,10,14
2013-02-28,1,Bed Number 1,44,3,41
2013-02-28,2,Bed Number 2,81,44,37
2013-02-28,3,Bed Number 3,87,27,60
2013-03-01,1,Bed Number 1,95,60,35
2013-03-01,2,Bed Number 2,89,18,71
2013-03-01,3,Bed Number 3,53,13,40
2013-03-02,1,Bed Number 1,16,7,9
2013-03-02,2,Bed Number 2,18,1,17
2013-03-02,3,Bed Number 3,93,47,46
2013-03-03,1,Bed Number 1,80,3,77
2013-03-03,2,Bed Number 2,43,22,21
2013-03-03,3,Bed Number 3,91,34,57
2013-03-04,1,Bed Number 1,56,38,18
2013-03-04,2,Bed Number 2,84,28,56
2013-03-04,3,Bed Number 3,36,20,16
2013-03-05,1,Bed Number 1,44,2,42
2013-03-05,2,Bed Number 2,95,17,78
2013-03-05,3,Bed Number 3,39,21,18
2013-03-06,1,Bed Number 1,43,41,2
2013-03-06,2,Bed Number 2,76,64,12
2013-03-06,3,Bed Number 3,15,1,14
2013-03-07,1,Bed Number 1,19,3,16
2013-03-07,2,Bed Number 2,59,46,13
2013-03-07,3,Bed Number 3,84,26,58
2013-03-08,1,Bed Number 1,47,33,14
2013-03-08,2,Bed Number 2,33,12,21
2013-03-08,3,Bed Number 3,13,1,12
2013-03-09,1,Bed Number 1,99,53,46
2013-03-09,2,Bed Number 2,87,65,22
2013-03-09,3,Bed Number 3,37,23,14
2013-03-10,1,Bed Number 1,66,36,30
2013-03-10,2,Bed Number 2,36,22,14
2013-03-10,3,Bed Number 3,38,4,34
2013-03-11,1,Bed Number 1,15,8,7
2013-03-11,2,Bed Number 2,34,33,1
2013-03-11,3,Bed Number 3,60,50,10
2013-03-12,1,Bed Number 1,20,12,8
2013-03-12,2,Bed Number 2,71,51,20
2013-03-12,3,Bed Number 3,66,55,11
2013-03-13,1,Bed Number 1,32,5,27
2013-03-13,2,Bed Number 2,67,66,1
2013-03-13,3,Bed Number 3,57,9,48
2013-03-14,1,Bed Number 1,96,14,82
2013-03-14,2,Bed Number 2,32,16,16
2013-03-14,3,Bed Number 3,99,3,96
2013-03-15,1,Bed Number 1,82,32,50
2013-03-15,2,Bed Number 2,44,10,34
2013-03-15,3,Bed Number 3,98,86,12
2013-03-16,1,Bed Number 1,37,35,2
2013-03-16,2,Bed Number 2,58,29,29
2013-03-16,3,Bed Number 3,42,37,5
2013-03-17,1,Bed Number 1,62,13,49
2013-03-17,2,Bed Number 2,25,11,14
2013-03-17,3,Bed Number 3,62,8,54
2013-03-18,1,Bed Number 1,50,29,21
2013-03-18,2,Bed Number 2,43,3,40
2013-03-18,3,Bed Number 3,25,22,3
2013-03-19,1,Bed Number 1,58,3,55
2013-03-19,2,Bed Number 2,13,11,2
2013-03-19,3,Bed Number 3,89,71,18
2013-03-20,1,Bed Number 1,50,25,25
2013-03-20,2,Bed Number 2,44,39,5
2013-03-20,3,Bed Number 3,84,58,26
2013-03-21,1,Bed Number 1,62,56,6
2013-03-21,2,Bed Number 2,40,26,14
2013-03-21,3,Bed Number 3,52,39,13
2013-03-22,1,Bed Number 1,88,16,72
2013-03-22,2,Bed Number 2,26,24,2
2013-03-22,3,Bed Number 3,38,26,12
2013-03-23,1,Bed Number 1,74,41,33
2013-03-23,2,Bed Number 2,36,8,28
2013-03-23,3,Bed Number 3,99,41,58
2013-03-24,1,Bed Number 1,80,12,68
2013-03-24,2,Bed Number 2,30,16,14
2013-03-24,3,Bed Number 3,94,18,76
2013-03-25,1,Bed Number 1,14,4,10
2013-03-25,2,Bed Number 2,73,19,54
2013-03-25,3,Bed Number 3,53,52,1
2013-03-26,1,Bed Number 1,30,11,19
2013-03-26,2,Bed Number 2,13,6,7
2013-03-26,3,Bed Number 3,54,41,13
2013-03-27,1,Bed Number 1,34,10,24
2013-03-27,2,Bed Number 2,100,15,85
2013-03-27,3,Bed Number 3,10,0,10
2013-03-28,1,Bed Number 1,71,42,29
2013-03-28,2,Bed Number 2,72,29,43
2013-03-28,3,Bed Number 3,62,26,36
2013-03-29,1,Bed Number 1,38,15,23
2013-03-29,2,Bed Number 2,77,0,77
2013-03-29,3,Bed Number 3,83,1,82
2013-03-30,1,Bed Number 1,73,66,7
2013-03-30,2,Bed Number 2,31,8,23
2013-03-30,3,Bed Number 3,39,22,17
2013-03-31,1,Bed Number 1,40,20,20
2013-03-31,2,Bed Number 2,42,12,30
2013-03-31,3,Bed Number 3,74,68,6
2013-04-01,1,Bed Number 1,66,65,1
2013-04-01,2,Bed Number 2,73,32,41
2013-04-01,3,Bed Number 3,60,44,16
2013-04-02,1,Bed Number 1,59,7,52
2013-04-02,2,Bed Number 2,94,9,85
2013-04-02,3,Bed Number 3,83,39,44
2013-04-03,1,Bed Number 1,83,60,23
2013-04-03,2,Bed Number 2,51,35,16
2013-04-03,3,Bed Number 3,86,67,19
2013-04-04,1,Bed Number 1,40,18,22
2013-04-04,2,Bed Number 2,92,67,25
2013-04-04,3,Bed Number 3,93,35,58
2013-04-05,1,Bed Number 1,98,31,67
2013-04-05,2,Bed Number 2,49,20,29
2013-04-05,3,Bed Number 3,66,65,1
2013-04-06,1,Bed Number 1,38,34,4
2013-04-06,2,Bed Number 2,55,14,41
2013-04-06,3,Bed Number 3,80,37,43
2013-04-07,1,Bed Number 1,43,43,0
2013-04-07,2,Bed Number 2,78,1,77
2013-04-07,3,Bed Number 3,58,39,19
2013-04-08,1,Bed Number 1,47,1,46
2013-04-08,2,Bed Number 2,96,3,93
2013-04-08,3,Bed Number 3,26,4,22
2013-04-09,1,Bed Number 1,30,20,10
2013-04-09,2,Bed Number 2,27,8,19
2013-04-09,3,Bed Number 3,77,76,1
2013-04-10,1,Bed Number 1,80,65,15
2013-04-10,2,Bed Number 2,64,30,34
2013-04-10,3,Bed Number 3,55,27,28
2013-04-11,1,Bed Number 1,32,20,12
2013-04-11,2,Bed Number 2,10,4,6
2013-04-11,3,Bed Number 3,37,28,9
2013-04-12,1,Bed Number 1,65,15,50
2013-04-12,2,Bed Number 2,82,76,6
2013-04-12,3,Bed Number 3,43,25,18
2013-04-13,1,Bed Number 1,20,3,17
2013-04-13,2,Bed Number 2,83,64,19
2013-04-13,3,Bed Number 3,42,29,13
2013-04-14,1,Bed Number 1,57,42,15
2013-04-14,2,Bed Number 2,21,10,11
2013-04-14,3,Bed Number 3,15,3,12
2013-04-15,1,Bed Number 1,61,57,4
2013-04-15,2,Bed Number 2,15,4,11
2013-04-15,3,Bed Number 3,40,38,2
2013-04-16,1,Bed Number 1,82,18,64
2013-04-16,2,Bed Number 2,30,1,29
2013-04-16,3,Bed Number 3,42,16,26
2013-04-17,1,Bed Number 1,21,6,15
2013-04-17,2,Bed Number 2,28,10,18
2013-04-17,3,Bed Number 3,89,62,27
2013-04-18,1,Bed Number 1,78,5,73
2013-04-18,2,Bed Number 2,25,23,2
2013-04-18,3,Bed Number 3,21,17,4
2013-04-19,1,Bed Number 1,58,16,42
2013-04-19,2,Bed Number 2,69,57,12
2013-04-19,3,Bed Number 3,42,41,1
2013-04-20,1,Bed Number 1,84,19,65
2013-04-20,2,Bed Number 2,23,14,9
2013-04-20,3,Bed Number 3,37,20,17
2013-04-21,1,Bed Number 1,58,46,12
2013-04-21,2,Bed Number 2,94,68,26
2013-04-21,3,Bed Number 3,71,9,62
2013-04-22,1,Bed Number 1,49,34,15
2013-04-22,2,Bed Number 2,31,4,27
2013-04-22,3,Bed Number 3,99,91,8
2013-04-23,1,Bed Number 1,19,6,13
2013-04-23,2,Bed Number 2,100,30,70
2013-04-23,3,Bed Number 3,63,56,7
2013-04-24,1,Bed Number 1,30,21,9
2013-04-24,2,Bed Number 2,96,3,93
2013-04-24,3,Bed Number 3,69,62,7
2013-04-25,1,Bed Number 1,62,25,37
2013-04-25,2,Bed Number 2,48,15,33
2013-04-25,3,Bed Number 3,61,5,56
2013-04-26,1,Bed Number 1,32,25,7
2013-04-26,2,Bed Number 2,73,48,25
2013-04-26,3,Bed Number 3,36,10,26
2013-04-27,1,Bed Number 1,65,32,33
2013-04-27,2,Bed Number 2,21,21,0
2013-04-27,3,Bed Number 3,56,30,26
2013-04-28,1,Bed Number 1,49,39,10
2013-04-28,2,Bed Number 2,74,34,40
2013-04-28,3,Bed Number 3,57,4,53
2013-04-29,1,Bed Number 1,84,60,24
2013-04-29,2,Bed Number 2,50,4,46
2013-04-29,3,Bed Number 3,41,12,29
2013-04-30,1,Bed Number 1,10,4,6
2013-04-30,2,Bed Number 2,68,30,38
2013-04-30,3,Bed Number 3,19,14,5
2013-05-01,1,Bed Number 1,72,70,2
2013-05-01,2,Bed Number 2,56,40,16
2013-05-01,3,Bed Number 3,92,1,91
2013-05-02,1,Bed Number 1,12,4,8
2013-05-02,2,Bed Number 2,61,22,39
2013-05-02,3,Bed Number 3,66,4,62
2013-05-03,1,Bed Number 1,90,7,83
2013-05-03,2,Bed Number 2,94,55,39
2013-05-03,3,Bed Number 3,62,10,52
2013-05-04,1,Bed Number 1,97,41,56
2013-05-04,2,Bed Number 2,78,75,3
2013-05-04,3,Bed Number 3,79,36,43
2013-05-05,1,Bed Number 1,18,10,8
2013-05-05,2,Bed Number 2,65,50,15
2013-05-05,3,Bed Number 3,30,1,29
2013-05-06,1,Bed Number 1,17,1,16
2013-05-06,2,Bed Number 2,100,83,17
2013-05-06,3,Bed Number 3,71,12,59
2013-05-07,1,Bed Number 1,68,6,62
2013-05-07,2,Bed Number 2,91,71,20
2013-05-07,3,Bed Number 3,14,14,0
2013-05-08,1,Bed Number 1,83,22,61
2013-05-08,2,Bed Number 2,14,8,6
2013-05-08,3,Bed Number 3,99,20,79
2013-05-09,1,Bed Number 1,90,34,56
2013-05-09,2,Bed Number 2,29,4,25
2013-05-09,3,Bed Number 3,63,41,22
2013-05-10,1,Bed Number 1,46,23,23
2013-05-10,2,Bed Number 2,67,32,35
2013-05-10,3,Bed Number 3,42,31,11
2013-05-11,1,Bed Number 1,53,52,1
2013-05-11,2,Bed Number 2,33,26,7
2013-05-11,3,Bed Number 3,100,46,54
2013-05-12,1,Bed Number 1,48,32,16
2013-05-12,2,Bed Number 2,16,4,12
2013-05-12,3,Bed Number 3,87,79,8
2013-05-13,1,Bed Number 1,85,15,70
2013-05-13,2,Bed Number 2,50,0,50
2013-05-13,3,Bed Number 3,23,0,23
2013-05-14,1,Bed Number 1,40,29,11
2013-05-14,2,Bed Number 2,46,0,46
2013-05-14,3,Bed Number 3,72,38,34
2013-05-15,1,Bed Number 1,66,39,27
2013-05-15,2,Bed Number 2,98,20,78
2013-05-15,3,Bed Number 3,39,32,7
2013-05-16,1,Bed Number 1,90,74,16
2013-05-16,2,Bed Number 2,75,70,5
2013-05-16,3,Bed Number 3,75,28,47
2013-05-17,1,Bed Number 1,65,14,51
2013-05-17,2,Bed Number 2,76,56,20
2013-05-17,3,Bed Number 3,54,20,34
2013-05-18,1,Bed Number 1,99,92,7
2013-05-18,2,Bed Number 2,66,44,22
2013-05-18,3,Bed Number 3,51,2,49
2013-05-19,1,Bed Number 1,86,84,2
2013-05-19,2,Bed Number 2,39,36,3
2013-05-19,3,Bed Number 3,52,31,21
2013-05-20,1,Bed Number 1,14,9,5
2013-05-20,2,Bed Number 2,54,45,9
2013-05-20,3,Bed Number 3,44,24,20
2013-05-21,1,Bed Number 1,65,55,10
2013-05-21,2,Bed Number 2,97,40,57
2013-05-21,3,Bed Number 3,27,18,9
2013-05-22,1,Bed Number 1,20,19,1
2013-05-22,2,Bed Number 2,74,63,11
2013-05-22,3,Bed Number 3,78,29,49
2013-05-23,1,Bed Number 1,26,16,10
2013-05-23,2,Bed Number 2,21,4,17
2013-05-23,3,Bed Number 3,75,0,75
2013-05-24,1,Bed Number 1,64,49,15
2013-05-24,2,Bed Number 2,62,52,10
2013-05-24,3,Bed Number 3,99,15,84
2013-05-25,1,Bed Number 1,68,1,67
2013-05-25,2,Bed Number 2,24,11,13
2013-05-25,3,Bed Number 3,71,32,39
2013-05-26,1,Bed Number 1,68,12,56
2013-05-26,2,Bed Number 2,12,12,0
2013-05-26,3,Bed Number 3,57,37,20
2013-05-27,1,Bed Number 1,89,76,13
2013-05-27,2,Bed Number 2,51,17,34
2013-05-27,3,Bed Number 3,82,38,44
2013-05-28,1,Bed Number 1,25,15,10
2013-05-28,2,Bed Number 2,94,84,10
2013-05-28,3,Bed Number 3,38,15,23
2013-05-29,1,Bed Number 1,16,10,6
2013-05-29,2,Bed Number 2,51,32,19
2013-05-29,3,Bed Number 3,25,9,16
2013-05-30,1,Bed Number 1,15,13,2
2013-05-30,2,Bed Number 2,67,44,23
2013-05-30,3,Bed Number 3,73,66,7
2013-05-31,1,Bed Number 1,26,11,15
2013-05-31,2,Bed Number 2,51,18,33
2013-05-31,3,Bed Number 3,93,9,84
2013-06-01,1,Bed Number 1,74,41,33
2013-06-01,2,Bed Number 2,74,47,27
2013-06-01,3,Bed Number 3,13,7,6
2013-06-02,1,Bed Number 1,72,10,62
2013-06-02,2,Bed Number 2,59,21,38
2013-06-02,3,Bed Number 3,42,1,41
2013-06-03,1,Bed Number 1,64,57,7
2013-06-03,2,Bed Number 2,81,50,31
2013-06-03,3,Bed Number 3,75,74,1
2013-06-04,1,Bed Number 1,99,55,44
2013-06-04,2,Bed Number 2,31,18,13
2013-06-04,3,Bed Number 3,21,8,13
2013-06-05,1,Bed Number 1,26,15,11
2013-06-05,2,Bed Number 2,67,6,61
2013-06-05,3,Bed Number 3,100,9,91
2013-06-06,1,Bed Number 1,39,5,34
2013-06-06,2,Bed Number 2,21,10,11
2013-06-06,3,Bed Number 3,94,13,81
2013-06-07,1,Bed Number 1,25,22,3
2013-06-07,2,Bed Number 2,15,4,11
2013-06-07,3,Bed Number 3,87,34,53
2013-06-08,1,Bed Number 1,43,43,0
2013-06-08,2,Bed Number 2,49,19,30
2013-06-08,3,Bed Number 3,37,28,9
2013-06-09,1,Bed Number 1,18,6,12
2013-06-09,2,Bed Number 2,82,37,45
2013-06-09,3,Bed Number 3,64,4,60
2013-06-10,1,Bed Number 1,43,1,42
2013-06-10,2,Bed Number 2,21,8,13
2013-06-10,3,Bed Number 3,72,37,35
2013-06-11,1,Bed Number 1,79,71,8
2013-06-11,2,Bed Number 2,70,11,59
2013-06-11,3,Bed Number 3,34,17,17
2013-06-12,1,Bed Number 1,58,16,42
2013-06-12,2,Bed Number 2,96,90,6
2013-06-12,3,Bed Number 3,25,5,20
2013-06-13,1,Bed Number 1,52,8,44
2013-06-13,2,Bed Number 2,37,34,3
2013-06-13,3,Bed Number 3,38,1,37
2013-06-14,1,Bed Number 1,56,4,52
2013-06-14,2,Bed Number 2,79,77,2
2013-06-14,3,Bed Number 3,20,13,7
2013-06-15,1,Bed Number 1,42,11,31
2013-06-15,2,Bed Number 2,89,41,48
2013-06-15,3,Bed Number 3,10,6,4
2013-06-16,1,Bed Number 1,16,15,1
2013-06-16,2,Bed Number 2,77,64,13
2013-06-16,3,Bed Number 3,26,4,22
2013-06-17,1,Bed Number 1,93,14,79
2013-06-17,2,Bed Number 2,85,85,0
2013-06-17,3,Bed Number 3,53,14,39
2013-06-18,1,Bed Number 1,43,38,5
2013-06-18,2,Bed Number 2,19,2,17
2013-06-18,3,Bed Number 3,91,17,74
2013-06-19,1,Bed Number 1,86,7,79
2013-06-19,2,Bed Number 2,28,18,10
2013-06-19,3,Bed Number 3,40,6,34
2013-06-20,1,Bed Number 1,28,20,8
2013-06-20,2,Bed Number 2,83,29,54
2013-06-20,3,Bed Number 3,78,47,31
2013-06-21,1,Bed Number 1,91,57,34
2013-06-21,2,Bed Number 2,45,7,38
2013-06-21,3,Bed Number 3,90,81,9
2013-06-22,1,Bed Number 1,89,33,56
2013-06-22,2,Bed Number 2,69,20,49
2013-06-22,3,Bed Number 3,13,5,8
2013-06-23,1,Bed Number 1,24,12,12
2013-06-23,2,Bed Number 2,73,51,22
2013-06-23,3,Bed Number 3,95,79,16
2013-06-24,1,Bed Number 1,59,39,20
2013-06-24,2,Bed Number 2,88,49,39
2013-06-24,3,Bed Number 3,80,39,41
2013-06-25,1,Bed Number 1,48,22,26
2013-06-25,2,Bed Number 2,75,0,75
2013-06-25,3,Bed Number 3,52,30,22
2013-06-26,1,Bed Number 1,87,69,18
2013-06-26,2,Bed Number 2,35,26,9
2013-06-26,3,Bed Number 3,76,27,49
2013-06-27,1,Bed Number 1,26,8,18
2013-06-27,2,Bed Number 2,97,34,63
2013-06-27,3,Bed Number 3,72,53,19
2013-06-28,1,Bed Number 1,70,42,28
2013-06-28,2,Bed Number 2,78,68,10
2013-06-28,3,Bed Number 3,33,1,32
2013-06-29,1,Bed Number 1,10,6,4
2013-06-29,2,Bed Number 2,95,86,9
2013-06-29,3,Bed Number 3,37,33,4
2013-06-30,1,Bed Number 1,81,78,3
2013-06-30,2,Bed Number 2,94,4,90
2013-06-30,3,Bed Number 3,22,9,13
2013-07-01,1,Bed Number 1,23,13,10
2013-07-01,2,Bed Number 2,12,12,0
2013-07-01,3,Bed Number 3,53,36,17
2013-07-02,1,Bed Number 1,29,18,11
2013-07-02,2,Bed Number 2,80,44,36
2013-07-02,3,Bed Number 3,88,61,27
2013-07-03,1,Bed Number 1,14,2,12
2013-07-03,2,Bed Number 2,88,66,22
2013-07-03,3,Bed Number 3,53,8,45
2013-07-04,1,Bed Number 1,57,35,22
2013-07-04,2,Bed Number 2,69,5,64
2013-07-04,3,Bed Number 3,92,16,76
2013-07-05,1,Bed Number 1,23,15,8
2013-07-05,2,Bed Number 2,37,20,17
2013-07-05,3,Bed Number 3,43,24,19
2013-07-06,1,Bed Number 1,52,42,10
2013-07-06,2,Bed Number 2,29,15,14
2013-07-06,3,Bed Number 3,17,2,15
2013-07-07,1,Bed Number 1,23,9,14
2013-07-07,2,Bed Number 2,80,6,74
2013-07-07,3,Bed Number 3,39,21,18
2013-07-08,1,Bed Number 1,11,0,11
2013-07-08,2,Bed Number 2,86,62,24
2013-07-08,3,Bed Number 3,50,5,45
2013-07-09,1,Bed Number 1,99,77,22
2013-07-09,2,Bed Number 2,40,5,35
2013-07-09,3,Bed Number 3,58,57,1
2013-07-10,1,Bed Number 1,93,25,68
2013-07-10,2,Bed Number 2,81,48,33
2013-07-10,3,Bed Number 3,31,30,1
2013-07-11,1,Bed Number 1,99,84,15
2013-07-11,2,Bed Number 2,13,4,9
2013-07-11,3,Bed Number 3,15,13,2
2013-07-12,1,Bed Number 1,19,2,17
2013-07-12,2,Bed Number 2,32,24,8
2013-07-12,3,Bed Number 3,88,15,73
2013-07-13,1,Bed Number 1,65,43,22
2013-07-13,2,Bed Number 2,66,36,30
2013-07-13,3,Bed Number 3,18,9,9
2013-07-14,1,Bed Number 1,10,2,8
2013-07-14,2,Bed Number 2,28,15,13
2013-07-14,3,Bed Number 3,91,90,1
2013-07-15,1,Bed Number 1,36,17,19
2013-07-15,2,Bed Number 2,53,48,5
2013-07-15,3,Bed Number 3,16,10,6
2013-07-16,1,Bed Number 1,83,17,66
2013-07-16,2,Bed Number 2,57,56,1
2013-07-16,3,Bed Number 3,77,2,75
2013-07-17,1,Bed Number 1,18,6,12
2013-07-17,2,Bed Number 2,16,9,7
2013-07-17,3,Bed Number 3,88,12,76
2013-07-18,1,Bed Number 1,31,17,14
2013-07-18,2,Bed Number 2,64,38,26
2013-07-18,3,Bed Number 3,65,49,16
2013-07-19,1,Bed Number 1,24,20,4
2013-07-19,2,Bed Number 2,12,3,9
2013-07-19,3,Bed Number 3,80,67,13
2013-07-20,1,Bed Number 1,63,63,0
2013-07-20,2,Bed Number 2,94,42,52
2013-07-20,3,Bed Number 3,35,35,0
2013-07-21,1,Bed Number 1,31,12,19
2013-07-21,2,Bed Number 2,51,22,29
2013-07-21,3,Bed Number 3,85,61,24
2013-07-22,1,Bed Number 1,96,35,61
2013-07-22,2,Bed Number 2,87,67,20
2013-07-22,3,Bed Number 3,29,4,25
2013-07-23,1,Bed Number 1,71,19,52
2013-07-23,2,Bed Number 2,55,9,46
2013-07-23,3,Bed Number 3,64,26,38
2013-07-24,1,Bed Number 1,44,24,20
2013-07-24,2,Bed Number 2,72,55,17
2013-07-24,3,Bed Number 3,64,47,17
2013-07-25,1,Bed Number 1,33,2,31
2013-07-25,2,Bed Number 2,57,22,35
2013-07-25,3,Bed Number 3,47,33,14
2013-07-26,1,Bed Number 1,56,6,50
2013-07-26,2,Bed Number 2,81,7,74
2013-07-26,3,Bed Number 3,30,28,2
2013-07-27,1,Bed Number 1,28,18,10
2013-07-27,2,Bed Number 2,15,2,13
2013-07-27,3,Bed Number 3,83,14,69
2013-07-28,1,Bed Number 1,76,71,5
2013-07-28,2,Bed Number 2,44,36,8
2013-07-28,3,Bed Number 3,99,76,23
2013-07-29,1,Bed Number 1,22,5,17
2013-07-29,2,Bed Number 2,69,38,31
2013-07-29,3,Bed Number 3,40,17,23
2013-07-30,1,Bed Number 1,57,30,27
2013-07-30,2,Bed Number 2,40,12,28
2013-07-30,3,Bed Number 3,95,35,60
2013-07-31,1,Bed Number 1,35,3,32
2013-07-31,2,Bed Number 2,45,9,36
2013-07-31,3,Bed Number 3,46,43,3
2013-08-01,1,Bed Number 1,27,15,12
2013-08-01,2,Bed Number 2,54,4,50
2013-08-01,3,Bed Number 3,80,62,18
2013-08-02,1,Bed Number 1,19,13,6
2013-08-02,2,Bed Number 2,97,59,38
2013-08-02,3,Bed Number 3,39,11,28
2013-08-03,1,Bed Number 1,57,41,16
2013-08-03,2,Bed Number 2,99,47,52
2013-08-03,3,Bed Number 3,20,14,6
2013-08-04,1,Bed Number 1,70,67,3
2013-08-04,2,Bed Number 2,34,19,15
2013-08-04,3,Bed Number 3,45,33,12
2013-08-05,1,Bed Number 1,89,37,52
2013-08-05,2,Bed Number 2,91,28,63
2013-08-05,3,Bed Number 3,68,12,56
2013-08-06,1,Bed Number 1,32,29,3
2013-08-06,2,Bed Number 2,42,40,2
2013-08-06,3,Bed Number 3,56,46,10
2013-08-07,1,Bed Number 1,10,4,6
2013-08-07,2,Bed Number 2,99,68,31
2013-08-07,3,Bed Number 3,98,79,19
2013-08-08,1,Bed Number 1,13,2,11
2013-08-08,2,Bed Number 2,79,30,49
2013-08-08,3,Bed Number 3,62,14,48
2013-08-09,1,Bed Number 1,20,11,9
2013-08-09,2,Bed Number 2,15,10,5
2013-08-09,3,Bed Number 3,75,9,66
2013-08-10,1,Bed Number 1,25,8,17
2013-08-10,2,Bed Number 2,75,22,53
2013-08-10,3,Bed Number 3,25,16,9
2013-08-11,1,Bed Number 1,53,18,35
2013-08-11,2,Bed Number 2,94,94,0
2013-08-11,3,Bed Number 3,40,36,4
2013-08-12,1,Bed Number 1,53,11,42
2013-08-12,2,Bed Number 2,35,34,1
2013-08-12,3,Bed Number 3,75,24,51
2013-08-13,1,Bed Number 1,66,23,43
2013-08-13,2,Bed Number 2,22,16,6
2013-08-13,3,Bed Number 3,10,6,4
2013-08-14,1,Bed Number 1,42,3,39
2013-08-14,2,Bed Number 2,34,13,21
2013-08-14,3,Bed Number 3,33,11,22
2013-08-15,1,Bed Number 1,15,14,1
2013-08-15,2,Bed Number 2,64,7,57
2013-08-15,3,Bed Number 3,29,5,24
2013-08-16,1,Bed Number 1,61,60,1
2013-08-16,2,Bed Number 2,57,5,52
2013-08-16,3,Bed Number 3,22,12,10
2013-08-17,1,Bed Number 1,72,26,46
2013-08-17,2,Bed Number 2,100,22,78
2013-08-17,3,Bed Number 3,72,14,58
2013-08-18,1,Bed Number 1,81,16,65
2013-08-18,2,Bed Number 2,98,48,50
2013-08-18,3,Bed Number 3,97,95,2
2013-08-19,1,Bed Number 1,39,26,13
2013-08-19,2,Bed Number 2,47,45,2
2013-08-19,3,Bed Number 3,13,12,1
2013-08-20,1,Bed Number 1,50,16,34
2013-08-20,2,Bed Number 2,100,31,69
2013-08-20,3,Bed Number 3,26,19,7
2013-08-21,1,Bed Number 1,52,21,31
2013-08-21,2,Bed Number 2,31,11,20
2013-08-21,3,Bed Number 3,74,48,26
2013-08-22,1,Bed Number 1,15,12,3
2013-08-22,2,Bed Number 2,65,33,32
2013-08-22,3,Bed Number 3,85,12,73
2013-08-23,1,Bed Number 1,91,71,20
2013-08-23,2,Bed Number 2,48,13,35
2013-08-23,3,Bed Number 3,41,15,26
2013-08-24,1,Bed Number 1,100,69,31
2013-08-24,2,Bed Number 2,85,57,28
2013-08-24,3,Bed Number 3,22,17,5
2013-08-25,1,Bed Number 1,15,7,8
2013-08-25,2,Bed Number 2,49,4,45
2013-08-25,3,Bed Number 3,44,17,27
2013-08-26,1,Bed Number 1,19,17,2
2013-08-26,2,Bed Number 2,76,66,10
2013-08-26,3,Bed Number 3,55,43,12
2013-08-27,1,Bed Number 1,34,5,29
2013-08-27,2,Bed Number 2,45,45,0
2013-08-27,3,Bed Number 3,97,66,31
2013-08-28,1,Bed Number 1,11,3,8
2013-08-28,2,Bed Number 2,66,64,2
2013-08-28,3,Bed Number 3,100,24,76
2013-08-29,1,Bed Number 1,93,30,63
2013-08-29,2,Bed Number 2,37,23,14
2013-08-29,3,Bed Number 3,52,27,25
2013-08-30,1,Bed Number 1,45,34,11
2013-08-30,2,Bed Number 2,75,39,36
2013-08-30,3,Bed Number 3,54,26,28
2013-08-31,1,Bed Number 1,46,13,33
2013-08-31,2,Bed Number 2,68,47,21
2013-08-31,3,Bed Number 3,63,33,30
2013-09-01,1,Bed Number 1,42,18,24
2013-09-01,2,Bed Number 2,39,2,37
2013-09-01,3,Bed Number 3,25,8,17
2013-09-02,1,Bed Number 1,35,14,21
2013-09-02,2,Bed Number 2,21,2,19
2013-09-02,3,Bed Number 3,99,42,57
2013-09-03,1,Bed Number 1,15,2,13
2013-09-03,2,Bed Number 2,41,34,7
2013-09-03,3,Bed Number 3,15,13,2
2013-09-04,1,Bed Number 1,44,26,18
2013-09-04,2,Bed Number 2,88,61,27
2013-09-04,3,Bed Number 3,21,5,16
2013-09-05,1,Bed Number 1,99,47,52
2013-09-05,2,Bed Number 2,20,0,20
2013-09-05,3,Bed Number 3,33,18,15
2013-09-06,1,Bed Number 1,51,8,43
2013-09-06,2,Bed Number 2,73,35,38
2013-09-06,3,Bed Number 3,96,76,20
2013-09-07,1,Bed Number 1,42,33,9
2013-09-07,2,Bed Number 2,58,40,18
2013-09-07,3,Bed Number 3,52,33,19
2013-09-08,1,Bed Number 1,94,41,53
2013-09-08,2,Bed Number 2,16,15,1
2013-09-08,3,Bed Number 3,76,35,41
2013-09-09,1,Bed Number 1,47,43,4
2013-09-09,2,Bed Number 2,33,1,32
2013-09-09,3,Bed Number 3,22,5,17
2013-09-10,1,Bed Number 1,25,24,1
2013-09-10,2,Bed Number 2,19,1,18
2013-09-10,3,Bed Number 3,89,1,88
2013-09-11,1,Bed Number 1,48,29,19
2013-09-11,2,Bed Number 2,18,0,18
2013-09-11,3,Bed Number 3,76,62,14
2013-09-12,1,Bed Number 1,92,6,86
2013-09-12,2,Bed Number 2,29,21,8
2013-09-12,3,Bed Number 3,68,8,60
2013-09-13,1,Bed Number 1,50,9,41
2013-09-13,2,Bed Number 2,83,29,54
2013-09-13,3,Bed Number 3,91,67,24
2013-09-14,1,Bed Number 1,92,16,76
2013-09-14,2,Bed Number 2,83,51,32
2013-09-14,3,Bed Number 3,78,32,46
2013-09-15,1,Bed Number 1,52,12,40
2013-09-15,2,Bed Number 2,100,55,45
2013-09-15,3,Bed Number 3,53,26,27
2013-09-16,1,Bed Number 1,12,5,7
2013-09-16,2,Bed Number 2,20,0,20
2013-09-16,3,Bed Number 3,33,6,27
2013-09-17,1,Bed Number 1,100,33,67
2013-09-17,2,Bed Number 2,83,60,23
2013-09-17,3,Bed Number 3,75,38,37
2013-09-18,1,Bed Number 1,19,3,16
2013-09-18,2,Bed Number 2,22,3,19
2013-09-18,3,Bed Number 3,41,16,25
2013-09-19,1,Bed Number 1,79,35,44
2013-09-19,2,Bed Number 2,50,46,4
2013-09-19,3,Bed Number 3,60,54,6
2013-09-20,1,Bed Number 1,26,24,2
2013-09-20,2,Bed Number 2,99,14,85
2013-09-20,3,Bed Number 3,34,33,1
2013-09-21,1,Bed Number 1,77,65,12
2013-09-21,2,Bed Number 2,89,17,72
2013-09-21,3,Bed Number 3,43,2,41
2013-09-22,1,Bed Number 1,50,45,5
2013-09-22,2,Bed Number 2,23,9,14
2013-09-22,3,Bed Number 3,33,26,7
2013-09-23,1,Bed Number 1,55,12,43
2013-09-23,2,Bed Number 2,64,26,38
2013-09-23,3,Bed Number 3,14,14,0
2013-09-24,1,Bed Number 1,88,19,69
2013-09-24,2,Bed Number 2,37,29,8
2013-09-24,3,Bed Number 3,88,10,78
2013-09-25,1,Bed Number 1,90,60,30
2013-09-25,2,Bed Number 2,17,6,11
2013-09-25,3,Bed Number 3,47,18,29
2013-09-26,1,Bed Number 1,42,19,23
2013-09-26,2,Bed Number 2,92,92,0
2013-09-26,3,Bed Number 3,88,3,85
2013-09-27,1,Bed Number 1,77,18,59
2013-09-27,2,Bed Number 2,28,26,2
2013-09-27,3,Bed Number 3,71,37,34
2013-09-28,1,Bed Number 1,88,87,1
2013-09-28,2,Bed Number 2,90,26,64
2013-09-28,3,Bed Number 3,20,14,6
2013-09-29,1,Bed Number 1,19,2,17
2013-09-29,2,Bed Number 2,83,25,58
2013-09-29,3,Bed Number 3,87,71,16
2013-09-30,1,Bed Number 1,56,25,31
2013-09-30,2,Bed Number 2,98,24,74
2013-09-30,3,Bed Number 3,71,25,46
2013-10-01,1,Bed Number 1,53,26,27
2013-10-01,2,Bed Number 2,27,4,23
2013-10-01,3,Bed Number 3,37,17,20
2013-10-02,1,Bed Number 1,67,46,21
2013-10-02,2,Bed Number 2,32,21,11
2013-10-02,3,Bed Number 3,95,81,14
2013-10-03,1,Bed Number 1,80,35,45
2013-10-03,2,Bed Number 2,37,13,24
2013-10-03,3,Bed Number 3,42,27,15
2013-10-04,1,Bed Number 1,43,40,3
2013-10-04,2,Bed Number 2,43,42,1
2013-10-04,3,Bed Number 3,80,42,38
2013-10-05,1,Bed Number 1,23,5,18
2013-10-05,2,Bed Number 2,55,43,12
2013-10-05,3,Bed Number 3,78,49,29
2013-10-06,1,Bed Number 1,97,35,62
2013-10-06,2,Bed Number 2,67,19,48
2013-10-06,3,Bed Number 3,13,11,2
2013-10-07,1,Bed Number 1,68,21,47
2013-10-07,2,Bed Number 2,20,15,5
2013-10-07,3,Bed Number 3,56,48,8
2013-10-08,1,Bed Number 1,92,72,20
2013-10-08,2,Bed Number 2,69,38,31
2013-10-08,3,Bed Number 3,44,42,2
2013-10-09,1,Bed Number 1,92,12,80
2013-10-09,2,Bed Number 2,69,2,67
2013-10-09,3,Bed Number 3,23,21,2
2013-10-10,1,Bed Number 1,72,46,26
2013-10-10,2,Bed Number 2,81,1,80
2013-10-10,3,Bed Number 3,54,19,35
2013-10-11,1,Bed Number 1,43,4,39
2013-10-11,2,Bed Number 2,81,5,76
2013-10-11,3,Bed Number 3,17,13,4
2013-10-12,1,Bed Number 1,80,28,52
2013-10-12,2,Bed Number 2,38,8,30
2013-10-12,3,Bed Number 3,75,51,24
2013-10-13,1,Bed Number 1,73,39,34
2013-10-13,2,Bed Number 2,58,50,8
2013-10-13,3,Bed Number 3,28,11,17
2013-10-14,1,Bed Number 1,64,27,37
2013-10-14,2,Bed Number 2,71,69,2
2013-10-14,3,Bed Number 3,10,10,0
2013-10-15,1,Bed Number 1,47,2,45
2013-10-15,2,Bed Number 2,36,11,25
2013-10-15,3,Bed Number 3,96,13,83
2013-10-16,1,Bed Number 1,18,2,16
2013-10-16,2,Bed Number 2,50,21,29
2013-10-16,3,Bed Number 3,13,4,9
2013-10-17,1,Bed Number 1,70,7,63
2013-10-17,2,Bed Number 2,90,68,22
2013-10-17,3,Bed Number 3,47,44,3
2013-10-18,1,Bed Number 1,44,44,0
2013-10-18,2,Bed Number 2,100,2,98
2013-10-18,3,Bed Number 3,11,0,11
2013-10-19,1,Bed Number 1,75,11,64
2013-10-19,2,Bed Number 2,41,19,22
2013-10-19,3,Bed Number 3,81,44,37
2013-10-20,1,Bed Number 1,65,47,18
2013-10-20,2,Bed Number 2,86,14,72
2013-10-20,3,Bed Number 3,35,8,27
2013-10-21,1,Bed Number 1,19,17,2
2013-10-21,2,Bed Number 2,21,5,16
2013-10-21,3,Bed Number 3,100,18,82
2013-10-22,1,Bed Number 1,41,37,4
2013-10-22,2,Bed Number 2,30,0,30
2013-10-22,3,Bed Number 3,75,4,71
2013-10-23,1,Bed Number 1,24,20,4
2013-10-23,2,Bed Number 2,94,86,8
2013-10-23,3,Bed Number 3,90,2,88
2013-10-24,1,Bed Number 1,68,36,32
2013-10-24,2,Bed Number 2,40,1,39
2013-10-24,3,Bed Number 3,42,25,17
2013-10-25,1,Bed Number 1,82,79,3
2013-10-25,2,Bed Number 2,86,56,30
2013-10-25,3,Bed Number 3,19,15,4
2013-10-26,1,Bed Number 1,40,37,3
2013-10-26,2,Bed Number 2,71,18,53
2013-10-26,3,Bed Number 3,75,21,54
2013-10-27,1,Bed Number 1,23,3,20
2013-10-27,2,Bed Number 2,36,2,34
2013-10-27,3,Bed Number 3,65,39,26
2013-10-28,1,Bed Number 1,95,88,7
2013-10-28,2,Bed Number 2,82,30,52
2013-10-28,3,Bed Number 3,19,19,0
2013-10-29,1,Bed Number 1,45,21,24
2013-10-29,2,Bed Number 2,50,25,25
2013-10-29,3,Bed Number 3,79,34,45
2013-10-30,1,Bed Number 1,15,3,12
2013-10-30,2,Bed Number 2,28,15,13
2013-10-30,3,Bed Number 3,35,33,2
2013-10-31,1,Bed Number 1,41,0,41
2013-10-31,2,Bed Number 2,81,30,51
2013-10-31,3,Bed Number 3,78,15,63
2013-11-01,1,Bed Number 1,39,28,11
2013-11-01,2,Bed Number 2,31,22,9
2013-11-01,3,Bed Number 3,24,7,17
2013-11-02,1,Bed Number 1,86,26,60
2013-11-02,2,Bed Number 2,100,29,71
2013-11-02,3,Bed Number 3,55,43,12
2013-11-03,1,Bed Number 1,91,67,24
2013-11-03,2,Bed Number 2,10,6,4
2013-11-03,3,Bed Number 3,54,11,43
2013-11-04,1,Bed Number 1,97,14,83
2013-11-04,2,Bed Number 2,69,17,52
2013-11-04,3,Bed Number 3,10,8,2
2013-11-05,1,Bed Number 1,89,19,70
2013-11-05,2,Bed Number 2,58,23,35
2013-11-05,3,Bed Number 3,93,52,41
2013-11-06,1,Bed Number 1,26,9,17
2013-11-06,2,Bed Number 2,79,47,32
2013-11-06,3,Bed Number 3,48,45,3
2013-11-07,1,Bed Number 1,39,25,14
2013-11-07,2,Bed Number 2,73,9,64
2013-11-07,3,Bed Number 3,54,25,29
2013-11-08,1,Bed Number 1,16,6,10
2013-11-08,2,Bed Number 2,67,45,22
2013-11-08,3,Bed Number 3,95,79,16
2013-11-09,1,Bed Number 1,71,46,25
2013-11-09,2,Bed Number 2,65,19,46
2013-11-09,3,Bed Number 3,27,7,20
2013-11-10,1,Bed Number 1,65,54,11
2013-11-10,2,Bed Number 2,94,38,56
2013-11-10,3,Bed Number 3,99,55,44
2013-11-11,1,Bed Number 1,69,33,36
2013-11-11,2,Bed Number 2,22,12,10
2013-11-11,3,Bed Number 3,74,71,3
2013-11-12,1,Bed Number 1,24,18,6
2013-11-12,2,Bed Number 2,16,0,16
2013-11-12,3,Bed Number 3,43,13,30
2013-11-13,1,Bed Number 1,94,87,7
2013-11-13,2,Bed Number 2,84,72,12
2013-11-13,3,Bed Number 3,100,70,30
2013-11-14,1,Bed Number 1,36,33,3
2013-11-14,2,Bed Number 2,47,36,11
2013-11-14,3,Bed Number 3,13,10,3
2013-11-15,1,Bed Number 1,72,29,43
2013-11-15,2,Bed Number 2,37,0,37
2013-11-15,3,Bed Number 3,68,60,8
2013-11-16,1,Bed Number 1,80,28,52
2013-11-16,2,Bed Number 2,53,17,36
2013-11-16,3,Bed Number 3,73,5,68
2013-11-17,1,Bed Number 1,100,7,93
2013-11-17,2,Bed Number 2,46,26,20
2013-11-17,3,Bed Number 3,82,27,55
2013-11-18,1,Bed Number 1,42,41,1
2013-11-18,2,Bed Number 2,45,8,37
2013-11-18,3,Bed Number 3,99,82,17
2013-11-19,1,Bed Number 1,63,9,54
2013-11-19,2,Bed Number 2,63,30,33
2013-11-19,3,Bed Number 3,65,41,24
2013-11-20,1,Bed Number 1,15,11,4
2013-11-20,2,Bed Number 2,31,13,18
2013-11-20,3,Bed Number 3,97,44,53
2013-11-21,1,Bed Number 1,67,4,63
2013-11-21,2,Bed Number 2,21,4,17
2013-11-21,3,Bed Number 3,76,37,39
2013-11-22,1,Bed Number 1,35,1,34
2013-11-22,2,Bed Number 2,35,21,14
2013-11-22,3,Bed Number 3,67,44,23
2013-11-23,1,Bed Number 1,50,35,15
2013-11-23,2,Bed Number 2,16,7,9
2013-11-23,3,Bed Number 3,10,7,3
2013-11-24,1,Bed Number 1,52,47,5
2013-11-24,2,Bed Number 2,16,12,4
2013-11-24,3,Bed Number 3,34,10,24
2013-11-25,1,Bed Number 1,30,28,2
2013-11-25,2,Bed Number 2,33,12,21
2013-11-25,3,Bed Number 3,49,9,40
2013-11-26,1,Bed Number 1,73,71,2
2013-11-26,2,Bed Number 2,10,3,7
2013-11-26,3,Bed Number 3,92,9,83
2013-11-27,1,Bed Number 1,18,3,15
2013-11-27,2,Bed Number 2,18,17,1
2013-11-27,3,Bed Number 3,39,28,11
2013-11-28,1,Bed Number 1,57,2,55
2013-11-28,2,Bed Number 2,17,15,2
2013-11-28,3,Bed Number 3,76,43,33
2013-11-29,1,Bed Number 1,66,5,61
2013-11-29,2,Bed Number 2,56,44,12
2013-11-29,3,Bed Number 3,85,6,79
2013-11-30,1,Bed Number 1,91,65,26
2013-11-30,2,Bed Number 2,85,26,59
2013-11-30,3,Bed Number 3,75,59,16
2013-12-01,1,Bed Number 1,50,6,44
2013-12-01,2,Bed Number 2,47,38,9
2013-12-01,3,Bed Number 3,95,19,76
2013-12-02,1,Bed Number 1,76,48,28
2013-12-02,2,Bed Number 2,69,63,6
2013-12-02,3,Bed Number 3,65,56,9
2013-12-03,1,Bed Number 1,77,43,34
2013-12-03,2,Bed Number 2,45,3,42
2013-12-03,3,Bed Number 3,64,56,8
2013-12-04,1,Bed Number 1,11,8,3
2013-12-04,2,Bed Number 2,27,12,15
2013-12-04,3,Bed Number 3,17,12,5
2013-12-05,1,Bed Number 1,54,41,13
2013-12-05,2,Bed Number 2,76,0,76
2013-12-05,3,Bed Number 3,12,2,10
2013-12-06,1,Bed Number 1,78,56,22
2013-12-06,2,Bed Number 2,63,17,46
2013-12-06,3,Bed Number 3,42,21,21
2013-12-07,1,Bed Number 1,13,0,13
2013-12-07,2,Bed Number 2,36,4,32
2013-12-07,3,Bed Number 3,32,26,6
2013-12-08,1,Bed Number 1,75,37,38
2013-12-08,2,Bed Number 2,51,20,31
2013-12-08,3,Bed Number 3,63,23,40
2013-12-09,1,Bed Number 1,18,8,10
2013-12-09,2,Bed Number 2,22,18,4
2013-12-09,3,Bed Number 3,64,6,58
2013-12-10,1,Bed Number 1,44,30,14
2013-12-10,2,Bed Number 2,47,2,45
2013-12-10,3,Bed Number 3,42,14,28
2013-12-11,1,Bed Number 1,20,19,1
2013-12-11,2,Bed Number 2,30,8,22
2013-12-11,3,Bed Number 3,64,35,29
2013-12-12,1,Bed Number 1,87,45,42
2013-12-12,2,Bed Number 2,21,0,21
2013-12-12,3,Bed Number 3,39,6,33
2013-12-13,1,Bed Number 1,65,55,10
2013-12-13,2,Bed Number 2,68,40,28
2013-12-13,3,Bed Number 3,49,44,5
2013-12-14,1,Bed Number 1,71,26,45
2013-12-14,2,Bed Number 2,29,24,5
2013-12-14,3,Bed Number 3,67,39,28
2013-12-15,1,Bed Number 1,97,43,54
2013-12-15,2,Bed Number 2,61,17,44
2013-12-15,3,Bed Number 3,14,11,3
2013-12-16,1,Bed Number 1,70,65,5
2013-12-16,2,Bed Number 2,19,14,5
2013-12-16,3,Bed Number 3,47,28,19
2013-12-17,1,Bed Number 1,15,6,9
2013-12-17,2,Bed Number 2,20,20,0
2013-12-17,3,Bed Number 3,90,52,38
2013-12-18,1,Bed Number 1,19,18,1
2013-12-18,2,Bed Number 2,64,32,32
2013-12-18,3,Bed Number 3,84,17,67
2013-12-19,1,Bed Number 1,44,33,11
2013-12-19,2,Bed Number 2,76,58,18
2013-12-19,3,Bed Number 3,54,46,8
2013-12-20,1,Bed Number 1,68,25,43
2013-12-20,2,Bed Number 2,44,44,0
2013-12-20,3,Bed Number 3,33,24,9
2013-12-21,1,Bed Number 1,100,9,91
2013-12-21,2,Bed Number 2,91,6,85
2013-12-21,3,Bed Number 3,61,55,6
2013-12-22,1,Bed Number 1,29,22,7
2013-12-22,2,Bed Number 2,74,34,40
2013-12-22,3,Bed Number 3,81,66,15
2013-12-23,1,Bed Number 1,32,21,11
2013-12-23,2,Bed Number 2,37,33,4
2013-12-23,3,Bed Number 3,98,88,10
2013-12-24,1,Bed Number 1,45,19,26
2013-12-24,2,Bed Number 2,63,17,46
2013-12-24,3,Bed Number 3,86,19,67
2013-12-25,1,Bed Number 1,53,13,40
2013-12-25,2,Bed Number 2,72,45,27
2013-12-25,3,Bed Number 3,57,43,14
2013-12-26,1,Bed Number 1,100,69,31
2013-12-26,2,Bed Number 2,46,36,10
2013-12-26,3,Bed Number 3,50,44,6
2013-12-27,1,Bed Number 1,11,8,3
2013-12-27,2,Bed Number 2,41,24,17
2013-12-27,3,Bed Number 3,38,22,16
2013-12-28,1,Bed Number 1,81,19,62
2013-12-28,2,Bed Number 2,53,35,18
2013-12-28,3,Bed Number 3,63,2,61
2013-12-29,1,Bed Number 1,100,91,9
2013-12-29,2,Bed Number 2,37,33,4
2013-12-29,3,Bed Number 3,79,24,55
2013-12-30,1,Bed Number 1,87,64,23
2013-12-30,2,Bed Number 2,45,19,26
2013-12-30,3,Bed Number 3,92,80,12
2013-12-31,1,Bed Number 1,11,7,4
2013-12-31,2,Bed Number 2,66,22,44
2013-12-31,3,Bed Number 3,63,60,3
2014-01-01,1,Bed Number 1,22,21,1
2014-01-01,2,Bed Number 2,96,30,66
2014-01-01,3,Bed Number 3,57,55,2
2014-01-02,1,Bed Number 1,69,55,14
2014-01-02,2,Bed Number 2,90,88,2
2014-01-02,3,Bed Number 3,99,99,0
2014-01-03,1,Bed Number 1,69,42,27
2014-01-03,2,Bed Number 2,91,73,18
2014-01-03,3,Bed Number 3,10,6,4
2014-01-04,1,Bed Number 1,65,11,54
2014-01-04,2,Bed Number 2,33,27,6
2014-01-04,3,Bed Number 3,72,9,63
2014-01-05,1,Bed Number 1,39,17,22
2014-01-05,2,Bed Number 2,100,72,28
2014-01-05,3,Bed Number 3,100,38,62
2014-01-06,1,Bed Number 1,70,31,39
2014-01-06,2,Bed Number 2,25,19,6
2014-01-06,3,Bed Number 3,63,56,7
2014-01-07,1,Bed Number 1,89,70,19
2014-01-07,2,Bed Number 2,36,16,20
2014-01-07,3,Bed Number 3,68,56,12
2014-01-08,1,Bed Number 1,97,12,85
2014-01-08,2,Bed Number 2,83,21,62
2014-01-08,3,Bed Number 3,89,74,15
2014-01-09,1,Bed Number 1,44,18,26
2014-01-09,2,Bed Number 2,33,18,15
2014-01-09,3,Bed Number 3,74,35,39
2014-01-10,1,Bed Number 1,41,37,4
2014-01-10,2,Bed Number 2,45,31,14
2014-01-10,3,Bed Number 3,55,5,50
2014-01-11,1,Bed Number 1,90,90,0
2014-01-11,2,Bed Number 2,24,15,9
2014-01-11,3,Bed Number 3,64,42,22
2014-01-12,1,Bed Number 1,48,46,2
2014-01-12,2,Bed Number 2,31,0,31
2014-01-12,3,Bed Number 3,91,88,3
2014-01-13,1,Bed Number 1,14,10,4
2014-01-13,2,Bed Number 2,16,0,16
2014-01-13,3,Bed Number 3,11,4,7
2014-01-14,1,Bed Number 1,48,17,31
2014-01-14,2,Bed Number 2,94,57,37
2014-01-14,3,Bed Number 3,20,5,15
2014-01-15,1,Bed Number 1,27,1,26
2014-01-15,2,Bed Number 2,34,11,23
2014-01-15,3,Bed Number 3,64,55,9
2014-01-16,1,Bed Number 1,76,66,10
2014-01-16,2,Bed Number 2,24,9,15
2014-01-16,3,Bed Number 3,76,0,76
2014-01-17,1,Bed Number 1,69,32,37
2014-01-17,2,Bed Number 2,19,16,3
2014-01-17,3,Bed Number 3,15,10,5
2014-01-18,1,Bed Number 1,14,1,13
2014-01-18,2,Bed Number 2,98,55,43
2014-01-18,3,Bed Number 3,39,5,34
2014-01-19,1,Bed Number 1,37,28,9
2014-01-19,2,Bed Number 2,40,39,1
2014-01-19,3,Bed Number 3,79,69,10
2014-01-20,1,Bed Number 1,55,42,13
2014-01-20,2,Bed Number 2,86,62,24
2014-01-20,3,Bed Number 3,44,25,19
2014-01-21,1,Bed Number 1,52,47,5
2014-01-21,2,Bed Number 2,46,12,34
2014-01-21,3,Bed Number 3,66,18,48
2014-01-22,1,Bed Number 1,91,51,40
2014-01-22,2,Bed Number 2,51,17,34
2014-01-22,3,Bed Number 3,98,61,37
2014-01-23,1,Bed Number 1,46,15,31
2014-01-23,2,Bed Number 2,27,26,1
2014-01-23,3,Bed Number 3,94,30,64
2014-01-24,1,Bed Number 1,15,11,4
2014-01-24,2,Bed Number 2,78,69,9
2014-01-24,3,Bed Number 3,44,21,23
2014-01-25,1,Bed Number 1,33,20,13
2014-01-25,2,Bed Number 2,56,15,41
2014-01-25,3,Bed Number 3,90,10,80
2014-01-26,1,Bed Number 1,64,58,6
2014-01-26,2,Bed Number 2,19,19,0
2014-01-26,3,Bed Number 3,15,14,1
2014-01-27,1,Bed Number 1,38,4,34
2014-01-27,2,Bed Number 2,39,33,6
2014-01-27,3,Bed Number 3,63,61,2
2014-01-28,1,Bed Number 1,40,15,25
2014-01-28,2,Bed Number 2,19,11,8
2014-01-28,3,Bed Number 3,99,65,34
2014-01-29,1,Bed Number 1,90,77,13
2014-01-29,2,Bed Number 2,21,5,16
2014-01-29,3,Bed Number 3,78,40,38
2014-01-30,1,Bed Number 1,38,20,18
2014-01-30,2,Bed Number 2,37,26,11
2014-01-30,3,Bed Number 3,35,21,14
2014-01-31,1,Bed Number 1,20,16,4
2014-01-31,2,Bed Number 2,49,32,17
2014-01-31,3,Bed Number 3,32,4,28
2014-02-01,1,Bed Number 1,38,27,11
2014-02-01,2,Bed Number 2,47,42,5
2014-02-01,3,Bed Number 3,46,11,35
2014-02-02,1,Bed Number 1,33,33,0
2014-02-02,2,Bed Number 2,91,87,4
2014-02-02,3,Bed Number 3,45,15,30
2014-02-03,1,Bed Number 1,44,19,25
2014-02-03,2,Bed Number 2,20,9,11
2014-02-03,3,Bed Number 3,100,26,74
2014-02-04,1,Bed Number 1,19,14,5
2014-02-04,2,Bed Number 2,99,88,11
2014-02-04,3,Bed Number 3,96,43,53
2014-02-05,1,Bed Number 1,41,5,36
2014-02-05,2,Bed Number 2,50,43,7
2014-02-05,3,Bed Number 3,75,44,31
2014-02-06,1,Bed Number 1,30,28,2
2014-02-06,2,Bed Number 2,14,9,5
2014-02-06,3,Bed Number 3,91,88,3
2014-02-07,1,Bed Number 1,69,52,17
2014-02-07,2,Bed Number 2,32,8,24
2014-02-07,3,Bed Number 3,85,44,41
2014-02-08,1,Bed Number 1,90,64,26
2014-02-08,2,Bed Number 2,13,4,9
2014-02-08,3,Bed Number 3,93,37,56
2014-02-09,1,Bed Number 1,66,40,26
2014-02-09,2,Bed Number 2,16,6,10
2014-02-09,3,Bed Number 3,61,25,36
2014-02-10,1,Bed Number 1,82,35,47
2014-02-10,2,Bed Number 2,76,17,59
2014-02-10,3,Bed Number 3,28,5,23
2014-02-11,1,Bed Number 1,92,47,45
2014-02-11,2,Bed Number 2,57,37,20
2014-02-11,3,Bed Number 3,61,14,47
2014-02-12,1,Bed Number 1,37,35,2
2014-02-12,2,Bed Number 2,29,7,22
2014-02-12,3,Bed Number 3,85,54,31
2014-02-13,1,Bed Number 1,79,18,61
2014-02-13,2,Bed Number 2,47,0,47
2014-02-13,3,Bed Number 3,84,30,54
2014-02-14,1,Bed Number 1,51,8,43
2014-02-14,2,Bed Number 2,46,27,19
2014-02-14,3,Bed Number 3,19,7,12
2014-02-15,1,Bed Number 1,76,23,53
2014-02-15,2,Bed Number 2,56,6,50
2014-02-15,3,Bed Number 3,38,36,2
2014-02-16,1,Bed Number 1,69,56,13
2014-02-16,2,Bed Number 2,92,62,30
2014-02-16,3,Bed Number 3,48,10,38
2014-02-17,1,Bed Number 1,70,19,51
2014-02-17,2,Bed Number 2,35,6,29
2014-02-17,3,Bed Number 3,19,16,3
2014-02-18,1,Bed Number 1,77,34,43
2014-02-18,2,Bed Number 2,69,67,2
2014-02-18,3,Bed Number 3,45,20,25
2014-02-19,1,Bed Number 1,63,62,1
2014-02-19,2,Bed Number 2,20,2,18
2014-02-19,3,Bed Number 3,95,48,47
2014-02-20,1,Bed Number 1,60,14,46
2014-02-20,2,Bed Number 2,42,27,15
2014-02-20,3,Bed Number 3,19,6,13
2014-02-21,1,Bed Number 1,83,17,66
2014-02-21,2,Bed Number 2,47,16,31
2014-02-21,3,Bed Number 3,43,36,7
2014-02-22,1,Bed Number 1,36,30,6
2014-02-22,2,Bed Number 2,77,45,32
2014-02-22,3,Bed Number 3,47,42,5
2014-02-23,1,Bed Number 1,11,5,6
2014-02-23,2,Bed Number 2,80,27,53
2014-02-23,3,Bed Number 3,53,38,15
2014-02-24,1,Bed Number 1,97,47,50
2014-02-24,2,Bed Number 2,94,25,69
2014-02-24,3,Bed Number 3,53,11,42
2014-02-25,1,Bed Number 1,18,1,17
2014-02-25,2,Bed Number 2,25,1,24
2014-02-25,3,Bed Number 3,97,41,56
2014-02-26,1,Bed Number 1,68,39,29
2014-02-26,2,Bed Number 2,76,14,62
2014-02-26,3,Bed Number 3,81,1,80
2014-02-27,1,Bed Number 1,98,38,60
2014-02-27,2,Bed Number 2,59,43,16
2014-02-27,3,Bed Number 3,78,64,14
2014-02-28,1,Bed Number 1,73,58,15
2014-02-28,2,Bed Number 2,98,33,65
2014-02-28,3,Bed Number 3,46,15,31
2014-03-01,1,Bed Number 1,43,16,27
2014-03-01,2,Bed Number 2,64,25,39
2014-03-01,3,Bed Number 3,75,30,45
2014-03-02,1,Bed Number 1,37,6,31
2014-03-02,2,Bed Number 2,26,0,26
2014-03-02,3,Bed Number 3,62,18,44
2014-03-03,1,Bed Number 1,43,26,17
2014-03-03,2,Bed Number 2,24,9,15
2014-03-03,3,Bed Number 3,97,48,49
2014-03-04,1,Bed Number 1,55,10,45
2014-03-04,2,Bed Number 2,98,73,25
2014-03-04,3,Bed Number 3,90,15,75
2014-03-05,1,Bed Number 1,66,11,55
2014-03-05,2,Bed Number 2,22,6,16
2014-03-05,3,Bed Number 3,11,3,8
2014-03-06,1,Bed Number 1,37,25,12
2014-03-06,2,Bed Number 2,69,19,50
2014-03-06,3,Bed Number 3,36,7,29
2014-03-07,1,Bed Number 1,71,18,53
2014-03-07,2,Bed Number 2,49,9,40
2014-03-07,3,Bed Number 3,20,11,9
2014-03-08,1,Bed Number 1,18,18,0
2014-03-08,2,Bed Number 2,67,22,45
2014-03-08,3,Bed Number 3,39,19,20
2014-03-09,1,Bed Number 1,49,33,16
2014-03-09,2,Bed Number 2,43,39,4
2014-03-09,3,Bed Number 3,65,39,26
2014-03-10,1,Bed Number 1,39,9,30
2014-03-10,2,Bed Number 2,99,79,20
2014-03-10,3,Bed Number 3,30,9,21
2014-03-11,1,Bed Number 1,43,24,19
2014-03-11,2,Bed Number 2,92,68,24
2014-03-11,3,Bed Number 3,50,47,3
2014-03-12,1,Bed Number 1,74,21,53
2014-03-12,2,Bed Number 2,78,66,12
2014-03-12,3,Bed Number 3,50,11,39
2014-03-13,1,Bed Number 1,82,22,60
2014-03-13,2,Bed Number 2,33,4,29
2014-03-13,3,Bed Number 3,50,46,4
2014-03-14,1,Bed Number 1,40,1,39
2014-03-14,2,Bed Number 2,51,6,45
2014-03-14,3,Bed Number 3,50,50,0
2014-03-15,1,Bed Number 1,50,2,48
2014-03-15,2,Bed Number 2,30,23,7
2014-03-15,3,Bed Number 3,71,38,33
2014-03-16,1,Bed Number 1,22,13,9
2014-03-16,2,Bed Number 2,35,15,20
2014-03-16,3,Bed Number 3,63,19,44
2014-03-17,1,Bed Number 1,37,26,11
2014-03-17,2,Bed Number 2,12,12,0
2014-03-17,3,Bed Number 3,70,44,26
2014-03-18,1,Bed Number 1,38,16,22
2014-03-18,2,Bed Number 2,59,34,25
2014-03-18,3,Bed Number 3,44,28,16
2014-03-19,1,Bed Number 1,62,32,30
2014-03-19,2,Bed Number 2,80,36,44
2014-03-19,3,Bed Number 3,66,24,42
2014-03-20,1,Bed Number 1,30,4,26
2014-03-20,2,Bed Number 2,68,17,51
2014-03-20,3,Bed Number 3,79,71,8
2014-03-21,1,Bed Number 1,69,2,67
2014-03-21,2,Bed Number 2,43,24,19
2014-03-21,3,Bed Number 3,68,62,6
2014-03-22,1,Bed Number 1,44,17,27
2014-03-22,2,Bed Number 2,28,8,20
2014-03-22,3,Bed Number 3,100,36,64
2014-03-23,1,Bed Number 1,22,17,5
2014-03-23,2,Bed Number 2,24,24,0
2014-03-23,3,Bed Number 3,30,10,20
2014-03-24,1,Bed Number 1,62,39,23
2014-03-24,2,Bed Number 2,68,8,60
2014-03-24,3,Bed Number 3,27,7,20
2014-03-25,1,Bed Number 1,69,25,44
2014-03-25,2,Bed Number 2,46,37,9
2014-03-25,3,Bed Number 3,66,6,60
2014-03-26,1,Bed Number 1,91,64,27
2014-03-26,2,Bed Number 2,61,6,55
2014-03-26,3,Bed Number 3,68,62,6
2014-03-27,1,Bed Number 1,28,4,24
2014-03-27,2,Bed Number 2,11,1,10
2014-03-27,3,Bed Number 3,49,44,5
2014-03-28,1,Bed Number 1,62,58,4
2014-03-28,2,Bed Number 2,20,16,4
2014-03-28,3,Bed Number 3,42,22,20
2014-03-29,1,Bed Number 1,28,3,25
2014-03-29,2,Bed Number 2,17,11,6
2014-03-29,3,Bed Number 3,42,13,29
2014-03-30,1,Bed Number 1,60,10,50
2014-03-30,2,Bed Number 2,22,7,15
2014-03-30,3,Bed Number 3,99,7,92
2014-03-31,1,Bed Number 1,18,5,13
2014-03-31,2,Bed Number 2,28,27,1
2014-03-31,3,Bed Number 3,44,5,39
2014-04-01,1,Bed Number 1,25,19,6
2014-04-01,2,Bed Number 2,74,67,7
2014-04-01,3,Bed Number 3,10,3,7
2014-04-02,1,Bed Number 1,14,0,14
2014-04-02,2,Bed Number 2,27,1,26
2014-04-02,3,Bed Number 3,87,59,28
2014-04-03,1,Bed Number 1,94,44,50
2014-04-03,2,Bed Number 2,34,31,3
2014-04-03,3,Bed Number 3,65,21,44
2014-04-04,1,Bed Number 1,13,6,7
2014-04-04,2,Bed Number 2,88,29,59
2014-04-04,3,Bed Number 3,35,0,35
2014-04-05,1,Bed Number 1,83,4,79
2014-04-05,2,Bed Number 2,33,13,20
2014-04-05,3,Bed Number 3,23,22,1
2014-04-06,1,Bed Number 1,96,30,66
2014-04-06,2,Bed Number 2,70,17,53
2014-04-06,3,Bed Number 3,57,54,3
2014-04-07,1,Bed Number 1,54,22,32
2014-04-07,2,Bed Number 2,56,7,49
2014-04-07,3,Bed Number 3,21,2,19
2014-04-08,1,Bed Number 1,74,44,30
2014-04-08,2,Bed Number 2,75,52,23
2014-04-08,3,Bed Number 3,58,0,58
2014-04-09,1,Bed Number 1,59,46,13
2014-04-09,2,Bed Number 2,73,25,48
2014-04-09,3,Bed Number 3,82,13,69
2014-04-10,1,Bed Number 1,11,8,3
2014-04-10,2,Bed Number 2,65,4,61
2014-04-10,3,Bed Number 3,77,24,53
2014-04-11,1,Bed Number 1,22,0,22
2014-04-11,2,Bed Number 2,35,34,1
2014-04-11,3,Bed Number 3,100,35,65
2014-04-12,1,Bed Number 1,33,12,21
2014-04-12,2,Bed Number 2,79,71,8
2014-04-12,3,Bed Number 3,96,7,89
2014-04-13,1,Bed Number 1,29,27,2
2014-04-13,2,Bed Number 2,35,29,6
2014-04-13,3,Bed Number 3,21,2,19
2014-04-14,1,Bed Number 1,71,53,18
2014-04-14,2,Bed Number 2,66,64,2
2014-04-14,3,Bed Number 3,65,9,56
2014-04-15,1,Bed Number 1,35,30,5
2014-04-15,2,Bed Number 2,36,7,29
2014-04-15,3,Bed Number 3,64,54,10
2014-04-16,1,Bed Number 1,10,4,6
2014-04-16,2,Bed Number 2,21,9,12
2014-04-16,3,Bed Number 3,80,9,71
2014-04-17,1,Bed Number 1,58,36,22
2014-04-17,2,Bed Number 2,56,53,3
2014-04-17,3,Bed Number 3,44,1,43
2014-04-18,1,Bed Number 1,20,8,12
2014-04-18,2,Bed Number 2,88,59,29
2014-04-18,3,Bed Number 3,40,10,30
2014-04-19,1,Bed Number 1,98,23,75
2014-04-19,2,Bed Number 2,26,10,16
2014-04-19,3,Bed Number 3,55,50,5
2014-04-20,1,Bed Number 1,80,21,59
2014-04-20,2,Bed Number 2,80,9,71
2014-04-20,3,Bed Number 3,51,23,28
2014-04-21,1,Bed Number 1,51,24,27
2014-04-21,2,Bed Number 2,67,35,32
2014-04-21,3,Bed Number 3,65,43,22
2014-04-22,1,Bed Number 1,45,18,27
2014-04-22,2,Bed Number 2,77,28,49
2014-04-22,3,Bed Number 3,48,3,45
2014-04-23,1,Bed Number 1,71,16,55
2014-04-23,2,Bed Number 2,75,35,40
2014-04-23,3,Bed Number 3,81,43,38
2014-04-24,1,Bed Number 1,29,6,23
2014-04-24,2,Bed Number 2,20,8,12
2014-04-24,3,Bed Number 3,81,78,3
2014-04-25,1,Bed Number 1,77,71,6
2014-04-25,2,Bed Number 2,66,26,40
2014-04-25,3,Bed Number 3,26,23,3
2014-04-26,1,Bed Number 1,49,25,24
2014-04-26,2,Bed Number 2,47,0,47
2014-04-26,3,Bed Number 3,33,20,13
2014-04-27,1,Bed Number 1,31,22,9
2014-04-27,2,Bed Number 2,44,26,18
2014-04-27,3,Bed Number 3,70,14,56
2014-04-28,1,Bed Number 1,96,89,7
2014-04-28,2,Bed Number 2,21,1,20
2014-04-28,3,Bed Number 3,85,49,36
2014-04-29,1,Bed Number 1,51,47,4
2014-04-29,2,Bed Number 2,59,23,36
2014-04-29,3,Bed Number 3,92,30,62
2014-04-30,1,Bed Number 1,63,2,61
2014-04-30,2,Bed Number 2,73,42,31
2014-04-30,3,Bed Number 3,53,33,20
2014-05-01,1,Bed Number 1,13,4,9
2014-05-01,2,Bed Number 2,14,2,12
2014-05-01,3,Bed Number 3,39,17,22
2014-05-02,1,Bed Number 1,52,12,40
2014-05-02,2,Bed Number 2,15,1,14
2014-05-02,3,Bed Number 3,18,6,12
2014-05-03,1,Bed Number 1,64,32,32
2014-05-03,2,Bed Number 2,24,22,2
2014-05-03,3,Bed Number 3,14,14,0
2014-05-04,1,Bed Number 1,89,40,49
2014-05-04,2,Bed Number 2,66,31,35
2014-05-04,3,Bed Number 3,49,24,25
2014-05-05,1,Bed Number 1,59,55,4
2014-05-05,2,Bed Number 2,70,17,53
2014-05-05,3,Bed Number 3,34,4,30
2014-05-06,1,Bed Number 1,36,31,5
2014-05-06,2,Bed Number 2,49,34,15
2014-05-06,3,Bed Number 3,49,27,22
2014-05-07,1,Bed Number 1,54,44,10
2014-05-07,2,Bed Number 2,15,6,9
2014-05-07,3,Bed Number 3,44,29,15
2014-05-08,1,Bed Number 1,21,10,11
2014-05-08,2,Bed Number 2,37,26,11
2014-05-08,3,Bed Number 3,88,42,46
2014-05-09,1,Bed Number 1,54,22,32
2014-05-09,2,Bed Number 2,59,0,59
2014-05-09,3,Bed Number 3,80,11,69
2014-05-10,1,Bed Number 1,89,61,28
2014-05-10,2,Bed Number 2,97,85,12
2014-05-10,3,Bed Number 3,26,13,13
2014-05-11,1,Bed Number 1,13,0,13
2014-05-11,2,Bed Number 2,21,16,5
2014-05-11,3,Bed Number 3,51,4,47
2014-05-12,1,Bed Number 1,54,26,28
2014-05-12,2,Bed Number 2,42,16,26
2014-05-12,3,Bed Number 3,13,5,8
2014-05-13,1,Bed Number 1,30,18,12
2014-05-13,2,Bed Number 2,16,12,4
2014-05-13,3,Bed Number 3,70,4,66
2014-05-14,1,Bed Number 1,60,33,27
2014-05-14,2,Bed Number 2,31,6,25
2014-05-14,3,Bed Number 3,76,57,19
2014-05-15,1,Bed Number 1,15,4,11
2014-05-15,2,Bed Number 2,35,29,6
2014-05-15,3,Bed Number 3,81,63,18
2014-05-16,1,Bed Number 1,87,49,38
2014-05-16,2,Bed Number 2,38,35,3
2014-05-16,3,Bed Number 3,29,11,18
2014-05-17,1,Bed Number 1,41,41,0
2014-05-17,2,Bed Number 2,63,46,17
2014-05-17,3,Bed Number 3,40,38,2
2014-05-18,1,Bed Number 1,22,17,5
2014-05-18,2,Bed Number 2,77,47,30
2014-05-18,3,Bed Number 3,18,1,17
2014-05-19,1,Bed Number 1,58,43,15
2014-05-19,2,Bed Number 2,57,38,19
2014-05-19,3,Bed Number 3,19,0,19
2014-05-20,1,Bed Number 1,69,26,43
2014-05-20,2,Bed Number 2,70,57,13
2014-05-20,3,Bed Number 3,23,0,23
2014-05-21,1,Bed Number 1,46,24,22
2014-05-21,2,Bed Number 2,18,17,1
2014-05-21,3,Bed Number 3,72,22,50
2014-05-22,1,Bed Number 1,58,33,25
2014-05-22,2,Bed Number 2,71,24,47
2014-05-22,3,Bed Number 3,95,79,16
2014-05-23,1,Bed Number 1,78,12,66
2014-05-23,2,Bed Number 2,75,46,29
2014-05-23,3,Bed Number 3,27,23,4
2014-05-24,1,Bed Number 1,61,9,52
2014-05-24,2,Bed Number 2,33,20,13
2014-05-24,3,Bed Number 3,30,9,21
2014-05-25,1,Bed Number 1,52,25,27
2014-05-25,2,Bed Number 2,41,3,38
2014-05-25,3,Bed Number 3,17,12,5
2014-05-26,1,Bed Number 1,37,9,28
2014-05-26,2,Bed Number 2,98,51,47
2014-05-26,3,Bed Number 3,78,11,67
2014-05-27,1,Bed Number 1,52,9,43
2014-05-27,2,Bed Number 2,94,43,51
2014-05-27,3,Bed Number 3,72,36,36
2014-05-28,1,Bed Number 1,22,3,19
2014-05-28,2,Bed Number 2,33,15,18
2014-05-28,3,Bed Number 3,72,32,40
2014-05-29,1,Bed Number 1,14,5,9
2014-05-29,2,Bed Number 2,10,1,9
2014-05-29,3,Bed Number 3,57,37,20
2014-05-30,1,Bed Number 1,15,0,15
2014-05-30,2,Bed Number 2,93,4,89
2014-05-30,3,Bed Number 3,86,5,81
2014-05-31,1,Bed Number 1,49,19,30
2014-05-31,2,Bed Number 2,76,3,73
2014-05-31,3,Bed Number 3,27,23,4
2014-06-01,1,Bed Number 1,46,8,38
2014-06-01,2,Bed Number 2,88,25,63
2014-06-01,3,Bed Number 3,32,18,14
2014-06-02,1,Bed Number 1,10,8,2
2014-06-02,2,Bed Number 2,60,32,28
2014-06-02,3,Bed Number 3,71,33,38
2014-06-03,1,Bed Number 1,94,75,19
2014-06-03,2,Bed Number 2,71,28,43
2014-06-03,3,Bed Number 3,87,14,73
2014-06-04,1,Bed Number 1,49,35,14
2014-06-04,2,Bed Number 2,62,11,51
2014-06-04,3,Bed Number 3,85,66,19
2014-06-05,1,Bed Number 1,15,5,10
2014-06-05,2,Bed Number 2,40,36,4
2014-06-05,3,Bed Number 3,36,7,29
2014-06-06,1,Bed Number 1,69,3,66
2014-06-06,2,Bed Number 2,70,14,56
2014-06-06,3,Bed Number 3,95,91,4
2014-06-07,1,Bed Number 1,59,28,31
2014-06-07,2,Bed Number 2,68,65,3
2014-06-07,3,Bed Number 3,92,47,45
2014-06-08,1,Bed Number 1,88,32,56
2014-06-08,2,Bed Number 2,55,50,5
2014-06-08,3,Bed Number 3,26,11,15
2014-06-09,1,Bed Number 1,16,9,7
2014-06-09,2,Bed Number 2,56,51,5
2014-06-09,3,Bed Number 3,65,26,39
2014-06-10,1,Bed Number 1,85,72,13
2014-06-10,2,Bed Number 2,47,17,30
2014-06-10,3,Bed Number 3,64,22,42
2014-06-11,1,Bed Number 1,62,6,56
2014-06-11,2,Bed Number 2,61,52,9
2014-06-11,3,Bed Number 3,50,30,20
2014-06-12,1,Bed Number 1,79,31,48
2014-06-12,2,Bed Number 2,49,16,33
2014-06-12,3,Bed Number 3,34,7,27
2014-06-13,1,Bed Number 1,84,3,81
2014-06-13,2,Bed Number 2,80,10,70
2014-06-13,3,Bed Number 3,15,14,1
2014-06-14,1,Bed Number 1,59,20,39
2014-06-14,2,Bed Number 2,10,6,4
2014-06-14,3,Bed Number 3,28,0,28
2014-06-15,1,Bed Number 1,100,49,51
2014-06-15,2,Bed Number 2,58,57,1
2014-06-15,3,Bed Number 3,97,9,88
2014-06-16,1,Bed Number 1,69,1,68
2014-06-16,2,Bed Number 2,71,56,15
2014-06-16,3,Bed Number 3,84,66,18
2014-06-17,1,Bed Number 1,19,9,10
2014-06-17,2,Bed Number 2,42,41,1
2014-06-17,3,Bed Number 3,78,1,77
2014-06-18,1,Bed Number 1,81,56,25
2014-06-18,2,Bed Number 2,35,32,3
2014-06-18,3,Bed Number 3,59,33,26
2014-06-19,1,Bed Number 1,97,41,56
2014-06-19,2,Bed Number 2,53,2,51
2014-06-19,3,Bed Number 3,56,10,46
2014-06-20,1,Bed Number 1,84,57,27
2014-06-20,2,Bed Number 2,27,22,5
2014-06-20,3,Bed Number 3,71,28,43
2014-06-21,1,Bed Number 1,34,4,30
2014-06-21,2,Bed Number 2,98,95,3
2014-06-21,3,Bed Number 3,40,18,22
2014-06-22,1,Bed Number 1,26,25,1
2014-06-22,2,Bed Number 2,94,45,49
2014-06-22,3,Bed Number 3,89,18,71
2014-06-23,1,Bed Number 1,32,5,27
2014-06-23,2,Bed Number 2,30,30,0
2014-06-23,3,Bed Number 3,78,55,23
2014-06-24,1,Bed Number 1,32,24,8
2014-06-24,2,Bed Number 2,25,6,19
2014-06-24,3,Bed Number 3,47,10,37
2014-06-25,1,Bed Number 1,69,49,20
2014-06-25,2,Bed Number 2,58,22,36
2014-06-25,3,Bed Number 3,26,16,10
2014-06-26,1,Bed Number 1,41,11,30
2014-06-26,2,Bed Number 2,99,44,55
2014-06-26,3,Bed Number 3,61,54,7
2014-06-27,1,Bed Number 1,21,14,7
2014-06-27,2,Bed Number 2,98,95,3
2014-06-27,3,Bed Number 3,37,5,32
2014-06-28,1,Bed Number 1,57,45,12
2014-06-28,2,Bed Number 2,14,7,7
2014-06-28,3,Bed Number 3,47,37,10
2014-06-29,1,Bed Number 1,74,54,20
2014-06-29,2,Bed Number 2,27,23,4
2014-06-29,3,Bed Number 3,97,36,61
2014-06-30,1,Bed Number 1,54,28,26
2014-06-30,2,Bed Number 2,93,16,77
2014-06-30,3,Bed Number 3,94,5,89
2014-07-01,1,Bed Number 1,51,10,41
2014-07-01,2,Bed Number 2,26,23,3
2014-07-01,3,Bed Number 3,47,32,15
2014-07-02,1,Bed Number 1,58,49,9
2014-07-02,2,Bed Number 2,51,3,48
2014-07-02,3,Bed Number 3,27,8,19
2014-07-03,1,Bed Number 1,96,3,93
2014-07-03,2,Bed Number 2,16,14,2
2014-07-03,3,Bed Number 3,75,69,6
2014-07-04,1,Bed Number 1,18,15,3
2014-07-04,2,Bed Number 2,61,9,52
2014-07-04,3,Bed Number 3,58,56,2
2014-07-05,1,Bed Number 1,41,4,37
2014-07-05,2,Bed Number 2,77,74,3
2014-07-05,3,Bed Number 3,77,67,10
2014-07-06,1,Bed Number 1,88,72,16
2014-07-06,2,Bed Number 2,23,10,13
2014-07-06,3,Bed Number 3,51,47,4
2014-07-07,1,Bed Number 1,51,4,47
2014-07-07,2,Bed Number 2,22,10,12
2014-07-07,3,Bed Number 3,100,42,58
2014-07-08,1,Bed Number 1,94,28,66
2014-07-08,2,Bed Number 2,61,6,55
2014-07-08,3,Bed Number 3,12,2,10
2014-07-09,1,Bed Number 1,21,13,8
2014-07-09,2,Bed Number 2,41,40,1
2014-07-09,3,Bed Number 3,90,1,89
2014-07-10,1,Bed Number 1,95,55,40
2014-07-10,2,Bed Number 2,30,1,29
2014-07-10,3,Bed Number 3,93,54,39
2014-07-11,1,Bed Number 1,36,35,1
2014-07-11,2,Bed Number 2,16,9,7
2014-07-11,3,Bed Number 3,42,27,15
2014-07-12,1,Bed Number 1,51,49,2
2014-07-12,2,Bed Number 2,32,30,2
2014-07-12,3,Bed Number 3,70,19,51
2014-07-13,1,Bed Number 1,62,60,2
2014-07-13,2,Bed Number 2,92,74,18
2014-07-13,3,Bed Number 3,26,5,21
2014-07-14,1,Bed Number 1,45,4,41
2014-07-14,2,Bed Number 2,50,24,26
2014-07-14,3,Bed Number 3,75,35,40
2014-07-15,1,Bed Number 1,37,24,13
2014-07-15,2,Bed Number 2,89,53,36
2014-07-15,3,Bed Number 3,48,5,43
2014-07-16,1,Bed Number 1,81,30,51
2014-07-16,2,Bed Number 2,23,10,13
2014-07-16,3,Bed Number 3,97,56,41
2014-07-17,1,Bed Number 1,31,14,17
2014-07-17,2,Bed Number 2,88,60,28
2014-07-17,3,Bed Number 3,96,25,71
2014-07-18,1,Bed Number 1,97,7,90
2014-07-18,2,Bed Number 2,17,7,10
2014-07-18,3,Bed Number 3,98,81,17
2014-07-19,1,Bed Number 1,99,3,96
2014-07-19,2,Bed Number 2,83,52,31
2014-07-19,3,Bed Number 3,81,79,2
2014-07-20,1,Bed Number 1,16,16,0
2014-07-20,2,Bed Number 2,41,4,37
2014-07-20,3,Bed Number 3,98,4,94
2014-07-21,1,Bed Number 1,79,60,19
2014-07-21,2,Bed Number 2,68,45,23
2014-07-21,3,Bed Number 3,58,35,23
2014-07-22,1,Bed Number 1,28,26,2
2014-07-22,2,Bed Number 2,34,16,18
2014-07-22,3,Bed Number 3,18,10,8
2014-07-23,1,Bed Number 1,76,40,36
2014-07-23,2,Bed Number 2,41,10,31
2014-07-23,3,Bed Number 3,83,45,38
2014-07-24,1,Bed Number 1,62,8,54
2014-07-24,2,Bed Number 2,90,21,69
2014-07-24,3,Bed Number 3,83,46,37
2014-07-25,1,Bed Number 1,49,6,43
2014-07-25,2,Bed Number 2,98,4,94
2014-07-25,3,Bed Number 3,18,18,0
2014-07-26,1,Bed Number 1,91,24,67
2014-07-26,2,Bed Number 2,99,55,44
2014-07-26,3,Bed Number 3,41,14,27
2014-07-27,1,Bed Number 1,61,17,44
2014-07-27,2,Bed Number 2,20,5,15
2014-07-27,3,Bed Number 3,37,26,11
2014-07-28,1,Bed Number 1,52,22,30
2014-07-28,2,Bed Number 2,78,24,54
2014-07-28,3,Bed Number 3,87,66,21
2014-07-29,1,Bed Number 1,93,49,44
2014-07-29,2,Bed Number 2,80,62,18
2014-07-29,3,Bed Number 3,97,96,1
2014-07-30,1,Bed Number 1,49,6,43
2014-07-30,2,Bed Number 2,39,34,5
2014-07-30,3,Bed Number 3,44,4,40
2014-07-31,1,Bed Number 1,11,11,0
2014-07-31,2,Bed Number 2,57,23,34
2014-07-31,3,Bed Number 3,59,12,47
2014-08-01,1,Bed Number 1,94,76,18
2014-08-01,2,Bed Number 2,36,27,9
2014-08-01,3,Bed Number 3,19,7,12
2014-08-02,1,Bed Number 1,52,11,41
2014-08-02,2,Bed Number 2,65,64,1
2014-08-02,3,Bed Number 3,51,2,49
2014-08-03,1,Bed Number 1,92,74,18
2014-08-03,2,Bed Number 2,20,2,18
2014-08-03,3,Bed Number 3,21,0,21
2014-08-04,1,Bed Number 1,58,21,37
2014-08-04,2,Bed Number 2,81,13,68
2014-08-04,3,Bed Number 3,91,39,52
2014-08-05,1,Bed Number 1,94,25,69
2014-08-05,2,Bed Number 2,37,24,13
2014-08-05,3,Bed Number 3,65,40,25
2014-08-06,1,Bed Number 1,74,54,20
2014-08-06,2,Bed Number 2,36,8,28
2014-08-06,3,Bed Number 3,93,45,48
2014-08-07,1,Bed Number 1,98,33,65
2014-08-07,2,Bed Number 2,92,23,69
2014-08-07,3,Bed Number 3,23,5,18
2014-08-08,1,Bed Number 1,66,29,37
2014-08-08,2,Bed Number 2,80,19,61
2014-08-08,3,Bed Number 3,44,20,24
2014-08-09,1,Bed Number 1,80,4,76
2014-08-09,2,Bed Number 2,61,6,55
2014-08-09,3,Bed Number 3,95,64,31
2014-08-10,1,Bed Number 1,55,50,5
2014-08-10,2,Bed Number 2,61,59,2
2014-08-10,3,Bed Number 3,38,36,2
2014-08-11,1,Bed Number 1,87,74,13
2014-08-11,2,Bed Number 2,87,62,25
2014-08-11,3,Bed Number 3,31,27,4
2014-08-12,1,Bed Number 1,76,11,65
2014-08-12,2,Bed Number 2,11,1,10
2014-08-12,3,Bed Number 3,24,17,7
2014-08-13,1,Bed Number 1,42,41,1
2014-08-13,2,Bed Number 2,77,69,8
2014-08-13,3,Bed Number 3,80,40,40
2014-08-14,1,Bed Number 1,50,25,25
2014-08-14,2,Bed Number 2,95,70,25
2014-08-14,3,Bed Number 3,81,28,53
2014-08-15,1,Bed Number 1,98,87,11
2014-08-15,2,Bed Number 2,53,26,27
2014-08-15,3,Bed Number 3,98,72,26
2014-08-16,1,Bed Number 1,43,1,42
2014-08-16,2,Bed Number 2,33,17,16
2014-08-16,3,Bed Number 3,40,9,31
2014-08-17,1,Bed Number 1,10,1,9
2014-08-17,2,Bed Number 2,55,45,10
2014-08-17,3,Bed Number 3,40,4,36
2014-08-18,1,Bed Number 1,89,7,82
2014-08-18,2,Bed Number 2,45,18,27
2014-08-18,3,Bed Number 3,67,23,44
2014-08-19,1,Bed Number 1,66,43,23
2014-08-19,2,Bed Number 2,90,45,45
2014-08-19,3,Bed Number 3,75,34,41
2014-08-20,1,Bed Number 1,96,65,31
2014-08-20,2,Bed Number 2,31,3,28
2014-08-20,3,Bed Number 3,76,16,60
2014-08-21,1,Bed Number 1,42,27,15
2014-08-21,2,Bed Number 2,89,62,27
2014-08-21,3,Bed Number 3,85,70,15
2014-08-22,1,Bed Number 1,74,4,70
2014-08-22,2,Bed Number 2,43,2,41
2014-08-22,3,Bed Number 3,81,65,16
2014-08-23,1,Bed Number 1,13,5,8
2014-08-23,2,Bed Number 2,37,0,37
2014-08-23,3,Bed Number 3,59,41,18
2014-08-24,1,Bed Number 1,74,50,24
2014-08-24,2,Bed Number 2,35,7,28
2014-08-24,3,Bed Number 3,30,20,10
2014-08-25,1,Bed Number 1,21,3,18
2014-08-25,2,Bed Number 2,53,32,21
2014-08-25,3,Bed Number 3,22,13,9
2014-08-26,1,Bed Number 1,91,55,36
2014-08-26,2,Bed Number 2,21,7,14
2014-08-26,3,Bed Number 3,91,51,40
2014-08-27,1,Bed Number 1,44,11,33
2014-08-27,2,Bed Number 2,71,2,69
2014-08-27,3,Bed Number 3,32,26,6
2014-08-28,1,Bed Number 1,52,25,27
2014-08-28,2,Bed Number 2,97,72,25
2014-08-28,3,Bed Number 3,59,48,11
2014-08-29,1,Bed Number 1,23,14,9
2014-08-29,2,Bed Number 2,23,16,7
2014-08-29,3,Bed Number 3,98,84,14
2014-08-30,1,Bed Number 1,75,25,50
2014-08-30,2,Bed Number 2,91,46,45
2014-08-30,3,Bed Number 3,72,44,28
2014-08-31,1,Bed Number 1,88,77,11
2014-08-31,2,Bed Number 2,92,2,90
2014-08-31,3,Bed Number 3,51,4,47
2014-09-01,1,Bed Number 1,50,0,50
2014-09-01,2,Bed Number 2,98,37,61
2014-09-01,3,Bed Number 3,57,17,40
2014-09-02,1,Bed Number 1,11,1,10
2014-09-02,2,Bed Number 2,30,10,20
2014-09-02,3,Bed Number 3,100,4,96
2014-09-03,1,Bed Number 1,81,56,25
2014-09-03,2,Bed Number 2,27,20,7
2014-09-03,3,Bed Number 3,26,25,1
2014-09-04,1,Bed Number 1,48,39,9
2014-09-04,2,Bed Number 2,61,11,50
2014-09-04,3,Bed Number 3,44,42,2
2014-09-05,1,Bed Number 1,70,46,24
2014-09-05,2,Bed Number 2,96,92,4
2014-09-05,3,Bed Number 3,75,73,2
2014-09-06,1,Bed Number 1,50,39,11
2014-09-06,2,Bed Number 2,60,58,2
2014-09-06,3,Bed Number 3,45,29,16
2014-09-07,1,Bed Number 1,89,65,24
2014-09-07,2,Bed Number 2,50,30,20
2014-09-07,3,Bed Number 3,83,9,74
2014-09-08,1,Bed Number 1,62,17,45
2014-09-08,2,Bed Number 2,13,12,1
2014-09-08,3,Bed Number 3,100,6,94
2014-09-09,1,Bed Number 1,19,3,16
2014-09-09,2,Bed Number 2,65,11,54
2014-09-09,3,Bed Number 3,94,88,6
2014-09-10,1,Bed Number 1,94,10,84
2014-09-10,2,Bed Number 2,52,44,8
2014-09-10,3,Bed Number 3,76,50,26
2014-09-11,1,Bed Number 1,97,65,32
2014-09-11,2,Bed Number 2,50,18,32
2014-09-11,3,Bed Number 3,52,9,43
2014-09-12,1,Bed Number 1,10,2,8
2014-09-12,2,Bed Number 2,82,37,45
2014-09-12,3,Bed Number 3,33,30,3
2014-09-13,1,Bed Number 1,12,5,7
2014-09-13,2,Bed Number 2,29,6,23
2014-09-13,3,Bed Number 3,67,57,10
2014-09-14,1,Bed Number 1,79,17,62
2014-09-14,2,Bed Number 2,30,27,3
2014-09-14,3,Bed Number 3,49,46,3
2014-09-15,1,Bed Number 1,91,5,86
2014-09-15,2,Bed Number 2,77,43,34
2014-09-15,3,Bed Number 3,94,78,16
2014-09-16,1,Bed Number 1,69,36,33
2014-09-16,2,Bed Number 2,38,0,38
2014-09-16,3,Bed Number 3,46,30,16
2014-09-17,1,Bed Number 1,72,27,45
2014-09-17,2,Bed Number 2,40,29,11
2014-09-17,3,Bed Number 3,81,9,72
2014-09-18,1,Bed Number 1,30,10,20
2014-09-18,2,Bed Number 2,65,12,53
2014-09-18,3,Bed Number 3,45,35,10
2014-09-19,1,Bed Number 1,82,52,30
2014-09-19,2,Bed Number 2,32,12,20
2014-09-19,3,Bed Number 3,34,17,17
2014-09-20,1,Bed Number 1,35,0,35
2014-09-20,2,Bed Number 2,15,1,14
2014-09-20,3,Bed Number 3,46,35,11
2014-09-21,1,Bed Number 1,74,70,4
2014-09-21,2,Bed Number 2,43,19,24
2014-09-21,3,Bed Number 3,24,5,19
2014-09-22,1,Bed Number 1,51,13,38
2014-09-22,2,Bed Number 2,21,5,16
2014-09-22,3,Bed Number 3,99,19,80
2014-09-23,1,Bed Number 1,70,41,29
2014-09-23,2,Bed Number 2,49,20,29
2014-09-23,3,Bed Number 3,24,21,3
2014-09-24,1,Bed Number 1,13,13,0
2014-09-24,2,Bed Number 2,67,6,61
2014-09-24,3,Bed Number 3,28,16,12
2014-09-25,1,Bed Number 1,91,27,64
2014-09-25,2,Bed Number 2,52,30,22
2014-09-25,3,Bed Number 3,73,11,62
2014-09-26,1,Bed Number 1,28,18,10
2014-09-26,2,Bed Number 2,57,3,54
2014-09-26,3,Bed Number 3,21,11,10
2014-09-27,1,Bed Number 1,85,73,12
2014-09-27,2,Bed Number 2,56,21,35
2014-09-27,3,Bed Number 3,15,9,6
2014-09-28,1,Bed Number 1,48,5,43
2014-09-28,2,Bed Number 2,33,1,32
2014-09-28,3,Bed Number 3,39,37,2
2014-09-29,1,Bed Number 1,94,69,25
2014-09-29,2,Bed Number 2,97,97,0
2014-09-29,3,Bed Number 3,91,57,34
2014-09-30,1,Bed Number 1,12,5,7
2014-09-30,2,Bed Number 2,83,51,32
2014-09-30,3,Bed Number 3,69,31,38
2014-10-01,1,Bed Number 1,58,14,44
2014-10-01,2,Bed Number 2,95,91,4
2014-10-01,3,Bed Number 3,58,24,34
2014-10-02,1,Bed Number 1,49,44,5
2014-10-02,2,Bed Number 2,96,71,25
2014-10-02,3,Bed Number 3,34,6,28
2014-10-03,1,Bed Number 1,22,10,12
2014-10-03,2,Bed Number 2,19,16,3
2014-10-03,3,Bed Number 3,39,17,22
2014-10-04,1,Bed Number 1,17,11,6
2014-10-04,2,Bed Number 2,54,3,51
2014-10-04,3,Bed Number 3,64,31,33
2014-10-05,1,Bed Number 1,82,50,32
2014-10-05,2,Bed Number 2,55,0,55
2014-10-05,3,Bed Number 3,97,56,41
2014-10-06,1,Bed Number 1,77,59,18
2014-10-06,2,Bed Number 2,42,40,2
2014-10-06,3,Bed Number 3,25,5,20
2014-10-07,1,Bed Number 1,18,16,2
2014-10-07,2,Bed Number 2,75,38,37
2014-10-07,3,Bed Number 3,39,5,34
2014-10-08,1,Bed Number 1,66,58,8
2014-10-08,2,Bed Number 2,66,18,48
2014-10-08,3,Bed Number 3,80,15,65
2014-10-09,1,Bed Number 1,99,88,11
2014-10-09,2,Bed Number 2,83,57,26
2014-10-09,3,Bed Number 3,81,9,72
2014-10-10,1,Bed Number 1,12,4,8
2014-10-10,2,Bed Number 2,87,35,52
2014-10-10,3,Bed Number 3,52,14,38
2014-10-11,1,Bed Number 1,97,48,49
2014-10-11,2,Bed Number 2,18,6,12
2014-10-11,3,Bed Number 3,60,11,49
2014-10-12,1,Bed Number 1,42,3,39
2014-10-12,2,Bed Number 2,96,17,79
2014-10-12,3,Bed Number 3,75,7,68
2014-10-13,1,Bed Number 1,26,7,19
2014-10-13,2,Bed Number 2,73,57,16
2014-10-13,3,Bed Number 3,32,2,30
2014-10-14,1,Bed Number 1,80,1,79
2014-10-14,2,Bed Number 2,84,79,5
2014-10-14,3,Bed Number 3,46,37,9
2014-10-15,1,Bed Number 1,15,6,9
2014-10-15,2,Bed Number 2,12,7,5
2014-10-15,3,Bed Number 3,68,48,20
2014-10-16,1,Bed Number 1,12,7,5
2014-10-16,2,Bed Number 2,77,41,36
2014-10-16,3,Bed Number 3,26,3,23
2014-10-17,1,Bed Number 1,40,10,30
2014-10-17,2,Bed Number 2,95,69,26
2014-10-17,3,Bed Number 3,55,54,1
2014-10-18,1,Bed Number 1,77,12,65
2014-10-18,2,Bed Number 2,27,5,22
2014-10-18,3,Bed Number 3,36,1,35
2014-10-19,1,Bed Number 1,87,42,45
2014-10-19,2,Bed Number 2,55,22,33
2014-10-19,3,Bed Number 3,26,18,8
2014-10-20,1,Bed Number 1,61,20,41
2014-10-20,2,Bed Number 2,51,37,14
2014-10-20,3,Bed Number 3,96,41,55
2014-10-21,1,Bed Number 1,51,44,7
2014-10-21,2,Bed Number 2,92,62,30
2014-10-21,3,Bed Number 3,85,25,60
2014-10-22,1,Bed Number 1,75,1,74
2014-10-22,2,Bed Number 2,53,8,45
2014-10-22,3,Bed Number 3,29,5,24
2014-10-23,1,Bed Number 1,74,21,53
2014-10-23,2,Bed Number 2,18,18,0
2014-10-23,3,Bed Number 3,69,61,8
2014-10-24,1,Bed Number 1,24,22,2
2014-10-24,2,Bed Number 2,81,0,81
2014-10-24,3,Bed Number 3,11,8,3
2014-10-25,1,Bed Number 1,91,1,90
2014-10-25,2,Bed Number 2,91,82,9
2014-10-25,3,Bed Number 3,23,14,9
2014-10-26,1,Bed Number 1,88,14,74
2014-10-26,2,Bed Number 2,74,33,41
2014-10-26,3,Bed Number 3,76,6,70
2014-10-27,1,Bed Number 1,70,52,18
2014-10-27,2,Bed Number 2,90,14,76
2014-10-27,3,Bed Number 3,18,3,15
2014-10-28,1,Bed Number 1,55,36,19
2014-10-28,2,Bed Number 2,32,24,8
2014-10-28,3,Bed Number 3,62,55,7
2014-10-29,1,Bed Number 1,52,38,14
2014-10-29,2,Bed Number 2,23,22,1
2014-10-29,3,Bed Number 3,49,5,44
2014-10-30,1,Bed Number 1,21,12,9
2014-10-30,2,Bed Number 2,32,5,27
2014-10-30,3,Bed Number 3,59,48,11
2014-10-31,1,Bed Number 1,33,10,23
2014-10-31,2,Bed Number 2,67,17,50
2014-10-31,3,Bed Number 3,96,37,59
2014-11-01,1,Bed Number 1,44,24,20
2014-11-01,2,Bed Number 2,62,10,52
2014-11-01,3,Bed Number 3,94,88,6
2014-11-02,1,Bed Number 1,17,2,15
2014-11-02,2,Bed Number 2,12,7,5
2014-11-02,3,Bed Number 3,26,25,1
2014-11-03,1,Bed Number 1,26,17,9
2014-11-03,2,Bed Number 2,40,15,25
2014-11-03,3,Bed Number 3,33,21,12
2014-11-04,1,Bed Number 1,39,22,17
2014-11-04,2,Bed Number 2,61,37,24
2014-11-04,3,Bed Number 3,28,14,14
2014-11-05,1,Bed Number 1,15,0,15
2014-11-05,2,Bed Number 2,64,33,31
2014-11-05,3,Bed Number 3,35,33,2
2014-11-06,1,Bed Number 1,10,9,1
2014-11-06,2,Bed Number 2,42,26,16
2014-11-06,3,Bed Number 3,64,33,31
2014-11-07,1,Bed Number 1,25,2,23
2014-11-07,2,Bed Number 2,56,32,24
2014-11-07,3,Bed Number 3,100,99,1
2014-11-08,1,Bed Number 1,84,48,36
2014-11-08,2,Bed Number 2,49,1,48
2014-11-08,3,Bed Number 3,94,17,77
2014-11-09,1,Bed Number 1,100,78,22
2014-11-09,2,Bed Number 2,46,11,35
2014-11-09,3,Bed Number 3,74,22,52
2014-11-10,1,Bed Number 1,82,8,74
2014-11-10,2,Bed Number 2,23,17,6
2014-11-10,3,Bed Number 3,85,31,54
2014-11-11,1,Bed Number 1,91,51,40
2014-11-11,2,Bed Number 2,30,5,25
2014-11-11,3,Bed Number 3,53,25,28
2014-11-12,1,Bed Number 1,64,28,36
2014-11-12,2,Bed Number 2,26,6,20
2014-11-12,3,Bed Number 3,93,66,27
2014-11-13,1,Bed Number 1,23,2,21
2014-11-13,2,Bed Number 2,79,72,7
2014-11-13,3,Bed Number 3,19,13,6
2014-11-14,1,Bed Number 1,38,4,34
2014-11-14,2,Bed Number 2,64,42,22
2014-11-14,3,Bed Number 3,39,25,14
2014-11-15,1,Bed Number 1,39,39,0
2014-11-15,2,Bed Number 2,49,45,4
2014-11-15,3,Bed Number 3,97,89,8
2014-11-16,1,Bed Number 1,98,85,13
2014-11-16,2,Bed Number 2,64,23,41
2014-11-16,3,Bed Number 3,78,69,9
2014-11-17,1,Bed Number 1,20,9,11
2014-11-17,2,Bed Number 2,15,5,10
2014-11-17,3,Bed Number 3,59,55,4
2014-11-18,1,Bed Number 1,70,65,5
2014-11-18,2,Bed Number 2,14,7,7
2014-11-18,3,Bed Number 3,89,69,20
2014-11-19,1,Bed Number 1,76,57,19
2014-11-19,2,Bed Number 2,12,2,10
2014-11-19,3,Bed Number 3,16,1,15
2014-11-20,1,Bed Number 1,76,49,27
2014-11-20,2,Bed Number 2,92,12,80
2014-11-20,3,Bed Number 3,20,15,5
2014-11-21,1,Bed Number 1,59,29,30
2014-11-21,2,Bed Number 2,28,26,2
2014-11-21,3,Bed Number 3,77,49,28
2014-11-22,1,Bed Number 1,85,50,35
2014-11-22,2,Bed Number 2,91,21,70
2014-11-22,3,Bed Number 3,27,8,19
2014-11-23,1,Bed Number 1,20,16,4
2014-11-23,2,Bed Number 2,27,21,6
2014-11-23,3,Bed Number 3,18,0,18
2014-11-24,1,Bed Number 1,45,11,34
2014-11-24,2,Bed Number 2,65,56,9
2014-11-24,3,Bed Number 3,43,18,25
2014-11-25,1,Bed Number 1,57,14,43
2014-11-25,2,Bed Number 2,95,24,71
2014-11-25,3,Bed Number 3,16,9,7
2014-11-26,1,Bed Number 1,95,8,87
2014-11-26,2,Bed Number 2,63,18,45
2014-11-26,3,Bed Number 3,13,12,1
2014-11-27,1,Bed Number 1,55,0,55
2014-11-27,2,Bed Number 2,83,79,4
2014-11-27,3,Bed Number 3,88,23,65
2014-11-28,1,Bed Number 1,85,19,66
2014-11-28,2,Bed Number 2,46,43,3
2014-11-28,3,Bed Number 3,41,29,12
2014-11-29,1,Bed Number 1,43,10,33
2014-11-29,2,Bed Number 2,55,11,44
2014-11-29,3,Bed Number 3,20,17,3
2014-11-30,1,Bed Number 1,29,8,21
2014-11-30,2,Bed Number 2,70,41,29
2014-11-30,3,Bed Number 3,97,59,38
2014-12-01,1,Bed Number 1,32,4,28
2014-12-01,2,Bed Number 2,15,1,14
2014-12-01,3,Bed Number 3,68,46,22
2014-12-02,1,Bed Number 1,69,43,26
2014-12-02,2,Bed Number 2,54,5,49
2014-12-02,3,Bed Number 3,73,4,69
2014-12-03,1,Bed Number 1,87,56,31
2014-12-03,2,Bed Number 2,63,49,14
2014-12-03,3,Bed Number 3,94,36,58
2014-12-04,1,Bed Number 1,37,7,30
2014-12-04,2,Bed Number 2,59,51,8
2014-12-04,3,Bed Number 3,79,18,61
2014-12-05,1,Bed Number 1,68,52,16
2014-12-05,2,Bed Number 2,83,79,4
2014-12-05,3,Bed Number 3,99,7,92
2014-12-06,1,Bed Number 1,89,26,63
2014-12-06,2,Bed Number 2,28,1,27
2014-12-06,3,Bed Number 3,60,44,16
2014-12-07,1,Bed Number 1,49,7,42
2014-12-07,2,Bed Number 2,100,88,12
2014-12-07,3,Bed Number 3,85,1,84
2014-12-08,1,Bed Number 1,54,41,13
2014-12-08,2,Bed Number 2,85,38,47
2014-12-08,3,Bed Number 3,34,33,1
2014-12-09,1,Bed Number 1,96,52,44
2014-12-09,2,Bed Number 2,13,7,6
2014-12-09,3,Bed Number 3,75,73,2
2014-12-10,1,Bed Number 1,31,21,10
2014-12-10,2,Bed Number 2,66,46,20
2014-12-10,3,Bed Number 3,28,16,12
2014-12-11,1,Bed Number 1,24,5,19
2014-12-11,2,Bed Number 2,20,4,16
2014-12-11,3,Bed Number 3,13,1,12
2014-12-12,1,Bed Number 1,80,73,7
2014-12-12,2,Bed Number 2,60,23,37
2014-12-12,3,Bed Number 3,100,26,74
2014-12-13,1,Bed Number 1,70,29,41
2014-12-13,2,Bed Number 2,61,12,49
2014-12-13,3,Bed Number 3,68,41,27
2014-12-14,1,Bed Number 1,31,26,5
2014-12-14,2,Bed Number 2,83,11,72
2014-12-14,3,Bed Number 3,35,23,12
2014-12-15,1,Bed Number 1,23,12,11
2014-12-15,2,Bed Number 2,36,11,25
2014-12-15,3,Bed Number 3,52,22,30
2014-12-16,1,Bed Number 1,36,8,28
2014-12-16,2,Bed Number 2,53,22,31
2014-12-16,3,Bed Number 3,82,82,0
2014-12-17,1,Bed Number 1,77,26,51
2014-12-17,2,Bed Number 2,94,6,88
2014-12-17,3,Bed Number 3,16,13,3
2014-12-18,1,Bed Number 1,14,14,0
2014-12-18,2,Bed Number 2,66,48,18
2014-12-18,3,Bed Number 3,31,27,4
2014-12-19,1,Bed Number 1,30,14,16
2014-12-19,2,Bed Number 2,65,35,30
2014-12-19,3,Bed Number 3,44,31,13
2014-12-20,1,Bed Number 1,93,26,67
2014-12-20,2,Bed Number 2,48,27,21
2014-12-20,3,Bed Number 3,23,0,23
2014-12-21,1,Bed Number 1,78,30,48
2014-12-21,2,Bed Number 2,13,11,2
2014-12-21,3,Bed Number 3,62,4,58
2014-12-22,1,Bed Number 1,48,42,6
2014-12-22,2,Bed Number 2,63,0,63
2014-12-22,3,Bed Number 3,40,21,19
2014-12-23,1,Bed Number 1,63,17,46
2014-12-23,2,Bed Number 2,11,7,4
2014-12-23,3,Bed Number 3,27,7,20
2014-12-24,1,Bed Number 1,21,18,3
2014-12-24,2,Bed Number 2,93,17,76
2014-12-24,3,Bed Number 3,25,25,0
2014-12-25,1,Bed Number 1,42,25,17
2014-12-25,2,Bed Number 2,59,56,3
2014-12-25,3,Bed Number 3,79,2,77
2014-12-26,1,Bed Number 1,42,15,27
2014-12-26,2,Bed Number 2,29,18,11
2014-12-26,3,Bed Number 3,25,17,8
2014-12-27,1,Bed Number 1,91,12,79
2014-12-27,2,Bed Number 2,38,32,6
2014-12-27,3,Bed Number 3,29,21,8
2014-12-28,1,Bed Number 1,60,6,54
2014-12-28,2,Bed Number 2,13,11,2
2014-12-28,3,Bed Number 3,83,73,10
2014-12-29,1,Bed Number 1,49,14,35
2014-12-29,2,Bed Number 2,16,1,15
2014-12-29,3,Bed Number 3,70,44,26
2014-12-30,1,Bed Number 1,21,19,2
2014-12-30,2,Bed Number 2,37,27,10
2014-12-30,3,Bed Number 3,41,2,39
2014-12-31,1,Bed Number 1,52,50,2
2014-12-31,2,Bed Number 2,32,20,12
2014-12-31,3,Bed Number 3,75,28,47
2015-01-01,1,Bed Number 1,45,44,1
2015-01-01,2,Bed Number 2,71,16,55
2015-01-01,3,Bed Number 3,60,36,24
2015-01-02,1,Bed Number 1,14,13,1
2015-01-02,2,Bed Number 2,32,21,11
2015-01-02,3,Bed Number 3,32,11,21
2015-01-03,1,Bed Number 1,34,15,19
2015-01-03,2,Bed Number 2,22,7,15
2015-01-03,3,Bed Number 3,41,23,18
2015-01-04,1,Bed Number 1,97,62,35
2015-01-04,2,Bed Number 2,87,13,74
2015-01-04,3,Bed Number 3,47,47,0
2015-01-05,1,Bed Number 1,36,22,14
2015-01-05,2,Bed Number 2,43,40,3
2015-01-05,3,Bed Number 3,27,24,3
2015-01-06,1,Bed Number 1,58,35,23
2015-01-06,2,Bed Number 2,28,14,14
2015-01-06,3,Bed Number 3,20,10,10
2015-01-07,1,Bed Number 1,93,3,90
2015-01-07,2,Bed Number 2,74,73,1
2015-01-07,3,Bed Number 3,14,1,13
2015-01-08,1,Bed Number 1,60,0,60
2015-01-08,2,Bed Number 2,63,56,7
2015-01-08,3,Bed Number 3,53,10,43
2015-01-09,1,Bed Number 1,29,22,7
2015-01-09,2,Bed Number 2,91,39,52
2015-01-09,3,Bed Number 3,31,28,3
2015-01-10,1,Bed Number 1,31,30,1
2015-01-10,2,Bed Number 2,63,45,18
2015-01-10,3,Bed Number 3,18,8,10
2015-01-11,1,Bed Number 1,76,16,60
2015-01-11,2,Bed Number 2,75,74,1
2015-01-11,3,Bed Number 3,61,48,13
2015-01-12,1,Bed Number 1,87,13,74
2015-01-12,2,Bed Number 2,80,41,39
2015-01-12,3,Bed Number 3,77,30,47
2015-01-13,1,Bed Number 1,57,5,52
2015-01-13,2,Bed Number 2,39,3,36
2015-01-13,3,Bed Number 3,38,16,22
2015-01-14,1,Bed Number 1,52,49,3
2015-01-14,2,Bed Number 2,16,6,10
2015-01-14,3,Bed Number 3,45,20,25
2015-01-15,1,Bed Number 1,67,28,39
2015-01-15,2,Bed Number 2,81,42,39
2015-01-15,3,Bed Number 3,54,43,11
2015-01-16,1,Bed Number 1,11,1,10
2015-01-16,2,Bed Number 2,76,68,8
2015-01-16,3,Bed Number 3,45,31,14
2015-01-17,1,Bed Number 1,26,20,6
2015-01-17,2,Bed Number 2,79,64,15
2015-01-17,3,Bed Number 3,70,53,17
2015-01-18,1,Bed Number 1,60,36,24
2015-01-18,2,Bed Number 2,39,24,15
2015-01-18,3,Bed Number 3,99,4,95
2015-01-19,1,Bed Number 1,13,8,5
2015-01-19,2,Bed Number 2,25,0,25
2015-01-19,3,Bed Number 3,37,12,25
2015-01-20,1,Bed Number 1,18,0,18
2015-01-20,2,Bed Number 2,84,19,65
2015-01-20,3,Bed Number 3,14,11,3
2015-01-21,1,Bed Number 1,22,20,2
2015-01-21,2,Bed Number 2,95,69,26
2015-01-21,3,Bed Number 3,17,1,16
2015-01-22,1,Bed Number 1,31,1,30
2015-01-22,2,Bed Number 2,24,21,3
2015-01-22,3,Bed Number 3,72,69,3
2015-01-23,1,Bed Number 1,17,15,2
2015-01-23,2,Bed Number 2,29,5,24
2015-01-23,3,Bed Number 3,92,3,89
2015-01-24,1,Bed Number 1,50,8,42
2015-01-24,2,Bed Number 2,51,47,4
2015-01-24,3,Bed Number 3,10,9,1
2015-01-25,1,Bed Number 1,30,3,27
2015-01-25,2,Bed Number 2,98,42,56
2015-01-25,3,Bed Number 3,16,5,11
2015-01-26,1,Bed Number 1,75,10,65
2015-01-26,2,Bed Number 2,76,14,62
2015-01-26,3,Bed Number 3,46,8,38
2015-01-27,1,Bed Number 1,48,33,15
2015-01-27,2,Bed Number 2,67,9,58
2015-01-27,3,Bed Number 3,20,0,20
2015-01-28,1,Bed Number 1,58,45,13
2015-01-28,2,Bed Number 2,50,24,26
2015-01-28,3,Bed Number 3,74,51,23
2015-01-29,1,Bed Number 1,38,0,38
2015-01-29,2,Bed Number 2,34,6,28
2015-01-29,3,Bed Number 3,78,26,52
2015-01-30,1,Bed Number 1,75,28,47
2015-01-30,2,Bed Number 2,66,61,5
2015-01-30,3,Bed Number 3,71,9,62
2015-01-31,1,Bed Number 1,66,54,12
2015-01-31,2,Bed Number 2,68,6,62
2015-01-31,3,Bed Number 3,23,17,6
2015-02-01,1,Bed Number 1,70,64,6
2015-02-01,2,Bed Number 2,11,0,11
2015-02-01,3,Bed Number 3,14,3,11
2015-02-02,1,Bed Number 1,89,43,46
2015-02-02,2,Bed Number 2,44,6,38
2015-02-02,3,Bed Number 3,11,8,3
2015-02-03,1,Bed Number 1,91,2,89
2015-02-03,2,Bed Number 2,97,26,71
2015-02-03,3,Bed Number 3,44,42,2
2015-02-04,1,Bed Number 1,85,78,7
2015-02-04,2,Bed Number 2,21,7,14
2015-02-04,3,Bed Number 3,43,32,11
2015-02-05,1,Bed Number 1,33,17,16
2015-02-05,2,Bed Number 2,58,35,23
2015-02-05,3,Bed Number 3,26,4,22
2015-02-06,1,Bed Number 1,66,25,41
2015-02-06,2,Bed Number 2,33,10,23
2015-02-06,3,Bed Number 3,36,18,18
2015-02-07,1,Bed Number 1,31,23,8
2015-02-07,2,Bed Number 2,40,38,2
2015-02-07,3,Bed Number 3,29,7,22
2015-02-08,1,Bed Number 1,93,37,56
2015-02-08,2,Bed Number 2,21,6,15
2015-02-08,3,Bed Number 3,33,2,31
2015-02-09,1,Bed Number 1,13,7,6
2015-02-09,2,Bed Number 2,54,53,1
2015-02-09,3,Bed Number 3,80,15,65
2015-02-10,1,Bed Number 1,69,10,59
2015-02-10,2,Bed Number 2,60,31,29
2015-02-10,3,Bed Number 3,25,21,4
2015-02-11,1,Bed Number 1,78,33,45
2015-02-11,2,Bed Number 2,94,90,4
2015-02-11,3,Bed Number 3,60,46,14
2015-02-12,1,Bed Number 1,53,33,20
2015-02-12,2,Bed Number 2,90,28,62
2015-02-12,3,Bed Number 3,56,26,30
2015-02-13,1,Bed Number 1,63,40,23
2015-02-13,2,Bed Number 2,70,15,55
2015-02-13,3,Bed Number 3,18,14,4
2015-02-14,1,Bed Number 1,81,43,38
2015-02-14,2,Bed Number 2,97,88,9
2015-02-14,3,Bed Number 3,60,46,14
2015-02-15,1,Bed Number 1,85,46,39
2015-02-15,2,Bed Number 2,22,3,19
2015-02-15,3,Bed Number 3,57,28,29
2015-02-16,1,Bed Number 1,46,38,8
2015-02-16,2,Bed Number 2,32,27,5
2015-02-16,3,Bed Number 3,62,53,9
2015-02-17,1,Bed Number 1,12,11,1
2015-02-17,2,Bed Number 2,26,5,21
2015-02-17,3,Bed Number 3,40,6,34
2015-02-18,1,Bed Number 1,96,78,18
2015-02-18,2,Bed Number 2,18,0,18
2015-02-18,3,Bed Number 3,13,6,7
2015-02-19,1,Bed Number 1,56,36,20
2015-02-19,2,Bed Number 2,54,23,31
2015-02-19,3,Bed Number 3,66,53,13
2015-02-20,1,Bed Number 1,71,19,52
2015-02-20,2,Bed Number 2,55,52,3
2015-02-20,3,Bed Number 3,36,25,11
2015-02-21,1,Bed Number 1,73,63,10
2015-02-21,2,Bed Number 2,93,40,53
2015-02-21,3,Bed Number 3,85,83,2
2015-02-22,1,Bed Number 1,69,35,34
2015-02-22,2,Bed Number 2,90,32,58
2015-02-22,3,Bed Number 3,86,52,34
2015-02-23,1,Bed Number 1,11,7,4
2015-02-23,2,Bed Number 2,81,6,75
2015-02-23,3,Bed Number 3,10,2,8
2015-02-24,1,Bed Number 1,51,43,8
2015-02-24,2,Bed Number 2,23,5,18
2015-02-24,3,Bed Number 3,55,52,3
2015-02-25,1,Bed Number 1,94,57,37
2015-02-25,2,Bed Number 2,79,8,71
2015-02-25,3,Bed Number 3,65,31,34
2015-02-26,1,Bed Number 1,60,15,45
2015-02-26,2,Bed Number 2,60,49,11
2015-02-26,3,Bed Number 3,45,2,43
2015-02-27,1,Bed Number 1,32,2,30
2015-02-27,2,Bed Number 2,32,11,21
2015-02-27,3,Bed Number 3,78,4,74
2015-02-28,1,Bed Number 1,39,25,14
2015-02-28,2,Bed Number 2,80,17,63
2015-02-28,3,Bed Number 3,43,17,26
2015-03-01,1,Bed Number 1,73,58,15
2015-03-01,2,Bed Number 2,57,42,15
2015-03-01,3,Bed Number 3,33,13,20
2015-03-02,1,Bed Number 1,84,58,26
2015-03-02,2,Bed Number 2,29,28,1
2015-03-02,3,Bed Number 3,23,11,12
2015-03-03,1,Bed Number 1,39,7,32
2015-03-03,2,Bed Number 2,12,11,1
2015-03-03,3,Bed Number 3,58,45,13
2015-03-04,1,Bed Number 1,97,52,45
2015-03-04,2,Bed Number 2,58,56,2
2015-03-04,3,Bed Number 3,66,43,23
2015-03-05,1,Bed Number 1,14,5,9
2015-03-05,2,Bed Number 2,92,19,73
2015-03-05,3,Bed Number 3,92,55,37
2015-03-06,1,Bed Number 1,72,26,46
2015-03-06,2,Bed Number 2,79,60,19
2015-03-06,3,Bed Number 3,94,23,71
2015-03-07,1,Bed Number 1,100,1,99
2015-03-07,2,Bed Number 2,40,6,34
2015-03-07,3,Bed Number 3,53,20,33
2015-03-08,1,Bed Number 1,44,12,32
2015-03-08,2,Bed Number 2,74,69,5
2015-03-08,3,Bed Number 3,94,79,15
2015-03-09,1,Bed Number 1,66,2,64
2015-03-09,2,Bed Number 2,73,15,58
2015-03-09,3,Bed Number 3,64,24,40
2015-03-10,1,Bed Number 1,68,41,27
2015-03-10,2,Bed Number 2,84,16,68
2015-03-10,3,Bed Number 3,75,44,31
2015-03-11,1,Bed Number 1,70,59,11
2015-03-11,2,Bed Number 2,71,16,55
2015-03-11,3,Bed Number 3,76,54,22
2015-03-12,1,Bed Number 1,26,24,2
2015-03-12,2,Bed Number 2,23,16,7
2015-03-12,3,Bed Number 3,71,23,48
2015-03-13,1,Bed Number 1,40,28,12
2015-03-13,2,Bed Number 2,38,30,8
2015-03-13,3,Bed Number 3,23,18,5
2015-03-14,1,Bed Number 1,98,4,94
2015-03-14,2,Bed Number 2,54,5,49
2015-03-14,3,Bed Number 3,12,9,3
2015-03-15,1,Bed Number 1,15,3,12
2015-03-15,2,Bed Number 2,67,35,32
2015-03-15,3,Bed Number 3,91,64,27
2015-03-16,1,Bed Number 1,63,21,42
2015-03-16,2,Bed Number 2,83,76,7
2015-03-16,3,Bed Number 3,68,52,16
2015-03-17,1,Bed Number 1,85,12,73
2015-03-17,2,Bed Number 2,86,22,64
2015-03-17,3,Bed Number 3,93,25,68
2015-03-18,1,Bed Number 1,37,23,14
2015-03-18,2,Bed Number 2,65,37,28
2015-03-18,3,Bed Number 3,38,32,6
2015-03-19,1,Bed Number 1,62,59,3
2015-03-19,2,Bed Number 2,57,51,6
2015-03-19,3,Bed Number 3,48,27,21
2015-03-20,1,Bed Number 1,45,23,22
2015-03-20,2,Bed Number 2,21,5,16
2015-03-20,3,Bed Number 3,74,24,50
2015-03-21,1,Bed Number 1,59,5,54
2015-03-21,2,Bed Number 2,31,28,3
2015-03-21,3,Bed Number 3,26,25,1
2015-03-22,1,Bed Number 1,60,49,11
2015-03-22,2,Bed Number 2,80,61,19
2015-03-22,3,Bed Number 3,68,55,13
2015-03-23,1,Bed Number 1,33,7,26
2015-03-23,2,Bed Number 2,29,29,0
2015-03-23,3,Bed Number 3,28,15,13
2015-03-24,1,Bed Number 1,45,8,37
2015-03-24,2,Bed Number 2,35,8,27
2015-03-24,3,Bed Number 3,92,45,47
2015-03-25,1,Bed Number 1,41,25,16
2015-03-25,2,Bed Number 2,94,8,86
2015-03-25,3,Bed Number 3,92,4,88
2015-03-26,1,Bed Number 1,47,20,27
2015-03-26,2,Bed Number 2,45,40,5
2015-03-26,3,Bed Number 3,11,9,2
2015-03-27,1,Bed Number 1,15,2,13
2015-03-27,2,Bed Number 2,82,51,31
2015-03-27,3,Bed Number 3,79,76,3
2015-03-28,1,Bed Number 1,28,12,16
2015-03-28,2,Bed Number 2,33,32,1
2015-03-28,3,Bed Number 3,46,25,21
2015-03-29,1,Bed Number 1,83,10,73
2015-03-29,2,Bed Number 2,78,70,8
2015-03-29,3,Bed Number 3,58,31,27
2015-03-30,1,Bed Number 1,29,17,12
2015-03-30,2,Bed Number 2,49,24,25
2015-03-30,3,Bed Number 3,80,39,41
2015-03-31,1,Bed Number 1,69,55,14
2015-03-31,2,Bed Number 2,98,44,54
2015-03-31,3,Bed Number 3,21,3,18
2015-04-01,1,Bed Number 1,86,7,79
2015-04-01,2,Bed Number 2,37,3,34
2015-04-01,3,Bed Number 3,48,43,5
2015-04-02,1,Bed Number 1,34,6,28
2015-04-02,2,Bed Number 2,73,23,50
2015-04-02,3,Bed Number 3,39,39,0
2015-04-03,1,Bed Number 1,39,7,32
2015-04-03,2,Bed Number 2,56,49,7
2015-04-03,3,Bed Number 3,88,40,48
2015-04-04,1,Bed Number 1,57,7,50
2015-04-04,2,Bed Number 2,17,15,2
2015-04-04,3,Bed Number 3,88,56,32
2015-04-05,1,Bed Number 1,45,1,44
2015-04-05,2,Bed Number 2,92,86,6
2015-04-05,3,Bed Number 3,43,3,40
2015-04-06,1,Bed Number 1,20,14,6
2015-04-06,2,Bed Number 2,56,1,55
2015-04-06,3,Bed Number 3,14,9,5
2015-04-07,1,Bed Number 1,89,59,30
2015-04-07,2,Bed Number 2,23,6,17
2015-04-07,3,Bed Number 3,21,10,11
2015-04-08,1,Bed Number 1,69,36,33
2015-04-08,2,Bed Number 2,68,5,63
2015-04-08,3,Bed Number 3,74,0,74
2015-04-09,1,Bed Number 1,21,11,10
2015-04-09,2,Bed Number 2,100,17,83
2015-04-09,3,Bed Number 3,84,51,33
2015-04-10,1,Bed Number 1,53,32,21
2015-04-10,2,Bed Number 2,83,80,3
2015-04-10,3,Bed Number 3,10,0,10
2015-04-11,1,Bed Number 1,89,88,1
2015-04-11,2,Bed Number 2,78,60,18
2015-04-11,3,Bed Number 3,71,71,0
2015-04-12,1,Bed Number 1,58,15,43
2015-04-12,2,Bed Number 2,11,3,8
2015-04-12,3,Bed Number 3,21,12,9
2015-04-13,1,Bed Number 1,95,14,81
2015-04-13,2,Bed Number 2,42,25,17
2015-04-13,3,Bed Number 3,78,5,73
2015-04-14,1,Bed Number 1,49,23,26
2015-04-14,2,Bed Number 2,22,14,8
2015-04-14,3,Bed Number 3,55,48,7
2015-04-15,1,Bed Number 1,42,34,8
2015-04-15,2,Bed Number 2,32,32,0
2015-04-15,3,Bed Number 3,37,2,35
2015-04-16,1,Bed Number 1,75,6,69
2015-04-16,2,Bed Number 2,42,24,18
2015-04-16,3,Bed Number 3,24,3,21
2015-04-17,1,Bed Number 1,41,22,19
2015-04-17,2,Bed Number 2,24,1,23
2015-04-17,3,Bed Number 3,35,32,3
2015-04-18,1,Bed Number 1,95,88,7
2015-04-18,2,Bed Number 2,27,21,6
2015-04-18,3,Bed Number 3,99,92,7
2015-04-19,1,Bed Number 1,62,60,2
2015-04-19,2,Bed Number 2,99,57,42
2015-04-19,3,Bed Number 3,78,41,37
2015-04-20,1,Bed Number 1,31,3,28
2015-04-20,2,Bed Number 2,97,5,92
2015-04-20,3,Bed Number 3,26,2,24
2015-04-21,1,Bed Number 1,25,25,0
2015-04-21,2,Bed Number 2,100,25,75
2015-04-21,3,Bed Number 3,26,20,6
2015-04-22,1,Bed Number 1,14,8,6
2015-04-22,2,Bed Number 2,49,45,4
2015-04-22,3,Bed Number 3,81,72,9
2015-04-23,1,Bed Number 1,40,39,1
2015-04-23,2,Bed Number 2,18,12,6
2015-04-23,3,Bed Number 3,94,38,56
2015-04-24,1,Bed Number 1,35,34,1
2015-04-24,2,Bed Number 2,14,14,0
2015-04-24,3,Bed Number 3,98,5,93
2015-04-25,1,Bed Number 1,18,16,2
2015-04-25,2,Bed Number 2,79,67,12
2015-04-25,3,Bed Number 3,90,8,82
2015-04-26,1,Bed Number 1,50,23,27
2015-04-26,2,Bed Number 2,22,15,7
2015-04-26,3,Bed Number 3,34,3,31
2015-04-27,1,Bed Number 1,93,32,61
2015-04-27,2,Bed Number 2,28,4,24
2015-04-27,3,Bed Number 3,83,66,17
2015-04-28,1,Bed Number 1,98,6,92
2015-04-28,2,Bed Number 2,31,11,20
2015-04-28,3,Bed Number 3,59,31,28
2015-04-29,1,Bed Number 1,61,56,5
2015-04-29,2,Bed Number 2,61,10,51
2015-04-29,3,Bed Number 3,86,47,39
2015-04-30,1,Bed Number 1,71,58,13
2015-04-30,2,Bed Number 2,76,44,32
2015-04-30,3,Bed Number 3,31,2,29
2015-05-01,1,Bed Number 1,62,38,24
2015-05-01,2,Bed Number 2,20,1,19
2015-05-01,3,Bed Number 3,22,7,15
2015-05-02,1,Bed Number 1,56,16,40
2015-05-02,2,Bed Number 2,36,25,11
2015-05-02,3,Bed Number 3,88,81,7
2015-05-03,1,Bed Number 1,64,5,59
2015-05-03,2,Bed Number 2,87,77,10
2015-05-03,3,Bed Number 3,33,18,15
2015-05-04,1,Bed Number 1,84,38,46
2015-05-04,2,Bed Number 2,92,52,40
2015-05-04,3,Bed Number 3,73,26,47
2015-05-05,1,Bed Number 1,92,74,18
2015-05-05,2,Bed Number 2,48,25,23
2015-05-05,3,Bed Number 3,88,37,51
2015-05-06,1,Bed Number 1,58,9,49
2015-05-06,2,Bed Number 2,33,31,2
2015-05-06,3,Bed Number 3,46,3,43
2015-05-07,1,Bed Number 1,26,14,12
2015-05-07,2,Bed Number 2,23,2,21
2015-05-07,3,Bed Number 3,78,10,68
2015-05-08,1,Bed Number 1,26,3,23
2015-05-08,2,Bed Number 2,10,1,9
2015-05-08,3,Bed Number 3,48,34,14
2015-05-09,1,Bed Number 1,73,39,34
2015-05-09,2,Bed Number 2,13,8,5
2015-05-09,3,Bed Number 3,91,60,31
2015-05-10,1,Bed Number 1,48,12,36
2015-05-10,2,Bed Number 2,16,14,2
2015-05-10,3,Bed Number 3,57,23,34
2015-05-11,1,Bed Number 1,23,8,15
2015-05-11,2,Bed Number 2,33,7,26
2015-05-11,3,Bed Number 3,64,40,24
2015-05-12,1,Bed Number 1,27,4,23
2015-05-12,2,Bed Number 2,66,21,45
2015-05-12,3,Bed Number 3,52,40,12
2015-05-13,1,Bed Number 1,92,63,29
2015-05-13,2,Bed Number 2,50,7,43
2015-05-13,3,Bed Number 3,84,68,16
2015-05-14,1,Bed Number 1,81,77,4
2015-05-14,2,Bed Number 2,13,3,10
2015-05-14,3,Bed Number 3,12,3,9
2015-05-15,1,Bed Number 1,22,3,19
2015-05-15,2,Bed Number 2,76,23,53
2015-05-15,3,Bed Number 3,30,25,5
2015-05-16,1,Bed Number 1,34,17,17
2015-05-16,2,Bed Number 2,59,15,44
2015-05-16,3,Bed Number 3,92,24,68
2015-05-17,1,Bed Number 1,70,68,2
2015-05-17,2,Bed Number 2,73,63,10
2015-05-17,3,Bed Number 3,25,24,1
2015-05-18,1,Bed Number 1,79,72,7
2015-05-18,2,Bed Number 2,11,4,7
2015-05-18,3,Bed Number 3,67,19,48
2015-05-19,1,Bed Number 1,16,12,4
2015-05-19,2,Bed Number 2,37,25,12
2015-05-19,3,Bed Number 3,67,60,7
2015-05-20,1,Bed Number 1,84,40,44
2015-05-20,2,Bed Number 2,54,28,26
2015-05-20,3,Bed Number 3,68,7,61
2015-05-21,1,Bed Number 1,60,27,33
2015-05-21,2,Bed Number 2,44,44,0
2015-05-21,3,Bed Number 3,21,6,15
2015-05-22,1,Bed Number 1,100,27,73
2015-05-22,2,Bed Number 2,62,7,55
2015-05-22,3,Bed Number 3,64,18,46
2015-05-23,1,Bed Number 1,80,71,9
2015-05-23,2,Bed Number 2,99,52,47
2015-05-23,3,Bed Number 3,14,4,10
2015-05-24,1,Bed Number 1,19,9,10
2015-05-24,2,Bed Number 2,62,0,62
2015-05-24,3,Bed Number 3,55,5,50
2015-05-25,1,Bed Number 1,15,2,13
2015-05-25,2,Bed Number 2,51,42,9
2015-05-25,3,Bed Number 3,34,13,21
2015-05-26,1,Bed Number 1,81,29,52
2015-05-26,2,Bed Number 2,84,45,39
2015-05-26,3,Bed Number 3,53,2,51
2015-05-27,1,Bed Number 1,45,18,27
2015-05-27,2,Bed Number 2,42,16,26
2015-05-27,3,Bed Number 3,92,83,9
2015-05-28,1,Bed Number 1,60,11,49
2015-05-28,2,Bed Number 2,83,48,35
2015-05-28,3,Bed Number 3,93,83,10
2015-05-29,1,Bed Number 1,73,4,69
2015-05-29,2,Bed Number 2,39,7,32
2015-05-29,3,Bed Number 3,63,48,15
2015-05-30,1,Bed Number 1,31,12,19
2015-05-30,2,Bed Number 2,18,12,6
2015-05-30,3,Bed Number 3,48,6,42
2015-05-31,1,Bed Number 1,38,18,20
2015-05-31,2,Bed Number 2,80,68,12
2015-05-31,3,Bed Number 3,57,16,41
2015-06-01,1,Bed Number 1,57,42,15
2015-06-01,2,Bed Number 2,44,13,31
2015-06-01,3,Bed Number 3,85,42,43
2015-06-02,1,Bed Number 1,77,66,11
2015-06-02,2,Bed Number 2,27,8,19
2015-06-02,3,Bed Number 3,82,79,3
2015-06-03,1,Bed Number 1,95,77,18
2015-06-03,2,Bed Number 2,66,34,32
2015-06-03,3,Bed Number 3,32,9,23
2015-06-04,1,Bed Number 1,12,9,3
2015-06-04,2,Bed Number 2,14,3,11
2015-06-04,3,Bed Number 3,66,65,1
2015-06-05,1,Bed Number 1,73,13,60
2015-06-05,2,Bed Number 2,92,82,10
2015-06-05,3,Bed Number 3,16,2,14
2015-06-06,1,Bed Number 1,57,11,46
2015-06-06,2,Bed Number 2,57,1,56
2015-06-06,3,Bed Number 3,76,17,59
2015-06-07,1,Bed Number 1,74,70,4
2015-06-07,2,Bed Number 2,88,22,66
2015-06-07,3,Bed Number 3,71,21,50
2015-06-08,1,Bed Number 1,25,5,20
2015-06-08,2,Bed Number 2,49,21,28
2015-06-08,3,Bed Number 3,85,30,55
2015-06-09,1,Bed Number 1,17,12,5
2015-06-09,2,Bed Number 2,70,3,67
2015-06-09,3,Bed Number 3,87,14,73
2015-06-10,1,Bed Number 1,65,12,53
2015-06-10,2,Bed Number 2,86,61,25
2015-06-10,3,Bed Number 3,79,41,38
2015-06-11,1,Bed Number 1,100,5,95
2015-06-11,2,Bed Number 2,84,23,61
2015-06-11,3,Bed Number 3,46,12,34
2015-06-12,1,Bed Number 1,94,8,86
2015-06-12,2,Bed Number 2,66,30,36
2015-06-12,3,Bed Number 3,12,4,8
2015-06-13,1,Bed Number 1,41,30,11
2015-06-13,2,Bed Number 2,28,16,12
2015-06-13,3,Bed Number 3,44,29,15
2015-06-14,1,Bed Number 1,69,28,41
2015-06-14,2,Bed Number 2,32,17,15
2015-06-14,3,Bed Number 3,73,4,69
2015-06-15,1,Bed Number 1,96,56,40
2015-06-15,2,Bed Number 2,14,5,9
2015-06-15,3,Bed Number 3,39,32,7
2015-06-16,1,Bed Number 1,93,23,70
2015-06-16,2,Bed Number 2,89,76,13
2015-06-16,3,Bed Number 3,75,43,32
2015-06-17,1,Bed Number 1,98,3,95
2015-06-17,2,Bed Number 2,21,11,10
2015-06-17,3,Bed Number 3,29,21,8
2015-06-18,1,Bed Number 1,12,5,7
2015-06-18,2,Bed Number 2,45,0,45
2015-06-18,3,Bed Number 3,63,45,18
2015-06-19,1,Bed Number 1,85,47,38
2015-06-19,2,Bed Number 2,60,44,16
2015-06-19,3,Bed Number 3,44,41,3
2015-06-20,1,Bed Number 1,11,8,3
2015-06-20,2,Bed Number 2,31,24,7
2015-06-20,3,Bed Number 3,33,11,22
2015-06-21,1,Bed Number 1,49,28,21
2015-06-21,2,Bed Number 2,73,58,15
2015-06-21,3,Bed Number 3,29,3,26
2015-06-22,1,Bed Number 1,37,25,12
2015-06-22,2,Bed Number 2,41,29,12
2015-06-22,3,Bed Number 3,50,43,7
2015-06-23,1,Bed Number 1,48,46,2
2015-06-23,2,Bed Number 2,87,67,20
2015-06-23,3,Bed Number 3,83,82,1
2015-06-24,1,Bed Number 1,32,12,20
2015-06-24,2,Bed Number 2,67,8,59
2015-06-24,3,Bed Number 3,91,63,28
2015-06-25,1,Bed Number 1,100,8,92
2015-06-25,2,Bed Number 2,61,54,7
2015-06-25,3,Bed Number 3,26,14,12
2015-06-26,1,Bed Number 1,28,9,19
2015-06-26,2,Bed Number 2,55,31,24
2015-06-26,3,Bed Number 3,77,53,24
2015-06-27,1,Bed Number 1,53,11,42
2015-06-27,2,Bed Number 2,75,74,1
2015-06-27,3,Bed Number 3,97,35,62
2015-06-28,1,Bed Number 1,31,24,7
2015-06-28,2,Bed Number 2,85,48,37
2015-06-28,3,Bed Number 3,35,21,14
2015-06-29,1,Bed Number 1,71,56,15
2015-06-29,2,Bed Number 2,54,43,11
2015-06-29,3,Bed Number 3,22,14,8
2015-06-30,1,Bed Number 1,41,36,5
2015-06-30,2,Bed Number 2,71,21,50
2015-06-30,3,Bed Number 3,89,39,50
2015-07-01,1,Bed Number 1,93,42,51
2015-07-01,2,Bed Number 2,29,3,26
2015-07-01,3,Bed Number 3,85,30,55
2015-07-02,1,Bed Number 1,88,18,70
2015-07-02,2,Bed Number 2,93,67,26
2015-07-02,3,Bed Number 3,22,1,21
2015-07-03,1,Bed Number 1,43,22,21
2015-07-03,2,Bed Number 2,80,17,63
2015-07-03,3,Bed Number 3,24,0,24
2015-07-04,1,Bed Number 1,69,62,7
2015-07-04,2,Bed Number 2,85,73,12
2015-07-04,3,Bed Number 3,57,22,35
2015-07-05,1,Bed Number 1,25,10,15
2015-07-05,2,Bed Number 2,73,34,39
2015-07-05,3,Bed Number 3,83,61,22
2015-07-06,1,Bed Number 1,68,25,43
2015-07-06,2,Bed Number 2,32,29,3
2015-07-06,3,Bed Number 3,87,51,36
2015-07-07,1,Bed Number 1,26,13,13
2015-07-07,2,Bed Number 2,56,51,5
2015-07-07,3,Bed Number 3,72,33,39
2015-07-08,1,Bed Number 1,81,27,54
2015-07-08,2,Bed Number 2,19,11,8
2015-07-08,3,Bed Number 3,52,8,44
2015-07-09,1,Bed Number 1,70,61,9
2015-07-09,2,Bed Number 2,52,22,30
2015-07-09,3,Bed Number 3,23,4,19
2015-07-10,1,Bed Number 1,79,19,60
2015-07-10,2,Bed Number 2,97,15,82
2015-07-10,3,Bed Number 3,35,14,21
2015-07-11,1,Bed Number 1,20,13,7
2015-07-11,2,Bed Number 2,21,21,0
2015-07-11,3,Bed Number 3,87,13,74
2015-07-12,1,Bed Number 1,18,12,6
2015-07-12,2,Bed Number 2,33,7,26
2015-07-12,3,Bed Number 3,24,11,13
2015-07-13,1,Bed Number 1,90,32,58
2015-07-13,2,Bed Number 2,94,14,80
2015-07-13,3,Bed Number 3,57,5,52
2015-07-14,1,Bed Number 1,98,43,55
2015-07-14,2,Bed Number 2,74,53,21
2015-07-14,3,Bed Number 3,47,12,35
2015-07-15,1,Bed Number 1,69,60,9
2015-07-15,2,Bed Number 2,11,0,11
2015-07-15,3,Bed Number 3,40,17,23
2015-07-16,1,Bed Number 1,21,10,11
2015-07-16,2,Bed Number 2,97,62,35
2015-07-16,3,Bed Number 3,28,9,19
2015-07-17,1,Bed Number 1,32,27,5
2015-07-17,2,Bed Number 2,54,42,12
2015-07-17,3,Bed Number 3,95,43,52
2015-07-18,1,Bed Number 1,26,11,15
2015-07-18,2,Bed Number 2,42,13,29
2015-07-18,3,Bed Number 3,17,3,14
2015-07-19,1,Bed Number 1,53,13,40
2015-07-19,2,Bed Number 2,82,22,60
2015-07-19,3,Bed Number 3,47,41,6
2015-07-20,1,Bed Number 1,36,26,10
2015-07-20,2,Bed Number 2,47,14,33
2015-07-20,3,Bed Number 3,78,8,70
2015-07-21,1,Bed Number 1,69,41,28
2015-07-21,2,Bed Number 2,97,21,76
2015-07-21,3,Bed Number 3,12,0,12
2015-07-22,1,Bed Number 1,56,45,11
2015-07-22,2,Bed Number 2,72,47,25
2015-07-22,3,Bed Number 3,22,22,0
2015-07-23,1,Bed Number 1,58,53,5
2015-07-23,2,Bed Number 2,49,23,26
2015-07-23,3,Bed Number 3,23,19,4
2015-07-24,1,Bed Number 1,44,37,7
2015-07-24,2,Bed Number 2,49,3,46
2015-07-24,3,Bed Number 3,59,57,2
2015-07-25,1,Bed Number 1,60,35,25
2015-07-25,2,Bed Number 2,22,20,2
2015-07-25,3,Bed Number 3,10,9,1
2015-07-26,1,Bed Number 1,17,16,1
2015-07-26,2,Bed Number 2,34,0,34
2015-07-26,3,Bed Number 3,98,83,15
2015-07-27,1,Bed Number 1,28,21,7
2015-07-27,2,Bed Number 2,29,9,20
2015-07-27,3,Bed Number 3,62,9,53
2015-07-28,1,Bed Number 1,41,1,40
2015-07-28,2,Bed Number 2,63,40,23
2015-07-28,3,Bed Number 3,56,31,25
2015-07-29,1,Bed Number 1,37,6,31
2015-07-29,2,Bed Number 2,80,60,20
2015-07-29,3,Bed Number 3,37,26,11
2015-07-30,1,Bed Number 1,68,68,0
2015-07-30,2,Bed Number 2,29,8,21
2015-07-30,3,Bed Number 3,21,3,18
2015-07-31,1,Bed Number 1,54,11,43
2015-07-31,2,Bed Number 2,97,82,15
2015-07-31,3,Bed Number 3,32,31,1
2015-08-01,1,Bed Number 1,70,60,10
2015-08-01,2,Bed Number 2,46,14,32
2015-08-01,3,Bed Number 3,89,88,1
2015-08-02,1,Bed Number 1,27,5,22
2015-08-02,2,Bed Number 2,49,4,45
2015-08-02,3,Bed Number 3,27,24,3
2015-08-03,1,Bed Number 1,95,52,43
2015-08-03,2,Bed Number 2,38,15,23
2015-08-03,3,Bed Number 3,94,43,51
2015-08-04,1,Bed Number 1,50,43,7
2015-08-04,2,Bed Number 2,40,15,25
2015-08-04,3,Bed Number 3,85,41,44
2015-08-05,1,Bed Number 1,67,30,37
2015-08-05,2,Bed Number 2,63,37,26
2015-08-05,3,Bed Number 3,96,61,35
2015-08-06,1,Bed Number 1,42,30,12
2015-08-06,2,Bed Number 2,64,35,29
2015-08-06,3,Bed Number 3,69,44,25
2015-08-07,1,Bed Number 1,69,41,28
2015-08-07,2,Bed Number 2,48,31,17
2015-08-07,3,Bed Number 3,99,37,62
2015-08-08,1,Bed Number 1,19,17,2
2015-08-08,2,Bed Number 2,79,17,62
2015-08-08,3,Bed Number 3,80,11,69
2015-08-09,1,Bed Number 1,31,10,21
2015-08-09,2,Bed Number 2,32,21,11
2015-08-09,3,Bed Number 3,20,5,15
2015-08-10,1,Bed Number 1,62,55,7
2015-08-10,2,Bed Number 2,90,49,41
2015-08-10,3,Bed Number 3,22,6,16
2015-08-11,1,Bed Number 1,48,7,41
2015-08-11,2,Bed Number 2,82,45,37
2015-08-11,3,Bed Number 3,12,7,5
2015-08-12,1,Bed Number 1,79,35,44
2015-08-12,2,Bed Number 2,71,2,69
2015-08-12,3,Bed Number 3,56,30,26
2015-08-13,1,Bed Number 1,79,27,52
2015-08-13,2,Bed Number 2,15,9,6
2015-08-13,3,Bed Number 3,55,7,48
2015-08-14,1,Bed Number 1,47,32,15
2015-08-14,2,Bed Number 2,21,21,0
2015-08-14,3,Bed Number 3,72,21,51
2015-08-15,1,Bed Number 1,48,46,2
2015-08-15,2,Bed Number 2,94,7,87
2015-08-15,3,Bed Number 3,61,19,42
2015-08-16,1,Bed Number 1,28,26,2
2015-08-16,2,Bed Number 2,25,17,8
2015-08-16,3,Bed Number 3,63,26,37
2015-08-17,1,Bed Number 1,37,14,23
2015-08-17,2,Bed Number 2,96,18,78
2015-08-17,3,Bed Number 3,55,24,31
2015-08-18,1,Bed Number 1,44,22,22
2015-08-18,2,Bed Number 2,21,2,19
2015-08-18,3,Bed Number 3,17,4,13
2015-08-19,1,Bed Number 1,31,6,25
2015-08-19,2,Bed Number 2,42,40,2
2015-08-19,3,Bed Number 3,90,86,4
2015-08-20,1,Bed Number 1,34,13,21
2015-08-20,2,Bed Number 2,57,12,45
2015-08-20,3,Bed Number 3,25,5,20
2015-08-21,1,Bed Number 1,22,4,18
2015-08-21,2,Bed Number 2,60,6,54
2015-08-21,3,Bed Number 3,91,72,19
2015-08-22,1,Bed Number 1,98,90,8
2015-08-22,2,Bed Number 2,44,8,36
2015-08-22,3,Bed Number 3,24,1,23
2015-08-23,1,Bed Number 1,55,11,44
2015-08-23,2,Bed Number 2,54,27,27
2015-08-23,3,Bed Number 3,84,8,76
2015-08-24,1,Bed Number 1,24,16,8
2015-08-24,2,Bed Number 2,24,5,19
2015-08-24,3,Bed Number 3,36,12,24
2015-08-25,1,Bed Number 1,79,12,67
2015-08-25,2,Bed Number 2,25,0,25
2015-08-25,3,Bed Number 3,87,9,78
2015-08-26,1,Bed Number 1,85,17,68
2015-08-26,2,Bed Number 2,30,20,10
2015-08-26,3,Bed Number 3,81,56,25
2015-08-27,1,Bed Number 1,46,41,5
2015-08-27,2,Bed Number 2,44,37,7
2015-08-27,3,Bed Number 3,52,39,13
2015-08-28,1,Bed Number 1,84,75,9
2015-08-28,2,Bed Number 2,51,17,34
2015-08-28,3,Bed Number 3,55,37,18
2015-08-29,1,Bed Number 1,75,65,10
2015-08-29,2,Bed Number 2,96,64,32
2015-08-29,3,Bed Number 3,10,8,2
2015-08-30,1,Bed Number 1,55,43,12
2015-08-30,2,Bed Number 2,91,8,83
2015-08-30,3,Bed Number 3,21,17,4
2015-08-31,1,Bed Number 1,82,54,28
2015-08-31,2,Bed Number 2,25,3,22
2015-08-31,3,Bed Number 3,72,7,65
2015-09-01,1,Bed Number 1,36,0,36
2015-09-01,2,Bed Number 2,90,65,25
2015-09-01,3,Bed Number 3,52,35,17
2015-09-02,1,Bed Number 1,42,22,20
2015-09-02,2,Bed Number 2,25,12,13
2015-09-02,3,Bed Number 3,100,45,55
2015-09-03,1,Bed Number 1,36,19,17
2015-09-03,2,Bed Number 2,89,86,3
2015-09-03,3,Bed Number 3,22,13,9
2015-09-04,1,Bed Number 1,28,25,3
2015-09-04,2,Bed Number 2,38,34,4
2015-09-04,3,Bed Number 3,31,24,7
2015-09-05,1,Bed Number 1,89,35,54
2015-09-05,2,Bed Number 2,74,33,41
2015-09-05,3,Bed Number 3,17,14,3
2015-09-06,1,Bed Number 1,54,33,21
2015-09-06,2,Bed Number 2,66,3,63
2015-09-06,3,Bed Number 3,65,49,16
2015-09-07,1,Bed Number 1,85,14,71
2015-09-07,2,Bed Number 2,46,29,17
2015-09-07,3,Bed Number 3,50,42,8
2015-09-08,1,Bed Number 1,62,44,18
2015-09-08,2,Bed Number 2,99,60,39
2015-09-08,3,Bed Number 3,96,52,44
2015-09-09,1,Bed Number 1,89,7,82
2015-09-09,2,Bed Number 2,97,30,67
2015-09-09,3,Bed Number 3,99,64,35
2015-09-10,1,Bed Number 1,46,8,38
2015-09-10,2,Bed Number 2,12,11,1
2015-09-10,3,Bed Number 3,31,3,28
2015-09-11,1,Bed Number 1,79,37,42
2015-09-11,2,Bed Number 2,74,62,12
2015-09-11,3,Bed Number 3,23,21,2
2015-09-12,1,Bed Number 1,21,11,10
2015-09-12,2,Bed Number 2,87,58,29
2015-09-12,3,Bed Number 3,74,12,62
2015-09-13,1,Bed Number 1,14,9,5
2015-09-13,2,Bed Number 2,39,32,7
2015-09-13,3,Bed Number 3,81,20,61
2015-09-14,1,Bed Number 1,96,8,88
2015-09-14,2,Bed Number 2,74,72,2
2015-09-14,3,Bed Number 3,87,66,21
2015-09-15,1,Bed Number 1,41,19,22
2015-09-15,2,Bed Number 2,17,5,12
2015-09-15,3,Bed Number 3,75,46,29
2015-09-16,1,Bed Number 1,13,12,1
2015-09-16,2,Bed Number 2,57,48,9
2015-09-16,3,Bed Number 3,32,16,16
2015-09-17,1,Bed Number 1,45,10,35
2015-09-17,2,Bed Number 2,65,7,58
2015-09-17,3,Bed Number 3,41,8,33
2015-09-18,1,Bed Number 1,83,4,79
2015-09-18,2,Bed Number 2,93,80,13
2015-09-18,3,Bed Number 3,16,9,7
2015-09-19,1,Bed Number 1,82,80,2
2015-09-19,2,Bed Number 2,70,58,12
2015-09-19,3,Bed Number 3,50,30,20
2015-09-20,1,Bed Number 1,34,14,20
2015-09-20,2,Bed Number 2,58,17,41
2015-09-20,3,Bed Number 3,13,7,6
2015-09-21,1,Bed Number 1,74,41,33
2015-09-21,2,Bed Number 2,51,20,31
2015-09-21,3,Bed Number 3,55,26,29
2015-09-22,1,Bed Number 1,13,2,11
2015-09-22,2,Bed Number 2,63,4,59
2015-09-22,3,Bed Number 3,90,34,56
2015-09-23,1,Bed Number 1,74,13,61
2015-09-23,2,Bed Number 2,66,29,37
2015-09-23,3,Bed Number 3,56,24,32
2015-09-24,1,Bed Number 1,95,81,14
2015-09-24,2,Bed Number 2,89,25,64
2015-09-24,3,Bed Number 3,44,23,21
2015-09-25,1,Bed Number 1,77,29,48
2015-09-25,2,Bed Number 2,48,15,33
2015-09-25,3,Bed Number 3,25,12,13
2015-09-26,1,Bed Number 1,21,15,6
2015-09-26,2,Bed Number 2,53,50,3
2015-09-26,3,Bed Number 3,16,10,6
2015-09-27,1,Bed Number 1,49,12,37
2015-09-27,2,Bed Number 2,35,13,22
2015-09-27,3,Bed Number 3,42,20,22
2015-09-28,1,Bed Number 1,36,7,29
2015-09-28,2,Bed Number 2,64,58,6
2015-09-28,3,Bed Number 3,11,8,3
2015-09-29,1,Bed Number 1,51,25,26
2015-09-29,2,Bed Number 2,79,63,16
2015-09-29,3,Bed Number 3,96,94,2
2015-09-30,1,Bed Number 1,88,74,14
2015-09-30,2,Bed Number 2,13,8,5
2015-09-30,3,Bed Number 3,59,34,25
2015-10-01,1,Bed Number 1,27,21,6
2015-10-01,2,Bed Number 2,95,2,93
2015-10-01,3,Bed Number 3,80,57,23
2015-10-02,1,Bed Number 1,24,8,16
2015-10-02,2,Bed Number 2,81,13,68
2015-10-02,3,Bed Number 3,73,13,60
2015-10-03,1,Bed Number 1,72,57,15
2015-10-03,2,Bed Number 2,76,46,30
2015-10-03,3,Bed Number 3,29,22,7
2015-10-04,1,Bed Number 1,66,41,25
2015-10-04,2,Bed Number 2,69,23,46
2015-10-04,3,Bed Number 3,25,10,15
2015-10-05,1,Bed Number 1,76,45,31
2015-10-05,2,Bed Number 2,97,19,78
2015-10-05,3,Bed Number 3,50,47,3
2015-10-06,1,Bed Number 1,48,25,23
2015-10-06,2,Bed Number 2,98,35,63
2015-10-06,3,Bed Number 3,52,20,32
2015-10-07,1,Bed Number 1,87,23,64
2015-10-07,2,Bed Number 2,38,17,21
2015-10-07,3,Bed Number 3,29,25,4
2015-10-08,1,Bed Number 1,42,27,15
2015-10-08,2,Bed Number 2,57,1,56
2015-10-08,3,Bed Number 3,65,33,32
2015-10-09,1,Bed Number 1,42,34,8
2015-10-09,2,Bed Number 2,49,19,30
2015-10-09,3,Bed Number 3,55,2,53
2015-10-10,1,Bed Number 1,32,0,32
2015-10-10,2,Bed Number 2,55,7,48
2015-10-10,3,Bed Number 3,47,22,25
2015-10-11,1,Bed Number 1,33,13,20
2015-10-11,2,Bed Number 2,83,75,8
2015-10-11,3,Bed Number 3,94,44,50
2015-10-12,1,Bed Number 1,77,33,44
2015-10-12,2,Bed Number 2,73,22,51
2015-10-12,3,Bed Number 3,59,9,50
2015-10-13,1,Bed Number 1,100,34,66
2015-10-13,2,Bed Number 2,85,45,40
2015-10-13,3,Bed Number 3,41,3,38
2015-10-14,1,Bed Number 1,88,0,88
2015-10-14,2,Bed Number 2,40,29,11
2015-10-14,3,Bed Number 3,99,98,1
2015-10-15,1,Bed Number 1,89,1,88
2015-10-15,2,Bed Number 2,45,39,6
2015-10-15,3,Bed Number 3,66,1,65
2015-10-16,1,Bed Number 1,44,33,11
2015-10-16,2,Bed Number 2,96,28,68
2015-10-16,3,Bed Number 3,98,33,65
2015-10-17,1,Bed Number 1,45,36,9
2015-10-17,2,Bed Number 2,66,29,37
2015-10-17,3,Bed Number 3,44,37,7
2015-10-18,1,Bed Number 1,62,39,23
2015-10-18,2,Bed Number 2,90,12,78
2015-10-18,3,Bed Number 3,63,24,39
2015-10-19,1,Bed Number 1,50,7,43
2015-10-19,2,Bed Number 2,29,8,21
2015-10-19,3,Bed Number 3,58,37,21
2015-10-20,1,Bed Number 1,37,34,3
2015-10-20,2,Bed Number 2,67,7,60
2015-10-20,3,Bed Number 3,85,55,30
2015-10-21,1,Bed Number 1,35,19,16
2015-10-21,2,Bed Number 2,38,37,1
2015-10-21,3,Bed Number 3,32,1,31
2015-10-22,1,Bed Number 1,87,62,25
2015-10-22,2,Bed Number 2,90,58,32
2015-10-22,3,Bed Number 3,12,3,9
2015-10-23,1,Bed Number 1,20,20,0
2015-10-23,2,Bed Number 2,69,29,40
2015-10-23,3,Bed Number 3,44,16,28
2015-10-24,1,Bed Number 1,54,16,38
2015-10-24,2,Bed Number 2,39,15,24
2015-10-24,3,Bed Number 3,87,14,73
2015-10-25,1,Bed Number 1,56,47,9
2015-10-25,2,Bed Number 2,37,25,12
2015-10-25,3,Bed Number 3,20,14,6
2015-10-26,1,Bed Number 1,94,12,82
2015-10-26,2,Bed Number 2,83,27,56
2015-10-26,3,Bed Number 3,57,22,35
2015-10-27,1,Bed Number 1,83,41,42
2015-10-27,2,Bed Number 2,75,4,71
2015-10-27,3,Bed Number 3,32,27,5
2015-10-28,1,Bed Number 1,87,78,9
2015-10-28,2,Bed Number 2,14,14,0
2015-10-28,3,Bed Number 3,27,20,7
2015-10-29,1,Bed Number 1,58,55,3
2015-10-29,2,Bed Number 2,80,14,66
2015-10-29,3,Bed Number 3,89,21,68
2015-10-30,1,Bed Number 1,47,35,12
2015-10-30,2,Bed Number 2,81,49,32
2015-10-30,3,Bed Number 3,86,58,28
2015-10-31,1,Bed Number 1,11,3,8
2015-10-31,2,Bed Number 2,88,80,8
2015-10-31,3,Bed Number 3,80,22,58
2015-11-01,1,Bed Number 1,62,31,31
2015-11-01,2,Bed Number 2,30,25,5
2015-11-01,3,Bed Number 3,54,16,38
2015-11-02,1,Bed Number 1,36,10,26
2015-11-02,2,Bed Number 2,57,46,11
2015-11-02,3,Bed Number 3,97,63,34
2015-11-03,1,Bed Number 1,81,80,1
2015-11-03,2,Bed Number 2,75,33,42
2015-11-03,3,Bed Number 3,87,59,28
2015-11-04,1,Bed Number 1,86,20,66
2015-11-04,2,Bed Number 2,78,48,30
2015-11-04,3,Bed Number 3,56,14,42
2015-11-05,1,Bed Number 1,22,12,10
2015-11-05,2,Bed Number 2,23,11,12
2015-11-05,3,Bed Number 3,10,8,2
2015-11-06,1,Bed Number 1,67,6,61
2015-11-06,2,Bed Number 2,52,8,44
2015-11-06,3,Bed Number 3,51,29,22
2015-11-07,1,Bed Number 1,28,26,2
2015-11-07,2,Bed Number 2,73,67,6
2015-11-07,3,Bed Number 3,39,23,16
2015-11-08,1,Bed Number 1,26,5,21
2015-11-08,2,Bed Number 2,48,29,19
2015-11-08,3,Bed Number 3,33,27,6
2015-11-09,1,Bed Number 1,44,40,4
2015-11-09,2,Bed Number 2,32,15,17
2015-11-09,3,Bed Number 3,77,10,67
2015-11-10,1,Bed Number 1,37,30,7
2015-11-10,2,Bed Number 2,10,7,3
2015-11-10,3,Bed Number 3,69,15,54
2015-11-11,1,Bed Number 1,75,53,22
2015-11-11,2,Bed Number 2,71,26,45
2015-11-11,3,Bed Number 3,52,32,20
2015-11-12,1,Bed Number 1,80,72,8
2015-11-12,2,Bed Number 2,100,92,8
2015-11-12,3,Bed Number 3,60,26,34
2015-11-13,1,Bed Number 1,32,18,14
2015-11-13,2,Bed Number 2,64,27,37
2015-11-13,3,Bed Number 3,34,12,22
2015-11-14,1,Bed Number 1,100,15,85
2015-11-14,2,Bed Number 2,67,13,54
2015-11-14,3,Bed Number 3,17,1,16
2015-11-15,1,Bed Number 1,77,35,42
2015-11-15,2,Bed Number 2,40,15,25
2015-11-15,3,Bed Number 3,71,70,1
2015-11-16,1,Bed Number 1,99,45,54
2015-11-16,2,Bed Number 2,69,65,4
2015-11-16,3,Bed Number 3,37,0,37
2015-11-17,1,Bed Number 1,71,62,9
2015-11-17,2,Bed Number 2,16,4,12
2015-11-17,3,Bed Number 3,39,27,12
2015-11-18,1,Bed Number 1,34,29,5
2015-11-18,2,Bed Number 2,96,44,52
2015-11-18,3,Bed Number 3,69,48,21
2015-11-19,1,Bed Number 1,36,35,1
2015-11-19,2,Bed Number 2,16,6,10
2015-11-19,3,Bed Number 3,93,52,41
2015-11-20,1,Bed Number 1,77,36,41
2015-11-20,2,Bed Number 2,46,23,23
2015-11-20,3,Bed Number 3,48,21,27
2015-11-21,1,Bed Number 1,59,16,43
2015-11-21,2,Bed Number 2,63,6,57
2015-11-21,3,Bed Number 3,74,2,72
2015-11-22,1,Bed Number 1,34,30,4
2015-11-22,2,Bed Number 2,15,4,11
2015-11-22,3,Bed Number 3,10,7,3
2015-11-23,1,Bed Number 1,65,35,30
2015-11-23,2,Bed Number 2,69,23,46
2015-11-23,3,Bed Number 3,32,4,28
2015-11-24,1,Bed Number 1,79,67,12
2015-11-24,2,Bed Number 2,39,25,14
2015-11-24,3,Bed Number 3,68,32,36
2015-11-25,1,Bed Number 1,24,9,15
2015-11-25,2,Bed Number 2,89,43,46
2015-11-25,3,Bed Number 3,56,43,13
2015-11-26,1,Bed Number 1,22,17,5
2015-11-26,2,Bed Number 2,83,47,36
2015-11-26,3,Bed Number 3,65,11,54
2015-11-27,1,Bed Number 1,78,19,59
2015-11-27,2,Bed Number 2,42,6,36
2015-11-27,3,Bed Number 3,32,3,29
2015-11-28,1,Bed Number 1,65,30,35
2015-11-28,2,Bed Number 2,37,6,31
2015-11-28,3,Bed Number 3,34,31,3
2015-11-29,1,Bed Number 1,16,11,5
2015-11-29,2,Bed Number 2,25,0,25
2015-11-29,3,Bed Number 3,39,22,17
2015-11-30,1,Bed Number 1,87,30,57
2015-11-30,2,Bed Number 2,81,49,32
2015-11-30,3,Bed Number 3,19,12,7
2015-12-01,1,Bed Number 1,24,15,9
2015-12-01,2,Bed Number 2,64,43,21
2015-12-01,3,Bed Number 3,26,6,20
2015-12-02,1,Bed Number 1,42,36,6
2015-12-02,2,Bed Number 2,10,6,4
2015-12-02,3,Bed Number 3,29,22,7
2015-12-03,1,Bed Number 1,42,33,9
2015-12-03,2,Bed Number 2,39,33,6
2015-12-03,3,Bed Number 3,83,83,0
2015-12-04,1,Bed Number 1,74,24,50
2015-12-04,2,Bed Number 2,47,9,38
2015-12-04,3,Bed Number 3,52,14,38
2015-12-05,1,Bed Number 1,68,25,43
2015-12-05,2,Bed Number 2,74,1,73
2015-12-05,3,Bed Number 3,93,16,77
2015-12-06,1,Bed Number 1,11,0,11
2015-12-06,2,Bed Number 2,72,19,53
2015-12-06,3,Bed Number 3,38,7,31
2015-12-07,1,Bed Number 1,56,9,47
2015-12-07,2,Bed Number 2,10,7,3
2015-12-07,3,Bed Number 3,57,55,2
2015-12-08,1,Bed Number 1,21,1,20
2015-12-08,2,Bed Number 2,16,3,13
2015-12-08,3,Bed Number 3,12,3,9
2015-12-09,1,Bed Number 1,51,32,19
2015-12-09,2,Bed Number 2,44,23,21
2015-12-09,3,Bed Number 3,20,0,20
2015-12-10,1,Bed Number 1,71,65,6
2015-12-10,2,Bed Number 2,24,21,3
2015-12-10,3,Bed Number 3,48,28,20
2015-12-11,1,Bed Number 1,98,85,13
2015-12-11,2,Bed Number 2,34,21,13
2015-12-11,3,Bed Number 3,43,37,6
2015-12-12,1,Bed Number 1,43,24,19
2015-12-12,2,Bed Number 2,25,11,14
2015-12-12,3,Bed Number 3,92,2,90
2015-12-13,1,Bed Number 1,72,19,53
2015-12-13,2,Bed Number 2,92,26,66
2015-12-13,3,Bed Number 3,73,38,35
2015-12-14,1,Bed Number 1,93,82,11
2015-12-14,2,Bed Number 2,61,2,59
2015-12-14,3,Bed Number 3,71,47,24
2015-12-15,1,Bed Number 1,66,58,8
2015-12-15,2,Bed Number 2,66,43,23
2015-12-15,3,Bed Number 3,78,26,52
2015-12-16,1,Bed Number 1,49,12,37
2015-12-16,2,Bed Number 2,38,26,12
2015-12-16,3,Bed Number 3,51,9,42
2015-12-17,1,Bed Number 1,57,2,55
2015-12-17,2,Bed Number 2,67,52,15
2015-12-17,3,Bed Number 3,16,15,1
2015-12-18,1,Bed Number 1,62,49,13
2015-12-18,2,Bed Number 2,33,8,25
2015-12-18,3,Bed Number 3,63,51,12
2015-12-19,1,Bed Number 1,18,4,14
2015-12-19,2,Bed Number 2,19,14,5
2015-12-19,3,Bed Number 3,92,86,6
2015-12-20,1,Bed Number 1,13,7,6
2015-12-20,2,Bed Number 2,62,61,1
2015-12-20,3,Bed Number 3,94,93,1
2015-12-21,1,Bed Number 1,40,6,34
2015-12-21,2,Bed Number 2,83,4,79
2015-12-21,3,Bed Number 3,52,44,8
2015-12-22,1,Bed Number 1,40,21,19
2015-12-22,2,Bed Number 2,10,5,5
2015-12-22,3,Bed Number 3,52,29,23
2015-12-23,1,Bed Number 1,39,21,18
2015-12-23,2,Bed Number 2,26,23,3
2015-12-23,3,Bed Number 3,80,18,62
2015-12-24,1,Bed Number 1,41,36,5
2015-12-24,2,Bed Number 2,56,6,50
2015-12-24,3,Bed Number 3,33,2,31
2015-12-25,1,Bed Number 1,13,2,11
2015-12-25,2,Bed Number 2,26,21,5
2015-12-25,3,Bed Number 3,77,73,4
2015-12-26,1,Bed Number 1,91,5,86
2015-12-26,2,Bed Number 2,31,16,15
2015-12-26,3,Bed Number 3,67,30,37
2015-12-27,1,Bed Number 1,67,46,21
2015-12-27,2,Bed Number 2,76,35,41
2015-12-27,3,Bed Number 3,99,92,7
2015-12-28,1,Bed Number 1,27,23,4
2015-12-28,2,Bed Number 2,63,21,42
2015-12-28,3,Bed Number 3,97,4,93
2015-12-29,1,Bed Number 1,17,17,0
2015-12-29,2,Bed Number 2,27,17,10
2015-12-29,3,Bed Number 3,43,30,13
2015-12-30,1,Bed Number 1,10,10,0
2015-12-30,2,Bed Number 2,60,4,56
2015-12-30,3,Bed Number 3,35,25,10
2015-12-31,1,Bed Number 1,27,3,24
2015-12-31,2,Bed Number 2,63,30,33
2015-12-31,3,Bed Number 3,59,21,38
2016-01-01,1,Bed Number 1,79,7,72
2016-01-01,2,Bed Number 2,82,17,65
2016-01-01,3,Bed Number 3,80,19,61
2016-01-02,1,Bed Number 1,15,5,10
2016-01-02,2,Bed Number 2,62,56,6
2016-01-02,3,Bed Number 3,47,36,11
2016-01-03,1,Bed Number 1,99,95,4
2016-01-03,2,Bed Number 2,52,39,13
2016-01-03,3,Bed Number 3,31,29,2
2016-01-04,1,Bed Number 1,25,23,2
2016-01-04,2,Bed Number 2,97,5,92
2016-01-04,3,Bed Number 3,40,27,13
2016-01-05,1,Bed Number 1,18,0,18
2016-01-05,2,Bed Number 2,21,16,5
2016-01-05,3,Bed Number 3,68,10,58
2016-01-06,1,Bed Number 1,33,27,6
2016-01-06,2,Bed Number 2,51,42,9
2016-01-06,3,Bed Number 3,84,24,60
2016-01-07,1,Bed Number 1,34,20,14
2016-01-07,2,Bed Number 2,49,30,19
2016-01-07,3,Bed Number 3,73,11,62
2016-01-08,1,Bed Number 1,57,54,3
2016-01-08,2,Bed Number 2,49,31,18
2016-01-08,3,Bed Number 3,72,14,58
2016-01-09,1,Bed Number 1,90,84,6
2016-01-09,2,Bed Number 2,96,90,6
2016-01-09,3,Bed Number 3,25,16,9
2016-01-10,1,Bed Number 1,36,34,2
2016-01-10,2,Bed Number 2,56,46,10
2016-01-10,3,Bed Number 3,59,1,58
2016-01-11,1,Bed Number 1,100,89,11
2016-01-11,2,Bed Number 2,72,1,71
2016-01-11,3,Bed Number 3,68,12,56
2016-01-12,1,Bed Number 1,39,38,1
2016-01-12,2,Bed Number 2,91,50,41
2016-01-12,3,Bed Number 3,21,13,8
2016-01-13,1,Bed Number 1,21,15,6
2016-01-13,2,Bed Number 2,71,29,42
2016-01-13,3,Bed Number 3,41,10,31
2016-01-14,1,Bed Number 1,18,1,17
2016-01-14,2,Bed Number 2,80,38,42
2016-01-14,3,Bed Number 3,91,39,52
2016-01-15,1,Bed Number 1,38,28,10
2016-01-15,2,Bed Number 2,77,61,16
2016-01-15,3,Bed Number 3,33,33,0
2016-01-16,1,Bed Number 1,22,3,19
2016-01-16,2,Bed Number 2,53,42,11
2016-01-16,3,Bed Number 3,43,2,41
2016-01-17,1,Bed Number 1,13,6,7
2016-01-17,2,Bed Number 2,57,37,20
2016-01-17,3,Bed Number 3,65,47,18
2016-01-18,1,Bed Number 1,54,37,17
2016-01-18,2,Bed Number 2,76,15,61
2016-01-18,3,Bed Number 3,67,49,18
2016-01-19,1,Bed Number 1,45,32,13
2016-01-19,2,Bed Number 2,63,28,35
2016-01-19,3,Bed Number 3,77,53,24
2016-01-20,1,Bed Number 1,10,4,6
2016-01-20,2,Bed Number 2,19,17,2
2016-01-20,3,Bed Number 3,24,21,3
2016-01-21,1,Bed Number 1,50,40,10
2016-01-21,2,Bed Number 2,62,24,38
2016-01-21,3,Bed Number 3,71,43,28
2016-01-22,1,Bed Number 1,69,64,5
2016-01-22,2,Bed Number 2,74,72,2
2016-01-22,3,Bed Number 3,68,18,50
2016-01-23,1,Bed Number 1,77,53,24
2016-01-23,2,Bed Number 2,87,26,61
2016-01-23,3,Bed Number 3,16,2,14
2016-01-24,1,Bed Number 1,10,4,6
2016-01-24,2,Bed Number 2,35,29,6
2016-01-24,3,Bed Number 3,14,0,14
2016-01-25,1,Bed Number 1,47,32,15
2016-01-25,2,Bed Number 2,34,30,4
2016-01-25,3,Bed Number 3,26,12,14
2016-01-26,1,Bed Number 1,33,21,12
2016-01-26,2,Bed Number 2,67,65,2
2016-01-26,3,Bed Number 3,64,1,63
2016-01-27,1,Bed Number 1,90,59,31
2016-01-27,2,Bed Number 2,63,7,56
2016-01-27,3,Bed Number 3,57,30,27
2016-01-28,1,Bed Number 1,100,10,90
2016-01-28,2,Bed Number 2,61,59,2
2016-01-28,3,Bed Number 3,39,7,32
2016-01-29,1,Bed Number 1,34,13,21
2016-01-29,2,Bed Number 2,60,7,53
2016-01-29,3,Bed Number 3,60,15,45
2016-01-30,1,Bed Number 1,64,38,26
2016-01-30,2,Bed Number 2,88,64,24
2016-01-30,3,Bed Number 3,37,33,4
2016-01-31,1,Bed Number 1,57,34,23
2016-01-31,2,Bed Number 2,60,35,25
2016-01-31,3,Bed Number 3,16,0,16
2016-02-01,1,Bed Number 1,45,37,8
2016-02-01,2,Bed Number 2,18,14,4
2016-02-01,3,Bed Number 3,58,35,23
2016-02-02,1,Bed Number 1,30,26,4
2016-02-02,2,Bed Number 2,71,49,22
2016-02-02,3,Bed Number 3,79,24,55
2016-02-03,1,Bed Number 1,18,1,17
2016-02-03,2,Bed Number 2,98,31,67
2016-02-03,3,Bed Number 3,42,29,13
2016-02-04,1,Bed Number 1,19,9,10
2016-02-04,2,Bed Number 2,67,17,50
2016-02-04,3,Bed Number 3,54,21,33
2016-02-05,1,Bed Number 1,89,25,64
2016-02-05,2,Bed Number 2,31,26,5
2016-02-05,3,Bed Number 3,26,1,25
2016-02-06,1,Bed Number 1,48,10,38
2016-02-06,2,Bed Number 2,22,11,11
2016-02-06,3,Bed Number 3,76,66,10
2016-02-07,1,Bed Number 1,56,31,25
2016-02-07,2,Bed Number 2,32,20,12
2016-02-07,3,Bed Number 3,47,43,4
2016-02-08,1,Bed Number 1,41,38,3
2016-02-08,2,Bed Number 2,44,5,39
2016-02-08,3,Bed Number 3,53,49,4
2016-02-09,1,Bed Number 1,51,45,6
2016-02-09,2,Bed Number 2,97,81,16
2016-02-09,3,Bed Number 3,48,0,48
2016-02-10,1,Bed Number 1,32,21,11
2016-02-10,2,Bed Number 2,70,45,25
2016-02-10,3,Bed Number 3,14,8,6
2016-02-11,1,Bed Number 1,68,57,11
2016-02-11,2,Bed Number 2,12,0,12
2016-02-11,3,Bed Number 3,99,19,80
2016-02-12,1,Bed Number 1,55,6,49
2016-02-12,2,Bed Number 2,93,66,27
2016-02-12,3,Bed Number 3,44,15,29
2016-02-13,1,Bed Number 1,92,40,52
2016-02-13,2,Bed Number 2,22,18,4
2016-02-13,3,Bed Number 3,48,29,19
2016-02-14,1,Bed Number 1,84,51,33
2016-02-14,2,Bed Number 2,38,27,11
2016-02-14,3,Bed Number 3,67,23,44
2016-02-15,1,Bed Number 1,49,6,43
2016-02-15,2,Bed Number 2,77,52,25
2016-02-15,3,Bed Number 3,85,52,33
2016-02-16,1,Bed Number 1,50,34,16
2016-02-16,2,Bed Number 2,63,49,14
2016-02-16,3,Bed Number 3,24,2,22
2016-02-17,1,Bed Number 1,78,71,7
2016-02-17,2,Bed Number 2,23,0,23
2016-02-17,3,Bed Number 3,29,14,15
2016-02-18,1,Bed Number 1,53,23,30
2016-02-18,2,Bed Number 2,67,26,41
2016-02-18,3,Bed Number 3,73,55,18
2016-02-19,1,Bed Number 1,38,36,2
2016-02-19,2,Bed Number 2,37,18,19
2016-02-19,3,Bed Number 3,32,32,0
2016-02-20,1,Bed Number 1,44,33,11
2016-02-20,2,Bed Number 2,83,9,74
2016-02-20,3,Bed Number 3,46,34,12
2016-02-21,1,Bed Number 1,19,5,14
2016-02-21,2,Bed Number 2,48,41,7
2016-02-21,3,Bed Number 3,30,20,10
2016-02-22,1,Bed Number 1,69,35,34
2016-02-22,2,Bed Number 2,46,17,29
2016-02-22,3,Bed Number 3,37,13,24
2016-02-23,1,Bed Number 1,23,22,1
2016-02-23,2,Bed Number 2,43,24,19
2016-02-23,3,Bed Number 3,25,24,1
2016-02-24,1,Bed Number 1,98,64,34
2016-02-24,2,Bed Number 2,47,26,21
2016-02-24,3,Bed Number 3,13,10,3
2016-02-25,1,Bed Number 1,23,13,10
2016-02-25,2,Bed Number 2,61,4,57
2016-02-25,3,Bed Number 3,16,12,4
2016-02-26,1,Bed Number 1,96,96,0
2016-02-26,2,Bed Number 2,56,12,44
2016-02-26,3,Bed Number 3,62,11,51
2016-02-27,1,Bed Number 1,50,25,25
2016-02-27,2,Bed Number 2,87,12,75
2016-02-27,3,Bed Number 3,97,62,35
2016-02-28,1,Bed Number 1,81,67,14
2016-02-28,2,Bed Number 2,52,5,47
2016-02-28,3,Bed Number 3,67,57,10
2016-02-29,1,Bed Number 1,70,12,58
2016-02-29,2,Bed Number 2,93,10,83
2016-02-29,3,Bed Number 3,50,5,45
2016-03-01,1,Bed Number 1,61,9,52
2016-03-01,2,Bed Number 2,15,9,6
2016-03-01,3,Bed Number 3,76,65,11
2016-03-02,1,Bed Number 1,97,68,29
2016-03-02,2,Bed Number 2,32,21,11
2016-03-02,3,Bed Number 3,49,3,46
2016-03-03,1,Bed Number 1,91,66,25
2016-03-03,2,Bed Number 2,42,31,11
2016-03-03,3,Bed Number 3,62,35,27
2016-03-04,1,Bed Number 1,84,60,24
2016-03-04,2,Bed Number 2,77,3,74
2016-03-04,3,Bed Number 3,85,11,74
2016-03-05,1,Bed Number 1,47,44,3
2016-03-05,2,Bed Number 2,82,26,56
2016-03-05,3,Bed Number 3,67,47,20
2016-03-06,1,Bed Number 1,50,31,19
2016-03-06,2,Bed Number 2,80,47,33
2016-03-06,3,Bed Number 3,43,8,35
2016-03-07,1,Bed Number 1,72,49,23
2016-03-07,2,Bed Number 2,30,30,0
2016-03-07,3,Bed Number 3,58,8,50
2016-03-08,1,Bed Number 1,100,28,72
2016-03-08,2,Bed Number 2,85,84,1
2016-03-08,3,Bed Number 3,58,27,31
2016-03-09,1,Bed Number 1,98,29,69
2016-03-09,2,Bed Number 2,95,63,32
2016-03-09,3,Bed Number 3,46,12,34
2016-03-10,1,Bed Number 1,73,7,66
2016-03-10,2,Bed Number 2,38,1,37
2016-03-10,3,Bed Number 3,81,43,38
2016-03-11,1,Bed Number 1,45,10,35
2016-03-11,2,Bed Number 2,24,15,9
2016-03-11,3,Bed Number 3,81,1,80
2016-03-12,1,Bed Number 1,83,77,6
2016-03-12,2,Bed Number 2,15,5,10
2016-03-12,3,Bed Number 3,45,41,4
2016-03-13,1,Bed Number 1,69,67,2
2016-03-13,2,Bed Number 2,42,41,1
2016-03-13,3,Bed Number 3,55,31,24
2016-03-14,1,Bed Number 1,42,14,28
2016-03-14,2,Bed Number 2,90,45,45
2016-03-14,3,Bed Number 3,76,20,56
2016-03-15,1,Bed Number 1,38,5,33
2016-03-15,2,Bed Number 2,28,8,20
2016-03-15,3,Bed Number 3,56,45,11
2016-03-16,1,Bed Number 1,46,4,42
2016-03-16,2,Bed Number 2,19,18,1
2016-03-16,3,Bed Number 3,27,20,7
2016-03-17,1,Bed Number 1,36,19,17
2016-03-17,2,Bed Number 2,36,18,18
2016-03-17,3,Bed Number 3,21,7,14
2016-03-18,1,Bed Number 1,45,28,17
2016-03-18,2,Bed Number 2,63,9,54
2016-03-18,3,Bed Number 3,88,17,71
2016-03-19,1,Bed Number 1,77,33,44
2016-03-19,2,Bed Number 2,57,8,49
2016-03-19,3,Bed Number 3,10,1,9
2016-03-20,1,Bed Number 1,73,73,0
2016-03-20,2,Bed Number 2,84,47,37
2016-03-20,3,Bed Number 3,54,46,8
2016-03-21,1,Bed Number 1,19,0,19
2016-03-21,2,Bed Number 2,44,36,8
2016-03-21,3,Bed Number 3,19,5,14
2016-03-22,1,Bed Number 1,17,15,2
2016-03-22,2,Bed Number 2,46,9,37
2016-03-22,3,Bed Number 3,29,0,29
2016-03-23,1,Bed Number 1,72,19,53
2016-03-23,2,Bed Number 2,35,12,23
2016-03-23,3,Bed Number 3,74,58,16
2016-03-24,1,Bed Number 1,92,78,14
2016-03-24,2,Bed Number 2,65,61,4
2016-03-24,3,Bed Number 3,71,69,2
2016-03-25,1,Bed Number 1,72,38,34
2016-03-25,2,Bed Number 2,35,34,1
2016-03-25,3,Bed Number 3,79,42,37
2016-03-26,1,Bed Number 1,96,38,58
2016-03-26,2,Bed Number 2,36,29,7
2016-03-26,3,Bed Number 3,75,23,52
2016-03-27,1,Bed Number 1,39,18,21
2016-03-27,2,Bed Number 2,46,16,30
2016-03-27,3,Bed Number 3,90,75,15
2016-03-28,1,Bed Number 1,92,22,70
2016-03-28,2,Bed Number 2,46,2,44
2016-03-28,3,Bed Number 3,72,45,27
2016-03-29,1,Bed Number 1,82,16,66
2016-03-29,2,Bed Number 2,97,46,51
2016-03-29,3,Bed Number 3,75,10,65
2016-03-30,1,Bed Number 1,44,16,28
2016-03-30,2,Bed Number 2,11,4,7
2016-03-30,3,Bed Number 3,64,62,2
2016-03-31,1,Bed Number 1,69,60,9
2016-03-31,2,Bed Number 2,27,24,3
2016-03-31,3,Bed Number 3,36,35,1
2016-04-01,1,Bed Number 1,59,54,5
2016-04-01,2,Bed Number 2,27,13,14
2016-04-01,3,Bed Number 3,67,52,15
2016-04-02,1,Bed Number 1,23,11,12
2016-04-02,2,Bed Number 2,95,72,23
2016-04-02,3,Bed Number 3,23,14,9
2016-04-03,1,Bed Number 1,86,35,51
2016-04-03,2,Bed Number 2,82,62,20
2016-04-03,3,Bed Number 3,16,4,12
2016-04-04,1,Bed Number 1,91,67,24
2016-04-04,2,Bed Number 2,73,66,7
2016-04-04,3,Bed Number 3,62,5,57
2016-04-05,1,Bed Number 1,92,77,15
2016-04-05,2,Bed Number 2,29,15,14
2016-04-05,3,Bed Number 3,23,2,21
2016-04-06,1,Bed Number 1,100,77,23
2016-04-06,2,Bed Number 2,77,68,9
2016-04-06,3,Bed Number 3,42,42,0
2016-04-07,1,Bed Number 1,74,53,21
2016-04-07,2,Bed Number 2,84,40,44
2016-04-07,3,Bed Number 3,92,6,86
2016-04-08,1,Bed Number 1,92,8,84
2016-04-08,2,Bed Number 2,73,48,25
2016-04-08,3,Bed Number 3,18,13,5
2016-04-09,1,Bed Number 1,99,74,25
2016-04-09,2,Bed Number 2,54,47,7
2016-04-09,3,Bed Number 3,90,44,46
2016-04-10,1,Bed Number 1,91,40,51
2016-04-10,2,Bed Number 2,86,78,8
2016-04-10,3,Bed Number 3,50,1,49
2016-04-11,1,Bed Number 1,79,73,6
2016-04-11,2,Bed Number 2,48,8,40
2016-04-11,3,Bed Number 3,64,38,26
2016-04-12,1,Bed Number 1,57,9,48
2016-04-12,2,Bed Number 2,11,1,10
2016-04-12,3,Bed Number 3,93,87,6
2016-04-13,1,Bed Number 1,24,24,0
2016-04-13,2,Bed Number 2,27,12,15
2016-04-13,3,Bed Number 3,23,7,16
2016-04-14,1,Bed Number 1,72,26,46
2016-04-14,2,Bed Number 2,24,1,23
2016-04-14,3,Bed Number 3,56,4,52
2016-04-15,1,Bed Number 1,81,30,51
2016-04-15,2,Bed Number 2,48,39,9
2016-04-15,3,Bed Number 3,48,39,9
2016-04-16,1,Bed Number 1,63,33,30
2016-04-16,2,Bed Number 2,89,38,51
2016-04-16,3,Bed Number 3,17,15,2
2016-04-17,1,Bed Number 1,18,11,7
2016-04-17,2,Bed Number 2,62,21,41
2016-04-17,3,Bed Number 3,53,14,39
2016-04-18,1,Bed Number 1,34,21,13
2016-04-18,2,Bed Number 2,49,3,46
2016-04-18,3,Bed Number 3,59,3,56
2016-04-19,1,Bed Number 1,13,13,0
2016-04-19,2,Bed Number 2,42,13,29
2016-04-19,3,Bed Number 3,20,16,4
2016-04-20,1,Bed Number 1,19,2,17
2016-04-20,2,Bed Number 2,16,7,9
2016-04-20,3,Bed Number 3,43,17,26
2016-04-21,1,Bed Number 1,100,85,15
2016-04-21,2,Bed Number 2,74,33,41
2016-04-21,3,Bed Number 3,24,20,4
2016-04-22,1,Bed Number 1,45,43,2
2016-04-22,2,Bed Number 2,76,25,51
2016-04-22,3,Bed Number 3,31,30,1
2016-04-23,1,Bed Number 1,15,10,5
2016-04-23,2,Bed Number 2,54,17,37
2016-04-23,3,Bed Number 3,34,27,7
2016-04-24,1,Bed Number 1,99,63,36
2016-04-24,2,Bed Number 2,13,5,8
2016-04-24,3,Bed Number 3,68,52,16
2016-04-25,1,Bed Number 1,96,76,20
2016-04-25,2,Bed Number 2,68,60,8
2016-04-25,3,Bed Number 3,35,12,23
2016-04-26,1,Bed Number 1,54,11,43
2016-04-26,2,Bed Number 2,79,24,55
2016-04-26,3,Bed Number 3,45,4,41
2016-04-27,1,Bed Number 1,47,9,38
2016-04-27,2,Bed Number 2,14,8,6
2016-04-27,3,Bed Number 3,61,19,42
2016-04-28,1,Bed Number 1,61,52,9
2016-04-28,2,Bed Number 2,47,47,0
2016-04-28,3,Bed Number 3,23,4,19
2016-04-29,1,Bed Number 1,33,31,2
2016-04-29,2,Bed Number 2,85,8,77
2016-04-29,3,Bed Number 3,75,37,38
2016-04-30,1,Bed Number 1,62,39,23
2016-04-30,2,Bed Number 2,13,10,3
2016-04-30,3,Bed Number 3,54,31,23
2016-05-01,1,Bed Number 1,47,39,8
2016-05-01,2,Bed Number 2,87,3,84
2016-05-01,3,Bed Number 3,64,2,62
2016-05-02,1,Bed Number 1,27,12,15
2016-05-02,2,Bed Number 2,49,20,29
2016-05-02,3,Bed Number 3,91,11,80
2016-05-03,1,Bed Number 1,28,16,12
2016-05-03,2,Bed Number 2,58,37,21
2016-05-03,3,Bed Number 3,81,14,67
2016-05-04,1,Bed Number 1,92,8,84
2016-05-04,2,Bed Number 2,64,64,0
2016-05-04,3,Bed Number 3,60,3,57
2016-05-05,1,Bed Number 1,33,2,31
2016-05-05,2,Bed Number 2,29,18,11
2016-05-05,3,Bed Number 3,68,44,24
2016-05-06,1,Bed Number 1,68,50,18
2016-05-06,2,Bed Number 2,71,45,26
2016-05-06,3,Bed Number 3,58,6,52
2016-05-07,1,Bed Number 1,82,77,5
2016-05-07,2,Bed Number 2,12,1,11
2016-05-07,3,Bed Number 3,85,3,82
2016-05-08,1,Bed Number 1,14,4,10
2016-05-08,2,Bed Number 2,36,7,29
2016-05-08,3,Bed Number 3,82,56,26
2016-05-09,1,Bed Number 1,88,51,37
2016-05-09,2,Bed Number 2,25,3,22
2016-05-09,3,Bed Number 3,30,16,14
2016-05-10,1,Bed Number 1,74,64,10
2016-05-10,2,Bed Number 2,55,53,2
2016-05-10,3,Bed Number 3,15,3,12
2016-05-11,1,Bed Number 1,31,24,7
2016-05-11,2,Bed Number 2,39,14,25
2016-05-11,3,Bed Number 3,99,25,74
2016-05-12,1,Bed Number 1,25,6,19
2016-05-12,2,Bed Number 2,45,38,7
2016-05-12,3,Bed Number 3,71,56,15
2016-05-13,1,Bed Number 1,16,14,2
2016-05-13,2,Bed Number 2,44,28,16
2016-05-13,3,Bed Number 3,54,7,47
2016-05-14,1,Bed Number 1,66,44,22
2016-05-14,2,Bed Number 2,68,28,40
2016-05-14,3,Bed Number 3,20,4,16
2016-05-15,1,Bed Number 1,63,18,45
2016-05-15,2,Bed Number 2,85,59,26
2016-05-15,3,Bed Number 3,55,42,13
2016-05-16,1,Bed Number 1,77,38,39
2016-05-16,2,Bed Number 2,54,27,27
2016-05-16,3,Bed Number 3,22,2,20
2016-05-17,1,Bed Number 1,70,13,57
2016-05-17,2,Bed Number 2,25,25,0
2016-05-17,3,Bed Number 3,90,28,62
2016-05-18,1,Bed Number 1,72,43,29
2016-05-18,2,Bed Number 2,38,12,26
2016-05-18,3,Bed Number 3,31,11,20
2016-05-19,1,Bed Number 1,35,6,29
2016-05-19,2,Bed Number 2,88,11,77
2016-05-19,3,Bed Number 3,85,81,4
2016-05-20,1,Bed Number 1,38,19,19
2016-05-20,2,Bed Number 2,58,30,28
2016-05-20,3,Bed Number 3,57,20,37
2016-05-21,1,Bed Number 1,62,16,46
2016-05-21,2,Bed Number 2,34,15,19
2016-05-21,3,Bed Number 3,99,14,85
2016-05-22,1,Bed Number 1,15,15,0
2016-05-22,2,Bed Number 2,86,64,22
2016-05-22,3,Bed Number 3,46,16,30
2016-05-23,1,Bed Number 1,64,5,59
2016-05-23,2,Bed Number 2,89,2,87
2016-05-23,3,Bed Number 3,91,8,83
2016-05-24,1,Bed Number 1,94,64,30
2016-05-24,2,Bed Number 2,60,31,29
2016-05-24,3,Bed Number 3,76,21,55
2016-05-25,1,Bed Number 1,90,60,30
2016-05-25,2,Bed Number 2,10,1,9
2016-05-25,3,Bed Number 3,35,25,10
2016-05-26,1,Bed Number 1,49,25,24
2016-05-26,2,Bed Number 2,30,11,19
2016-05-26,3,Bed Number 3,98,53,45
2016-05-27,1,Bed Number 1,11,8,3
2016-05-27,2,Bed Number 2,43,30,13
2016-05-27,3,Bed Number 3,42,5,37
2016-05-28,1,Bed Number 1,21,2,19
2016-05-28,2,Bed Number 2,35,13,22
2016-05-28,3,Bed Number 3,17,9,8
2016-05-29,1,Bed Number 1,61,0,61
2016-05-29,2,Bed Number 2,89,30,59
2016-05-29,3,Bed Number 3,90,66,24
2016-05-30,1,Bed Number 1,13,9,4
2016-05-30,2,Bed Number 2,97,88,9
2016-05-30,3,Bed Number 3,11,0,11
2016-05-31,1,Bed Number 1,96,87,9
2016-05-31,2,Bed Number 2,60,14,46
2016-05-31,3,Bed Number 3,66,43,23
2016-06-01,1,Bed Number 1,61,51,10
2016-06-01,2,Bed Number 2,40,32,8
2016-06-01,3,Bed Number 3,51,49,2
2016-06-02,1,Bed Number 1,98,95,3
2016-06-02,2,Bed Number 2,72,20,52
2016-06-02,3,Bed Number 3,87,70,17
2016-06-03,1,Bed Number 1,34,0,34
2016-06-03,2,Bed Number 2,90,1,89
2016-06-03,3,Bed Number 3,74,47,27
2016-06-04,1,Bed Number 1,43,8,35
2016-06-04,2,Bed Number 2,92,82,10
2016-06-04,3,Bed Number 3,12,0,12
2016-06-05,1,Bed Number 1,75,21,54
2016-06-05,2,Bed Number 2,77,46,31
2016-06-05,3,Bed Number 3,45,18,27
2016-06-06,1,Bed Number 1,13,1,12
2016-06-06,2,Bed Number 2,56,5,51
2016-06-06,3,Bed Number 3,97,71,26
2016-06-07,1,Bed Number 1,87,47,40
2016-06-07,2,Bed Number 2,59,15,44
2016-06-07,3,Bed Number 3,39,39,0
2016-06-08,1,Bed Number 1,15,6,9
2016-06-08,2,Bed Number 2,58,55,3
2016-06-08,3,Bed Number 3,18,1,17
2016-06-09,1,Bed Number 1,90,26,64
2016-06-09,2,Bed Number 2,73,48,25
2016-06-09,3,Bed Number 3,100,46,54
2016-06-10,1,Bed Number 1,77,48,29
2016-06-10,2,Bed Number 2,62,44,18
2016-06-10,3,Bed Number 3,87,62,25
2016-06-11,1,Bed Number 1,64,61,3
2016-06-11,2,Bed Number 2,10,0,10
2016-06-11,3,Bed Number 3,57,31,26
2016-06-12,1,Bed Number 1,55,32,23
2016-06-12,2,Bed Number 2,81,12,69
2016-06-12,3,Bed Number 3,24,4,20
2016-06-13,1,Bed Number 1,78,3,75
2016-06-13,2,Bed Number 2,82,0,82
2016-06-13,3,Bed Number 3,21,11,10
2016-06-14,1,Bed Number 1,18,1,17
2016-06-14,2,Bed Number 2,90,10,80
2016-06-14,3,Bed Number 3,89,48,41
2016-06-15,1,Bed Number 1,10,0,10
2016-06-15,2,Bed Number 2,99,10,89
2016-06-15,3,Bed Number 3,81,15,66
2016-06-16,1,Bed Number 1,53,24,29
2016-06-16,2,Bed Number 2,86,76,10
2016-06-16,3,Bed Number 3,82,0,82
2016-06-17,1,Bed Number 1,61,50,11
2016-06-17,2,Bed Number 2,21,10,11
2016-06-17,3,Bed Number 3,96,37,59
2016-06-18,1,Bed Number 1,66,7,59
2016-06-18,2,Bed Number 2,42,25,17
2016-06-18,3,Bed Number 3,82,52,30
2016-06-19,1,Bed Number 1,27,13,14
2016-06-19,2,Bed Number 2,74,28,46
2016-06-19,3,Bed Number 3,17,3,14
2016-06-20,1,Bed Number 1,65,27,38
2016-06-20,2,Bed Number 2,42,29,13
2016-06-20,3,Bed Number 3,60,42,18
2016-06-21,1,Bed Number 1,41,20,21
2016-06-21,2,Bed Number 2,88,61,27
2016-06-21,3,Bed Number 3,53,4,49
2016-06-22,1,Bed Number 1,37,37,0
2016-06-22,2,Bed Number 2,65,57,8
2016-06-22,3,Bed Number 3,82,17,65
2016-06-23,1,Bed Number 1,92,50,42
2016-06-23,2,Bed Number 2,53,19,34
2016-06-23,3,Bed Number 3,59,56,3
2016-06-24,1,Bed Number 1,16,3,13
2016-06-24,2,Bed Number 2,13,5,8
2016-06-24,3,Bed Number 3,22,7,15
2016-06-25,1,Bed Number 1,79,71,8
2016-06-25,2,Bed Number 2,13,9,4
2016-06-25,3,Bed Number 3,79,47,32
2016-06-26,1,Bed Number 1,53,17,36
2016-06-26,2,Bed Number 2,80,51,29
2016-06-26,3,Bed Number 3,60,52,8
2016-06-27,1,Bed Number 1,95,67,28
2016-06-27,2,Bed Number 2,58,5,53
2016-06-27,3,Bed Number 3,75,1,74
2016-06-28,1,Bed Number 1,27,5,22
2016-06-28,2,Bed Number 2,47,34,13
2016-06-28,3,Bed Number 3,75,43,32
2016-06-29,1,Bed Number 1,42,28,14
2016-06-29,2,Bed Number 2,83,78,5
2016-06-29,3,Bed Number 3,98,59,39
2016-06-30,1,Bed Number 1,90,17,73
2016-06-30,2,Bed Number 2,70,10,60
2016-06-30,3,Bed Number 3,19,0,19
2016-07-01,1,Bed Number 1,54,22,32
2016-07-01,2,Bed Number 2,38,2,36
2016-07-01,3,Bed Number 3,97,47,50
2016-07-02,1,Bed Number 1,70,53,17
2016-07-02,2,Bed Number 2,31,20,11
2016-07-02,3,Bed Number 3,25,17,8
2016-07-03,1,Bed Number 1,49,12,37
2016-07-03,2,Bed Number 2,44,31,13
2016-07-03,3,Bed Number 3,51,1,50
2016-07-04,1,Bed Number 1,26,26,0
2016-07-04,2,Bed Number 2,65,11,54
2016-07-04,3,Bed Number 3,15,15,0
2016-07-05,1,Bed Number 1,98,61,37
2016-07-05,2,Bed Number 2,35,11,24
2016-07-05,3,Bed Number 3,10,8,2
2016-07-06,1,Bed Number 1,88,3,85
2016-07-06,2,Bed Number 2,92,38,54
2016-07-06,3,Bed Number 3,64,25,39
2016-07-07,1,Bed Number 1,42,29,13
2016-07-07,2,Bed Number 2,89,31,58
2016-07-07,3,Bed Number 3,16,6,10
2016-07-08,1,Bed Number 1,37,21,16
2016-07-08,2,Bed Number 2,84,11,73
2016-07-08,3,Bed Number 3,92,3,89
2016-07-09,1,Bed Number 1,53,20,33
2016-07-09,2,Bed Number 2,79,61,18
2016-07-09,3,Bed Number 3,69,65,4
2016-07-10,1,Bed Number 1,33,16,17
2016-07-10,2,Bed Number 2,53,36,17
2016-07-10,3,Bed Number 3,81,72,9
2016-07-11,1,Bed Number 1,46,5,41
2016-07-11,2,Bed Number 2,100,52,48
2016-07-11,3,Bed Number 3,53,26,27
2016-07-12,1,Bed Number 1,49,41,8
2016-07-12,2,Bed Number 2,61,32,29
2016-07-12,3,Bed Number 3,62,46,16
2016-07-13,1,Bed Number 1,50,39,11
2016-07-13,2,Bed Number 2,26,21,5
2016-07-13,3,Bed Number 3,46,45,1
2016-07-14,1,Bed Number 1,69,40,29
2016-07-14,2,Bed Number 2,97,3,94
2016-07-14,3,Bed Number 3,64,59,5
2016-07-15,1,Bed Number 1,74,66,8
2016-07-15,2,Bed Number 2,39,38,1
2016-07-15,3,Bed Number 3,52,31,21
2016-07-16,1,Bed Number 1,48,18,30
2016-07-16,2,Bed Number 2,32,4,28
2016-07-16,3,Bed Number 3,23,16,7
2016-07-17,1,Bed Number 1,81,44,37
2016-07-17,2,Bed Number 2,60,30,30
2016-07-17,3,Bed Number 3,39,10,29
2016-07-18,1,Bed Number 1,20,18,2
2016-07-18,2,Bed Number 2,80,47,33
2016-07-18,3,Bed Number 3,87,21,66
2016-07-19,1,Bed Number 1,43,5,38
2016-07-19,2,Bed Number 2,22,16,6
2016-07-19,3,Bed Number 3,97,40,57
2016-07-20,1,Bed Number 1,51,9,42
2016-07-20,2,Bed Number 2,74,27,47
2016-07-20,3,Bed Number 3,45,36,9
2016-07-21,1,Bed Number 1,65,46,19
2016-07-21,2,Bed Number 2,29,18,11
2016-07-21,3,Bed Number 3,86,32,54
2016-07-22,1,Bed Number 1,20,5,15
2016-07-22,2,Bed Number 2,31,22,9
2016-07-22,3,Bed Number 3,59,4,55
2016-07-23,1,Bed Number 1,23,23,0
2016-07-23,2,Bed Number 2,20,10,10
2016-07-23,3,Bed Number 3,21,21,0
2016-07-24,1,Bed Number 1,30,30,0
2016-07-24,2,Bed Number 2,27,13,14
2016-07-24,3,Bed Number 3,13,9,4
2016-07-25,1,Bed Number 1,94,50,44
2016-07-25,2,Bed Number 2,25,5,20
2016-07-25,3,Bed Number 3,98,30,68
2016-07-26,1,Bed Number 1,26,20,6
2016-07-26,2,Bed Number 2,45,36,9
2016-07-26,3,Bed Number 3,10,3,7
2016-07-27,1,Bed Number 1,97,88,9
2016-07-27,2,Bed Number 2,92,44,48
2016-07-27,3,Bed Number 3,20,14,6
2016-07-28,1,Bed Number 1,74,42,32
2016-07-28,2,Bed Number 2,54,41,13
2016-07-28,3,Bed Number 3,24,9,15
2016-07-29,1,Bed Number 1,34,17,17
2016-07-29,2,Bed Number 2,91,64,27
2016-07-29,3,Bed Number 3,29,0,29
2016-07-30,1,Bed Number 1,83,29,54
2016-07-30,2,Bed Number 2,55,43,12
2016-07-30,3,Bed Number 3,23,2,21
2016-07-31,1,Bed Number 1,79,67,12
2016-07-31,2,Bed Number 2,39,28,11
2016-07-31,3,Bed Number 3,91,16,75
2016-08-01,1,Bed Number 1,69,69,0
2016-08-01,2,Bed Number 2,46,6,40
2016-08-01,3,Bed Number 3,91,86,5
2016-08-02,1,Bed Number 1,84,6,78
2016-08-02,2,Bed Number 2,89,85,4
2016-08-02,3,Bed Number 3,54,52,2
2016-08-03,1,Bed Number 1,77,31,46
2016-08-03,2,Bed Number 2,12,1,11
2016-08-03,3,Bed Number 3,33,19,14
2016-08-04,1,Bed Number 1,27,19,8
2016-08-04,2,Bed Number 2,61,19,42
2016-08-04,3,Bed Number 3,81,22,59
2016-08-05,1,Bed Number 1,78,57,21
2016-08-05,2,Bed Number 2,88,47,41
2016-08-05,3,Bed Number 3,50,36,14
2016-08-06,1,Bed Number 1,17,7,10
2016-08-06,2,Bed Number 2,22,21,1
2016-08-06,3,Bed Number 3,94,24,70
2016-08-07,1,Bed Number 1,77,71,6
2016-08-07,2,Bed Number 2,89,35,54
2016-08-07,3,Bed Number 3,48,4,44
2016-08-08,1,Bed Number 1,71,21,50
2016-08-08,2,Bed Number 2,91,22,69
2016-08-08,3,Bed Number 3,42,5,37
2016-08-09,1,Bed Number 1,44,23,21
2016-08-09,2,Bed Number 2,95,36,59
2016-08-09,3,Bed Number 3,81,9,72
2016-08-10,1,Bed Number 1,51,47,4
2016-08-10,2,Bed Number 2,56,21,35
2016-08-10,3,Bed Number 3,94,49,45
2016-08-11,1,Bed Number 1,47,44,3
2016-08-11,2,Bed Number 2,49,15,34
2016-08-11,3,Bed Number 3,25,1,24
2016-08-12,1,Bed Number 1,86,6,80
2016-08-12,2,Bed Number 2,88,0,88
2016-08-12,3,Bed Number 3,83,23,60
2016-08-13,1,Bed Number 1,27,15,12
2016-08-13,2,Bed Number 2,89,66,23
2016-08-13,3,Bed Number 3,14,4,10
2016-08-14,1,Bed Number 1,60,8,52
2016-08-14,2,Bed Number 2,76,13,63
2016-08-14,3,Bed Number 3,85,83,2
2016-08-15,1,Bed Number 1,87,78,9
2016-08-15,2,Bed Number 2,37,17,20
2016-08-15,3,Bed Number 3,27,12,15
2016-08-16,1,Bed Number 1,32,29,3
2016-08-16,2,Bed Number 2,76,10,66
2016-08-16,3,Bed Number 3,68,44,24
2016-08-17,1,Bed Number 1,72,8,64
2016-08-17,2,Bed Number 2,33,28,5
2016-08-17,3,Bed Number 3,93,3,90
2016-08-18,1,Bed Number 1,14,4,10
2016-08-18,2,Bed Number 2,92,56,36
2016-08-18,3,Bed Number 3,15,5,10
2016-08-19,1,Bed Number 1,43,6,37
2016-08-19,2,Bed Number 2,41,3,38
2016-08-19,3,Bed Number 3,25,0,25
2016-08-20,1,Bed Number 1,24,13,11
2016-08-20,2,Bed Number 2,100,71,29
2016-08-20,3,Bed Number 3,41,39,2
2016-08-21,1,Bed Number 1,81,25,56
2016-08-21,2,Bed Number 2,80,51,29
2016-08-21,3,Bed Number 3,42,18,24
2016-08-22,1,Bed Number 1,64,47,17
2016-08-22,2,Bed Number 2,88,26,62
2016-08-22,3,Bed Number 3,68,27,41
2016-08-23,1,Bed Number 1,93,46,47
2016-08-23,2,Bed Number 2,22,9,13
2016-08-23,3,Bed Number 3,35,7,28
2016-08-24,1,Bed Number 1,33,21,12
2016-08-24,2,Bed Number 2,95,50,45
2016-08-24,3,Bed Number 3,77,35,42
2016-08-25,1,Bed Number 1,77,53,24
2016-08-25,2,Bed Number 2,28,8,20
2016-08-25,3,Bed Number 3,35,15,20
2016-08-26,1,Bed Number 1,94,87,7
2016-08-26,2,Bed Number 2,15,8,7
2016-08-26,3,Bed Number 3,43,2,41
2016-08-27,1,Bed Number 1,93,27,66
2016-08-27,2,Bed Number 2,64,42,22
2016-08-27,3,Bed Number 3,34,4,30
2016-08-28,1,Bed Number 1,13,11,2
2016-08-28,2,Bed Number 2,26,9,17
2016-08-28,3,Bed Number 3,57,57,0
2016-08-29,1,Bed Number 1,29,20,9
2016-08-29,2,Bed Number 2,21,17,4
2016-08-29,3,Bed Number 3,30,19,11
2016-08-30,1,Bed Number 1,71,58,13
2016-08-30,2,Bed Number 2,45,8,37
2016-08-30,3,Bed Number 3,92,39,53
2016-08-31,1,Bed Number 1,19,18,1
2016-08-31,2,Bed Number 2,49,45,4
2016-08-31,3,Bed Number 3,98,4,94
2016-09-01,1,Bed Number 1,68,12,56
2016-09-01,2,Bed Number 2,14,8,6
2016-09-01,3,Bed Number 3,90,47,43
2016-09-02,1,Bed Number 1,68,13,55
2016-09-02,2,Bed Number 2,30,15,15
2016-09-02,3,Bed Number 3,34,11,23
2016-09-03,1,Bed Number 1,61,12,49
2016-09-03,2,Bed Number 2,83,72,11
2016-09-03,3,Bed Number 3,31,31,0
2016-09-04,1,Bed Number 1,43,15,28
2016-09-04,2,Bed Number 2,64,56,8
2016-09-04,3,Bed Number 3,71,37,34
2016-09-05,1,Bed Number 1,93,87,6
2016-09-05,2,Bed Number 2,21,18,3
2016-09-05,3,Bed Number 3,16,10,6
2016-09-06,1,Bed Number 1,80,23,57
2016-09-06,2,Bed Number 2,95,75,20
2016-09-06,3,Bed Number 3,82,71,11
2016-09-07,1,Bed Number 1,41,11,30
2016-09-07,2,Bed Number 2,68,38,30
2016-09-07,3,Bed Number 3,69,14,55
2016-09-08,1,Bed Number 1,46,4,42
2016-09-08,2,Bed Number 2,28,19,9
2016-09-08,3,Bed Number 3,61,44,17
2016-09-09,1,Bed Number 1,56,8,48
2016-09-09,2,Bed Number 2,64,37,27
2016-09-09,3,Bed Number 3,42,30,12
2016-09-10,1,Bed Number 1,29,28,1
2016-09-10,2,Bed Number 2,55,15,40
2016-09-10,3,Bed Number 3,97,86,11
2016-09-11,1,Bed Number 1,17,0,17
2016-09-11,2,Bed Number 2,36,1,35
2016-09-11,3,Bed Number 3,76,66,10
2016-09-12,1,Bed Number 1,39,35,4
2016-09-12,2,Bed Number 2,42,17,25
2016-09-12,3,Bed Number 3,51,24,27
2016-09-13,1,Bed Number 1,83,27,56
2016-09-13,2,Bed Number 2,24,11,13
2016-09-13,3,Bed Number 3,19,10,9
2016-09-14,1,Bed Number 1,10,9,1
2016-09-14,2,Bed Number 2,34,13,21
2016-09-14,3,Bed Number 3,87,10,77
2016-09-15,1,Bed Number 1,31,9,22
2016-09-15,2,Bed Number 2,56,29,27
2016-09-15,3,Bed Number 3,84,5,79
2016-09-16,1,Bed Number 1,49,47,2
2016-09-16,2,Bed Number 2,80,50,30
2016-09-16,3,Bed Number 3,41,35,6
2016-09-17,1,Bed Number 1,10,5,5
2016-09-17,2,Bed Number 2,31,1,30
2016-09-17,3,Bed Number 3,22,10,12
2016-09-18,1,Bed Number 1,14,14,0
2016-09-18,2,Bed Number 2,58,38,20
2016-09-18,3,Bed Number 3,35,18,17
2016-09-19,1,Bed Number 1,31,25,6
2016-09-19,2,Bed Number 2,67,26,41
2016-09-19,3,Bed Number 3,39,10,29
2016-09-20,1,Bed Number 1,45,38,7
2016-09-20,2,Bed Number 2,52,45,7
2016-09-20,3,Bed Number 3,10,7,3
2016-09-21,1,Bed Number 1,40,28,12
2016-09-21,2,Bed Number 2,73,40,33
2016-09-21,3,Bed Number 3,45,6,39
2016-09-22,1,Bed Number 1,60,48,12
2016-09-22,2,Bed Number 2,96,66,30
2016-09-22,3,Bed Number 3,42,4,38
2016-09-23,1,Bed Number 1,71,17,54
2016-09-23,2,Bed Number 2,75,57,18
2016-09-23,3,Bed Number 3,45,17,28
2016-09-24,1,Bed Number 1,10,4,6
2016-09-24,2,Bed Number 2,22,14,8
2016-09-24,3,Bed Number 3,34,0,34
2016-09-25,1,Bed Number 1,89,33,56
2016-09-25,2,Bed Number 2,94,87,7
2016-09-25,3,Bed Number 3,39,13,26
2016-09-26,1,Bed Number 1,62,60,2
2016-09-26,2,Bed Number 2,69,58,11
2016-09-26,3,Bed Number 3,94,15,79
2016-09-27,1,Bed Number 1,82,54,28
2016-09-27,2,Bed Number 2,70,34,36
2016-09-27,3,Bed Number 3,34,0,34
2016-09-28,1,Bed Number 1,80,53,27
2016-09-28,2,Bed Number 2,31,16,15
2016-09-28,3,Bed Number 3,67,9,58
2016-09-29,1,Bed Number 1,93,86,7
2016-09-29,2,Bed Number 2,17,8,9
2016-09-29,3,Bed Number 3,68,48,20
2016-09-30,1,Bed Number 1,52,50,2
2016-09-30,2,Bed Number 2,92,71,21
2016-09-30,3,Bed Number 3,59,49,10
2016-10-01,1,Bed Number 1,61,23,38
2016-10-01,2,Bed Number 2,48,12,36
2016-10-01,3,Bed Number 3,50,50,0
2016-10-02,1,Bed Number 1,70,14,56
2016-10-02,2,Bed Number 2,10,7,3
2016-10-02,3,Bed Number 3,80,28,52
2016-10-03,1,Bed Number 1,50,15,35
2016-10-03,2,Bed Number 2,19,13,6
2016-10-03,3,Bed Number 3,86,41,45
2016-10-04,1,Bed Number 1,10,3,7
2016-10-04,2,Bed Number 2,92,9,83
2016-10-04,3,Bed Number 3,58,5,53
2016-10-05,1,Bed Number 1,38,36,2
2016-10-05,2,Bed Number 2,15,5,10
2016-10-05,3,Bed Number 3,85,17,68
2016-10-06,1,Bed Number 1,62,40,22
2016-10-06,2,Bed Number 2,23,3,20
2016-10-06,3,Bed Number 3,82,25,57
2016-10-07,1,Bed Number 1,57,4,53
2016-10-07,2,Bed Number 2,14,5,9
2016-10-07,3,Bed Number 3,86,80,6
2016-10-08,1,Bed Number 1,40,34,6
2016-10-08,2,Bed Number 2,53,11,42
2016-10-08,3,Bed Number 3,88,34,54
2016-10-09,1,Bed Number 1,28,2,26
2016-10-09,2,Bed Number 2,60,21,39
2016-10-09,3,Bed Number 3,19,1,18
2016-10-10,1,Bed Number 1,24,22,2
2016-10-10,2,Bed Number 2,93,73,20
2016-10-10,3,Bed Number 3,84,57,27
2016-10-11,1,Bed Number 1,67,46,21
2016-10-11,2,Bed Number 2,34,25,9
2016-10-11,3,Bed Number 3,11,6,5
2016-10-12,1,Bed Number 1,85,15,70
2016-10-12,2,Bed Number 2,22,17,5
2016-10-12,3,Bed Number 3,88,62,26
2016-10-13,1,Bed Number 1,75,9,66
2016-10-13,2,Bed Number 2,75,30,45
2016-10-13,3,Bed Number 3,32,16,16
2016-10-14,1,Bed Number 1,98,69,29
2016-10-14,2,Bed Number 2,49,20,29
2016-10-14,3,Bed Number 3,62,51,11
2016-10-15,1,Bed Number 1,65,41,24
2016-10-15,2,Bed Number 2,70,55,15
2016-10-15,3,Bed Number 3,71,56,15
2016-10-16,1,Bed Number 1,93,87,6
2016-10-16,2,Bed Number 2,54,7,47
2016-10-16,3,Bed Number 3,18,2,16
2016-10-17,1,Bed Number 1,28,0,28
2016-10-17,2,Bed Number 2,93,1,92
2016-10-17,3,Bed Number 3,32,14,18
2016-10-18,1,Bed Number 1,65,22,43
2016-10-18,2,Bed Number 2,98,81,17
2016-10-18,3,Bed Number 3,95,33,62
2016-10-19,1,Bed Number 1,22,21,1
2016-10-19,2,Bed Number 2,63,25,38
2016-10-19,3,Bed Number 3,30,19,11
2016-10-20,1,Bed Number 1,93,64,29
2016-10-20,2,Bed Number 2,92,43,49
2016-10-20,3,Bed Number 3,97,48,49
2016-10-21,1,Bed Number 1,98,73,25
2016-10-21,2,Bed Number 2,53,43,10
2016-10-21,3,Bed Number 3,13,4,9
2016-10-22,1,Bed Number 1,39,31,8
2016-10-22,2,Bed Number 2,41,10,31
2016-10-22,3,Bed Number 3,100,96,4
2016-10-23,1,Bed Number 1,85,39,46
2016-10-23,2,Bed Number 2,86,62,24
2016-10-23,3,Bed Number 3,26,6,20
2016-10-24,1,Bed Number 1,62,57,5
2016-10-24,2,Bed Number 2,40,25,15
2016-10-24,3,Bed Number 3,91,24,67
2016-10-25,1,Bed Number 1,58,18,40
2016-10-25,2,Bed Number 2,24,17,7
2016-10-25,3,Bed Number 3,27,14,13
2016-10-26,1,Bed Number 1,66,39,27
2016-10-26,2,Bed Number 2,27,26,1
2016-10-26,3,Bed Number 3,25,23,2
2016-10-27,1,Bed Number 1,29,13,16
2016-10-27,2,Bed Number 2,24,10,14
2016-10-27,3,Bed Number 3,99,37,62
2016-10-28,1,Bed Number 1,42,28,14
2016-10-28,2,Bed Number 2,91,76,15
2016-10-28,3,Bed Number 3,60,31,29
2016-10-29,1,Bed Number 1,37,31,6
2016-10-29,2,Bed Number 2,35,5,30
2016-10-29,3,Bed Number 3,21,8,13
2016-10-30,1,Bed Number 1,21,9,12
2016-10-30,2,Bed Number 2,78,59,19
2016-10-30,3,Bed Number 3,69,57,12
2016-10-31,1,Bed Number 1,89,0,89
2016-10-31,2,Bed Number 2,14,4,10
2016-10-31,3,Bed Number 3,41,22,19
2016-11-01,1,Bed Number 1,34,8,26
2016-11-01,2,Bed Number 2,75,52,23
2016-11-01,3,Bed Number 3,88,73,15
2016-11-02,1,Bed Number 1,57,20,37
2016-11-02,2,Bed Number 2,16,2,14
2016-11-02,3,Bed Number 3,64,7,57
2016-11-03,1,Bed Number 1,42,20,22
2016-11-03,2,Bed Number 2,27,12,15
2016-11-03,3,Bed Number 3,75,12,63
2016-11-04,1,Bed Number 1,57,52,5
2016-11-04,2,Bed Number 2,93,17,76
2016-11-04,3,Bed Number 3,79,73,6
2016-11-05,1,Bed Number 1,49,0,49
2016-11-05,2,Bed Number 2,95,59,36
2016-11-05,3,Bed Number 3,87,74,13
2016-11-06,1,Bed Number 1,87,56,31
2016-11-06,2,Bed Number 2,10,9,1
2016-11-06,3,Bed Number 3,13,12,1
2016-11-07,1,Bed Number 1,27,18,9
2016-11-07,2,Bed Number 2,16,3,13
2016-11-07,3,Bed Number 3,100,20,80
2016-11-08,1,Bed Number 1,39,24,15
2016-11-08,2,Bed Number 2,76,52,24
2016-11-08,3,Bed Number 3,44,11,33
2016-11-09,1,Bed Number 1,35,28,7
2016-11-09,2,Bed Number 2,63,19,44
2016-11-09,3,Bed Number 3,21,9,12
2016-11-10,1,Bed Number 1,55,27,28
2016-11-10,2,Bed Number 2,10,10,0
2016-11-10,3,Bed Number 3,76,54,22
2016-11-11,1,Bed Number 1,14,3,11
2016-11-11,2,Bed Number 2,96,7,89
2016-11-11,3,Bed Number 3,47,8,39
2016-11-12,1,Bed Number 1,60,57,3
2016-11-12,2,Bed Number 2,64,16,48
2016-11-12,3,Bed Number 3,13,4,9
2016-11-13,1,Bed Number 1,19,18,1
2016-11-13,2,Bed Number 2,10,8,2
2016-11-13,3,Bed Number 3,40,9,31
2016-11-14,1,Bed Number 1,37,23,14
2016-11-14,2,Bed Number 2,79,75,4
2016-11-14,3,Bed Number 3,94,21,73
2016-11-15,1,Bed Number 1,75,17,58
2016-11-15,2,Bed Number 2,13,12,1
2016-11-15,3,Bed Number 3,31,14,17
2016-11-16,1,Bed Number 1,75,53,22
2016-11-16,2,Bed Number 2,67,1,66
2016-11-16,3,Bed Number 3,24,20,4
2016-11-17,1,Bed Number 1,48,4,44
2016-11-17,2,Bed Number 2,67,1,66
2016-11-17,3,Bed Number 3,45,18,27
2016-11-18,1,Bed Number 1,31,12,19
2016-11-18,2,Bed Number 2,69,41,28
2016-11-18,3,Bed Number 3,67,60,7
2016-11-19,1,Bed Number 1,15,13,2
2016-11-19,2,Bed Number 2,56,39,17
2016-11-19,3,Bed Number 3,41,7,34
2016-11-20,1,Bed Number 1,34,31,3
2016-11-20,2,Bed Number 2,60,53,7
2016-11-20,3,Bed Number 3,63,23,40
2016-11-21,1,Bed Number 1,17,16,1
2016-11-21,2,Bed Number 2,27,18,9
2016-11-21,3,Bed Number 3,62,23,39
2016-11-22,1,Bed Number 1,56,22,34
2016-11-22,2,Bed Number 2,25,19,6
2016-11-22,3,Bed Number 3,60,7,53
2016-11-23,1,Bed Number 1,29,11,18
2016-11-23,2,Bed Number 2,53,44,9
2016-11-23,3,Bed Number 3,81,34,47
2016-11-24,1,Bed Number 1,97,19,78
2016-11-24,2,Bed Number 2,47,37,10
2016-11-24,3,Bed Number 3,31,20,11
2016-11-25,1,Bed Number 1,95,78,17
2016-11-25,2,Bed Number 2,66,6,60
2016-11-25,3,Bed Number 3,50,24,26
2016-11-26,1,Bed Number 1,17,16,1
2016-11-26,2,Bed Number 2,87,9,78
2016-11-26,3,Bed Number 3,79,25,54
2016-11-27,1,Bed Number 1,44,18,26
2016-11-27,2,Bed Number 2,33,23,10
2016-11-27,3,Bed Number 3,18,12,6
2016-11-28,1,Bed Number 1,17,3,14
2016-11-28,2,Bed Number 2,61,5,56
2016-11-28,3,Bed Number 3,92,61,31
2016-11-29,1,Bed Number 1,40,9,31
2016-11-29,2,Bed Number 2,19,4,15
2016-11-29,3,Bed Number 3,12,5,7
2016-11-30,1,Bed Number 1,34,29,5
2016-11-30,2,Bed Number 2,44,41,3
2016-11-30,3,Bed Number 3,24,15,9
2016-12-01,1,Bed Number 1,51,45,6
2016-12-01,2,Bed Number 2,45,15,30
2016-12-01,3,Bed Number 3,25,19,6
2016-12-02,1,Bed Number 1,52,9,43
2016-12-02,2,Bed Number 2,60,23,37
2016-12-02,3,Bed Number 3,64,10,54
2016-12-03,1,Bed Number 1,58,38,20
2016-12-03,2,Bed Number 2,34,18,16
2016-12-03,3,Bed Number 3,30,12,18
2016-12-04,1,Bed Number 1,78,66,12
2016-12-04,2,Bed Number 2,71,45,26
2016-12-04,3,Bed Number 3,70,65,5
2016-12-05,1,Bed Number 1,55,44,11
2016-12-05,2,Bed Number 2,54,12,42
2016-12-05,3,Bed Number 3,67,35,32
2016-12-06,1,Bed Number 1,62,44,18
2016-12-06,2,Bed Number 2,76,29,47
2016-12-06,3,Bed Number 3,97,89,8
2016-12-07,1,Bed Number 1,79,75,4
2016-12-07,2,Bed Number 2,44,8,36
2016-12-07,3,Bed Number 3,43,23,20
2016-12-08,1,Bed Number 1,85,79,6
2016-12-08,2,Bed Number 2,56,11,45
2016-12-08,3,Bed Number 3,70,59,11
2016-12-09,1,Bed Number 1,98,64,34
2016-12-09,2,Bed Number 2,68,63,5
2016-12-09,3,Bed Number 3,74,62,12
2016-12-10,1,Bed Number 1,64,9,55
2016-12-10,2,Bed Number 2,92,47,45
2016-12-10,3,Bed Number 3,79,5,74
2016-12-11,1,Bed Number 1,46,27,19
2016-12-11,2,Bed Number 2,51,17,34
2016-12-11,3,Bed Number 3,33,0,33
2016-12-12,1,Bed Number 1,49,31,18
2016-12-12,2,Bed Number 2,68,22,46
2016-12-12,3,Bed Number 3,41,16,25
2016-12-13,1,Bed Number 1,54,53,1
2016-12-13,2,Bed Number 2,20,8,12
2016-12-13,3,Bed Number 3,77,77,0
2016-12-14,1,Bed Number 1,10,0,10
2016-12-14,2,Bed Number 2,98,52,46
2016-12-14,3,Bed Number 3,71,10,61
2016-12-15,1,Bed Number 1,41,24,17
2016-12-15,2,Bed Number 2,59,9,50
2016-12-15,3,Bed Number 3,56,52,4
2016-12-16,1,Bed Number 1,100,54,46
2016-12-16,2,Bed Number 2,55,35,20
2016-12-16,3,Bed Number 3,73,9,64
2016-12-17,1,Bed Number 1,74,57,17
2016-12-17,2,Bed Number 2,39,9,30
2016-12-17,3,Bed Number 3,26,21,5
2016-12-18,1,Bed Number 1,62,51,11
2016-12-18,2,Bed Number 2,16,0,16
2016-12-18,3,Bed Number 3,17,16,1
2016-12-19,1,Bed Number 1,78,33,45
2016-12-19,2,Bed Number 2,14,5,9
2016-12-19,3,Bed Number 3,51,33,18
2016-12-20,1,Bed Number 1,36,12,24
2016-12-20,2,Bed Number 2,67,13,54
2016-12-20,3,Bed Number 3,94,73,21
2016-12-21,1,Bed Number 1,19,8,11
2016-12-21,2,Bed Number 2,49,1,48
2016-12-21,3,Bed Number 3,77,55,22
2016-12-22,1,Bed Number 1,47,43,4
2016-12-22,2,Bed Number 2,31,0,31
2016-12-22,3,Bed Number 3,94,15,79
2016-12-23,1,Bed Number 1,61,35,26
2016-12-23,2,Bed Number 2,92,67,25
2016-12-23,3,Bed Number 3,70,45,25
2016-12-24,1,Bed Number 1,72,48,24
2016-12-24,2,Bed Number 2,13,8,5
2016-12-24,3,Bed Number 3,20,12,8
2016-12-25,1,Bed Number 1,47,21,26
2016-12-25,2,Bed Number 2,50,48,2
2016-12-25,3,Bed Number 3,77,50,27
2016-12-26,1,Bed Number 1,20,2,18
2016-12-26,2,Bed Number 2,91,35,56
2016-12-26,3,Bed Number 3,99,70,29
2016-12-27,1,Bed Number 1,64,32,32
2016-12-27,2,Bed Number 2,38,28,10
2016-12-27,3,Bed Number 3,59,13,46
2016-12-28,1,Bed Number 1,96,63,33
2016-12-28,2,Bed Number 2,55,43,12
2016-12-28,3,Bed Number 3,76,19,57
2016-12-29,1,Bed Number 1,20,17,3
2016-12-29,2,Bed Number 2,29,12,17
2016-12-29,3,Bed Number 3,55,32,23
2016-12-30,1,Bed Number 1,63,45,18
2016-12-30,2,Bed Number 2,70,58,12
2016-12-30,3,Bed Number 3,78,54,24
2016-12-31,1,Bed Number 1,74,53,21
2016-12-31,2,Bed Number 2,48,20,28
2016-12-31,3,Bed Number 3,66,9,57
2017-01-01,1,Bed Number 1,40,22,18
2017-01-01,2,Bed Number 2,35,3,32
2017-01-01,3,Bed Number 3,89,76,13
2017-01-02,1,Bed Number 1,67,58,9
2017-01-02,2,Bed Number 2,65,2,63
2017-01-02,3,Bed Number 3,41,7,34
2017-01-03,1,Bed Number 1,69,8,61
2017-01-03,2,Bed Number 2,54,34,20
2017-01-03,3,Bed Number 3,79,0,79
2017-01-04,1,Bed Number 1,26,25,1
2017-01-04,2,Bed Number 2,84,35,49
2017-01-04,3,Bed Number 3,34,5,29
2017-01-05,1,Bed Number 1,11,10,1
2017-01-05,2,Bed Number 2,30,11,19
2017-01-05,3,Bed Number 3,82,75,7
2017-01-06,1,Bed Number 1,20,20,0
2017-01-06,2,Bed Number 2,94,5,89
2017-01-06,3,Bed Number 3,89,57,32
2017-01-07,1,Bed Number 1,17,14,3
2017-01-07,2,Bed Number 2,51,13,38
2017-01-07,3,Bed Number 3,47,24,23
2017-01-08,1,Bed Number 1,100,65,35
2017-01-08,2,Bed Number 2,12,1,11
2017-01-08,3,Bed Number 3,24,7,17
2017-01-09,1,Bed Number 1,87,36,51
2017-01-09,2,Bed Number 2,93,9,84
2017-01-09,3,Bed Number 3,100,25,75
2017-01-10,1,Bed Number 1,45,17,28
2017-01-10,2,Bed Number 2,53,33,20
2017-01-10,3,Bed Number 3,17,8,9
2017-01-11,1,Bed Number 1,75,44,31
2017-01-11,2,Bed Number 2,47,47,0
2017-01-11,3,Bed Number 3,41,13,28
2017-01-12,1,Bed Number 1,50,28,22
2017-01-12,2,Bed Number 2,31,30,1
2017-01-12,3,Bed Number 3,74,7,67
2017-01-13,1,Bed Number 1,93,53,40
2017-01-13,2,Bed Number 2,75,10,65
2017-01-13,3,Bed Number 3,71,64,7
2017-01-14,1,Bed Number 1,92,65,27
2017-01-14,2,Bed Number 2,36,30,6
2017-01-14,3,Bed Number 3,96,81,15
2017-01-15,1,Bed Number 1,52,5,47
2017-01-15,2,Bed Number 2,21,3,18
2017-01-15,3,Bed Number 3,59,21,38
2017-01-16,1,Bed Number 1,83,19,64
2017-01-16,2,Bed Number 2,52,14,38
2017-01-16,3,Bed Number 3,88,13,75
2017-01-17,1,Bed Number 1,63,20,43
2017-01-17,2,Bed Number 2,42,40,2
2017-01-17,3,Bed Number 3,49,16,33
2017-01-18,1,Bed Number 1,10,8,2
2017-01-18,2,Bed Number 2,10,6,4
2017-01-18,3,Bed Number 3,37,1,36
2017-01-19,1,Bed Number 1,53,46,7
2017-01-19,2,Bed Number 2,39,19,20
2017-01-19,3,Bed Number 3,10,10,0
2017-01-20,1,Bed Number 1,73,51,22
2017-01-20,2,Bed Number 2,66,17,49
2017-01-20,3,Bed Number 3,17,5,12
2017-01-21,1,Bed Number 1,45,10,35
2017-01-21,2,Bed Number 2,62,28,34
2017-01-21,3,Bed Number 3,10,9,1
2017-01-22,1,Bed Number 1,33,21,12
2017-01-22,2,Bed Number 2,90,41,49
2017-01-22,3,Bed Number 3,100,4,96
2017-01-23,1,Bed Number 1,40,32,8
2017-01-23,2,Bed Number 2,54,1,53
2017-01-23,3,Bed Number 3,52,43,9
2017-01-24,1,Bed Number 1,35,3,32
2017-01-24,2,Bed Number 2,74,60,14
2017-01-24,3,Bed Number 3,72,1,71
2017-01-25,1,Bed Number 1,25,14,11
2017-01-25,2,Bed Number 2,31,1,30
2017-01-25,3,Bed Number 3,21,4,17
2017-01-26,1,Bed Number 1,49,7,42
2017-01-26,2,Bed Number 2,99,41,58
2017-01-26,3,Bed Number 3,33,5,28
2017-01-27,1,Bed Number 1,53,6,47
2017-01-27,2,Bed Number 2,21,8,13
2017-01-27,3,Bed Number 3,48,47,1
2017-01-28,1,Bed Number 1,26,25,1
2017-01-28,2,Bed Number 2,33,0,33
2017-01-28,3,Bed Number 3,61,44,17
2017-01-29,1,Bed Number 1,11,11,0
2017-01-29,2,Bed Number 2,96,48,48
2017-01-29,3,Bed Number 3,16,3,13
2017-01-30,1,Bed Number 1,76,15,61
2017-01-30,2,Bed Number 2,90,64,26
2017-01-30,3,Bed Number 3,83,47,36
2017-01-31,1,Bed Number 1,87,27,60
2017-01-31,2,Bed Number 2,59,19,40
2017-01-31,3,Bed Number 3,19,10,9
2017-02-01,1,Bed Number 1,18,12,6
2017-02-01,2,Bed Number 2,38,12,26
2017-02-01,3,Bed Number 3,11,9,2
2017-02-02,1,Bed Number 1,89,53,36
2017-02-02,2,Bed Number 2,62,58,4
2017-02-02,3,Bed Number 3,65,15,50
2017-02-03,1,Bed Number 1,88,57,31
2017-02-03,2,Bed Number 2,49,36,13
2017-02-03,3,Bed Number 3,63,59,4
2017-02-04,1,Bed Number 1,56,15,41
2017-02-04,2,Bed Number 2,50,12,38
2017-02-04,3,Bed Number 3,19,1,18
2017-02-05,1,Bed Number 1,34,16,18
2017-02-05,2,Bed Number 2,64,4,60
2017-02-05,3,Bed Number 3,40,28,12
2017-02-06,1,Bed Number 1,89,75,14
2017-02-06,2,Bed Number 2,38,26,12
2017-02-06,3,Bed Number 3,89,22,67
2017-02-07,1,Bed Number 1,66,39,27
2017-02-07,2,Bed Number 2,89,51,38
2017-02-07,3,Bed Number 3,97,1,96
2017-02-08,1,Bed Number 1,88,61,27
2017-02-08,2,Bed Number 2,79,63,16
2017-02-08,3,Bed Number 3,69,69,0
2017-02-09,1,Bed Number 1,29,1,28
2017-02-09,2,Bed Number 2,59,50,9
2017-02-09,3,Bed Number 3,83,76,7
2017-02-10,1,Bed Number 1,21,1,20
2017-02-10,2,Bed Number 2,53,23,30
2017-02-10,3,Bed Number 3,82,37,45
2017-02-11,1,Bed Number 1,94,61,33
2017-02-11,2,Bed Number 2,80,17,63
2017-02-11,3,Bed Number 3,52,8,44
2017-02-12,1,Bed Number 1,84,25,59
2017-02-12,2,Bed Number 2,98,63,35
2017-02-12,3,Bed Number 3,14,1,13
2017-02-13,1,Bed Number 1,38,6,32
2017-02-13,2,Bed Number 2,79,9,70
2017-02-13,3,Bed Number 3,85,23,62
2017-02-14,1,Bed Number 1,21,18,3
2017-02-14,2,Bed Number 2,50,19,31
2017-02-14,3,Bed Number 3,22,16,6
2017-02-15,1,Bed Number 1,55,44,11
2017-02-15,2,Bed Number 2,79,45,34
2017-02-15,3,Bed Number 3,82,4,78
2017-02-16,1,Bed Number 1,30,7,23
2017-02-16,2,Bed Number 2,77,54,23
2017-02-16,3,Bed Number 3,83,71,12
2017-02-17,1,Bed Number 1,86,43,43
2017-02-17,2,Bed Number 2,52,48,4
2017-02-17,3,Bed Number 3,34,29,5
2017-02-18,1,Bed Number 1,26,19,7
2017-02-18,2,Bed Number 2,64,10,54
2017-02-18,3,Bed Number 3,60,58,2
2017-02-19,1,Bed Number 1,99,35,64
2017-02-19,2,Bed Number 2,98,7,91
2017-02-19,3,Bed Number 3,17,9,8
2017-02-20,1,Bed Number 1,31,2,29
2017-02-20,2,Bed Number 2,79,73,6
2017-02-20,3,Bed Number 3,30,18,12
2017-02-21,1,Bed Number 1,31,12,19
2017-02-21,2,Bed Number 2,65,17,48
2017-02-21,3,Bed Number 3,80,22,58
2017-02-22,1,Bed Number 1,65,48,17
2017-02-22,2,Bed Number 2,23,12,11
2017-02-22,3,Bed Number 3,73,22,51
2017-02-23,1,Bed Number 1,73,12,61
2017-02-23,2,Bed Number 2,87,47,40
2017-02-23,3,Bed Number 3,84,70,14
2017-02-24,1,Bed Number 1,67,62,5
2017-02-24,2,Bed Number 2,72,52,20
2017-02-24,3,Bed Number 3,52,37,15
2017-02-25,1,Bed Number 1,94,52,42
2017-02-25,2,Bed Number 2,33,25,8
2017-02-25,3,Bed Number 3,65,53,12
2017-02-26,1,Bed Number 1,38,33,5
2017-02-26,2,Bed Number 2,49,26,23
2017-02-26,3,Bed Number 3,84,47,37
2017-02-27,1,Bed Number 1,71,34,37
2017-02-27,2,Bed Number 2,56,51,5
2017-02-27,3,Bed Number 3,38,0,38
2017-02-28,1,Bed Number 1,43,8,35
2017-02-28,2,Bed Number 2,46,9,37
2017-02-28,3,Bed Number 3,65,22,43
2017-03-01,1,Bed Number 1,88,38,50
2017-03-01,2,Bed Number 2,88,20,68
2017-03-01,3,Bed Number 3,93,16,77
2017-03-02,1,Bed Number 1,70,38,32
2017-03-02,2,Bed Number 2,99,65,34
2017-03-02,3,Bed Number 3,55,51,4
2017-03-03,1,Bed Number 1,36,1,35
2017-03-03,2,Bed Number 2,91,66,25
2017-03-03,3,Bed Number 3,19,5,14
2017-03-04,1,Bed Number 1,24,21,3
2017-03-04,2,Bed Number 2,23,5,18
2017-03-04,3,Bed Number 3,35,6,29
2017-03-05,1,Bed Number 1,11,10,1
2017-03-05,2,Bed Number 2,49,9,40
2017-03-05,3,Bed Number 3,47,21,26
2017-03-06,1,Bed Number 1,91,78,13
2017-03-06,2,Bed Number 2,46,34,12
2017-03-06,3,Bed Number 3,69,15,54
2017-03-07,1,Bed Number 1,51,40,11
2017-03-07,2,Bed Number 2,31,12,19
2017-03-07,3,Bed Number 3,37,37,0
2017-03-08,1,Bed Number 1,73,69,4
2017-03-08,2,Bed Number 2,99,24,75
2017-03-08,3,Bed Number 3,31,17,14
2017-03-09,1,Bed Number 1,59,27,32
2017-03-09,2,Bed Number 2,47,8,39
2017-03-09,3,Bed Number 3,85,20,65
2017-03-10,1,Bed Number 1,38,11,27
2017-03-10,2,Bed Number 2,85,27,58
2017-03-10,3,Bed Number 3,43,19,24
2017-03-11,1,Bed Number 1,98,31,67
2017-03-11,2,Bed Number 2,65,6,59
2017-03-11,3,Bed Number 3,70,38,32
2017-03-12,1,Bed Number 1,98,95,3
2017-03-12,2,Bed Number 2,96,19,77
2017-03-12,3,Bed Number 3,22,5,17
2017-03-13,1,Bed Number 1,60,27,33
2017-03-13,2,Bed Number 2,70,15,55
2017-03-13,3,Bed Number 3,14,7,7
2017-03-14,1,Bed Number 1,28,5,23
2017-03-14,2,Bed Number 2,60,5,55
2017-03-14,3,Bed Number 3,22,1,21
2017-03-15,1,Bed Number 1,74,69,5
2017-03-15,2,Bed Number 2,94,71,23
2017-03-15,3,Bed Number 3,16,0,16
2017-03-16,1,Bed Number 1,94,86,8
2017-03-16,2,Bed Number 2,15,2,13
2017-03-16,3,Bed Number 3,65,6,59
2017-03-17,1,Bed Number 1,78,61,17
2017-03-17,2,Bed Number 2,12,4,8
2017-03-17,3,Bed Number 3,48,39,9
2017-03-18,1,Bed Number 1,68,64,4
2017-03-18,2,Bed Number 2,89,9,80
2017-03-18,3,Bed Number 3,46,20,26
2017-03-19,1,Bed Number 1,54,19,35
2017-03-19,2,Bed Number 2,81,30,51
2017-03-19,3,Bed Number 3,63,3,60
2017-03-20,1,Bed Number 1,11,4,7
2017-03-20,2,Bed Number 2,44,10,34
2017-03-20,3,Bed Number 3,58,13,45
2017-03-21,1,Bed Number 1,78,30,48
2017-03-21,2,Bed Number 2,59,24,35
2017-03-21,3,Bed Number 3,81,3,78
2017-03-22,1,Bed Number 1,60,2,58
2017-03-22,2,Bed Number 2,57,55,2
2017-03-22,3,Bed Number 3,65,11,54
2017-03-23,1,Bed Number 1,94,3,91
2017-03-23,2,Bed Number 2,59,43,16
2017-03-23,3,Bed Number 3,74,27,47
2017-03-24,1,Bed Number 1,34,14,20
2017-03-24,2,Bed Number 2,11,0,11
2017-03-24,3,Bed Number 3,41,0,41
2017-03-25,1,Bed Number 1,52,23,29
2017-03-25,2,Bed Number 2,90,42,48
2017-03-25,3,Bed Number 3,13,12,1
2017-03-26,1,Bed Number 1,62,48,14
2017-03-26,2,Bed Number 2,98,3,95
2017-03-26,3,Bed Number 3,99,6,93
2017-03-27,1,Bed Number 1,34,17,17
2017-03-27,2,Bed Number 2,41,36,5
2017-03-27,3,Bed Number 3,38,34,4
2017-03-28,1,Bed Number 1,66,5,61
2017-03-28,2,Bed Number 2,77,29,48
2017-03-28,3,Bed Number 3,80,61,19
2017-03-29,1,Bed Number 1,72,67,5
2017-03-29,2,Bed Number 2,70,19,51
2017-03-29,3,Bed Number 3,46,6,40
2017-03-30,1,Bed Number 1,39,14,25
2017-03-30,2,Bed Number 2,40,1,39
2017-03-30,3,Bed Number 3,19,13,6
2017-03-31,1,Bed Number 1,86,42,44
2017-03-31,2,Bed Number 2,12,5,7
2017-03-31,3,Bed Number 3,25,11,14
2017-04-01,1,Bed Number 1,98,12,86
2017-04-01,2,Bed Number 2,76,5,71
2017-04-01,3,Bed Number 3,49,14,35
2017-04-02,1,Bed Number 1,59,14,45
2017-04-02,2,Bed Number 2,50,18,32
2017-04-02,3,Bed Number 3,57,16,41
2017-04-03,1,Bed Number 1,38,5,33
2017-04-03,2,Bed Number 2,56,51,5
2017-04-03,3,Bed Number 3,40,7,33
2017-04-04,1,Bed Number 1,99,80,19
2017-04-04,2,Bed Number 2,14,9,5
2017-04-04,3,Bed Number 3,17,8,9
2017-04-05,1,Bed Number 1,10,10,0
2017-04-05,2,Bed Number 2,99,52,47
2017-04-05,3,Bed Number 3,11,0,11
2017-04-06,1,Bed Number 1,35,21,14
2017-04-06,2,Bed Number 2,20,4,16
2017-04-06,3,Bed Number 3,95,47,48
2017-04-07,1,Bed Number 1,55,42,13
2017-04-07,2,Bed Number 2,22,8,14
2017-04-07,3,Bed Number 3,17,1,16
2017-04-08,1,Bed Number 1,65,9,56
2017-04-08,2,Bed Number 2,62,15,47
2017-04-08,3,Bed Number 3,39,9,30
2017-04-09,1,Bed Number 1,79,72,7
2017-04-09,2,Bed Number 2,15,0,15
2017-04-09,3,Bed Number 3,46,14,32
2017-04-10,1,Bed Number 1,37,1,36
2017-04-10,2,Bed Number 2,37,20,17
2017-04-10,3,Bed Number 3,13,5,8
2017-04-11,1,Bed Number 1,50,45,5
2017-04-11,2,Bed Number 2,34,23,11
2017-04-11,3,Bed Number 3,73,26,47
2017-04-12,1,Bed Number 1,41,19,22
2017-04-12,2,Bed Number 2,36,19,17
2017-04-12,3,Bed Number 3,61,6,55
2017-04-13,1,Bed Number 1,96,4,92
2017-04-13,2,Bed Number 2,64,30,34
2017-04-13,3,Bed Number 3,24,17,7
2017-04-14,1,Bed Number 1,60,26,34
2017-04-14,2,Bed Number 2,30,14,16
2017-04-14,3,Bed Number 3,24,3,21
2017-04-15,1,Bed Number 1,86,7,79
2017-04-15,2,Bed Number 2,15,1,14
2017-04-15,3,Bed Number 3,93,33,60
2017-04-16,1,Bed Number 1,73,8,65
2017-04-16,2,Bed Number 2,91,26,65
2017-04-16,3,Bed Number 3,46,20,26
2017-04-17,1,Bed Number 1,34,21,13
2017-04-17,2,Bed Number 2,33,12,21
2017-04-17,3,Bed Number 3,70,42,28
2017-04-18,1,Bed Number 1,45,19,26
2017-04-18,2,Bed Number 2,86,73,13
2017-04-18,3,Bed Number 3,43,31,12
2017-04-19,1,Bed Number 1,99,14,85
2017-04-19,2,Bed Number 2,30,9,21
2017-04-19,3,Bed Number 3,15,2,13
2017-04-20,1,Bed Number 1,93,16,77
2017-04-20,2,Bed Number 2,53,6,47
2017-04-20,3,Bed Number 3,96,89,7
2017-04-21,1,Bed Number 1,52,4,48
2017-04-21,2,Bed Number 2,72,26,46
2017-04-21,3,Bed Number 3,53,24,29
2017-04-22,1,Bed Number 1,93,11,82
2017-04-22,2,Bed Number 2,89,31,58
2017-04-22,3,Bed Number 3,62,49,13
2017-04-23,1,Bed Number 1,55,52,3
2017-04-23,2,Bed Number 2,88,74,14
2017-04-23,3,Bed Number 3,55,54,1
2017-04-24,1,Bed Number 1,69,10,59
2017-04-24,2,Bed Number 2,76,69,7
2017-04-24,3,Bed Number 3,82,9,73
2017-04-25,1,Bed Number 1,92,86,6
2017-04-25,2,Bed Number 2,27,21,6
2017-04-25,3,Bed Number 3,92,11,81
2017-04-26,1,Bed Number 1,25,8,17
2017-04-26,2,Bed Number 2,99,78,21
2017-04-26,3,Bed Number 3,86,59,27
2017-04-27,1,Bed Number 1,73,70,3
2017-04-27,2,Bed Number 2,13,5,8
2017-04-27,3,Bed Number 3,74,0,74
2017-04-28,1,Bed Number 1,15,11,4
2017-04-28,2,Bed Number 2,63,36,27
2017-04-28,3,Bed Number 3,41,1,40
2017-04-29,1,Bed Number 1,45,22,23
2017-04-29,2,Bed Number 2,26,2,24
2017-04-29,3,Bed Number 3,16,11,5
2017-04-30,1,Bed Number 1,79,78,1
2017-04-30,2,Bed Number 2,33,12,21
2017-04-30,3,Bed Number 3,56,5,51
2017-05-01,1,Bed Number 1,30,26,4
2017-05-01,2,Bed Number 2,89,4,85
2017-05-01,3,Bed Number 3,74,61,13
2017-05-02,1,Bed Number 1,21,11,10
2017-05-02,2,Bed Number 2,84,54,30
2017-05-02,3,Bed Number 3,99,58,41
2017-05-03,1,Bed Number 1,67,34,33
2017-05-03,2,Bed Number 2,47,26,21
2017-05-03,3,Bed Number 3,100,68,32
2017-05-04,1,Bed Number 1,23,8,15
2017-05-04,2,Bed Number 2,72,55,17
2017-05-04,3,Bed Number 3,79,23,56
2017-05-05,1,Bed Number 1,31,4,27
2017-05-05,2,Bed Number 2,95,70,25
2017-05-05,3,Bed Number 3,68,26,42
2017-05-06,1,Bed Number 1,15,5,10
2017-05-06,2,Bed Number 2,57,57,0
2017-05-06,3,Bed Number 3,82,20,62
2017-05-07,1,Bed Number 1,30,5,25
2017-05-07,2,Bed Number 2,58,30,28
2017-05-07,3,Bed Number 3,53,9,44
2017-05-08,1,Bed Number 1,64,39,25
2017-05-08,2,Bed Number 2,91,20,71
2017-05-08,3,Bed Number 3,27,11,16
2017-05-09,1,Bed Number 1,29,14,15
2017-05-09,2,Bed Number 2,17,13,4
2017-05-09,3,Bed Number 3,59,28,31
2017-05-10,1,Bed Number 1,77,9,68
2017-05-10,2,Bed Number 2,99,14,85
2017-05-10,3,Bed Number 3,74,18,56
2017-05-11,1,Bed Number 1,52,1,51
2017-05-11,2,Bed Number 2,90,3,87
2017-05-11,3,Bed Number 3,15,5,10
2017-05-12,1,Bed Number 1,37,3,34
2017-05-12,2,Bed Number 2,42,12,30
2017-05-12,3,Bed Number 3,28,16,12
2017-05-13,1,Bed Number 1,61,54,7
2017-05-13,2,Bed Number 2,34,11,23
2017-05-13,3,Bed Number 3,34,21,13
2017-05-14,1,Bed Number 1,98,21,77
2017-05-14,2,Bed Number 2,28,19,9
2017-05-14,3,Bed Number 3,40,28,12
2017-05-15,1,Bed Number 1,63,61,2
2017-05-15,2,Bed Number 2,50,1,49
2017-05-15,3,Bed Number 3,17,2,15
2017-05-16,1,Bed Number 1,85,53,32
2017-05-16,2,Bed Number 2,97,69,28
2017-05-16,3,Bed Number 3,39,39,0
2017-05-17,1,Bed Number 1,27,2,25
2017-05-17,2,Bed Number 2,61,31,30
2017-05-17,3,Bed Number 3,93,85,8
2017-05-18,1,Bed Number 1,72,24,48
2017-05-18,2,Bed Number 2,80,19,61
2017-05-18,3,Bed Number 3,69,0,69
2017-05-19,1,Bed Number 1,27,27,0
2017-05-19,2,Bed Number 2,69,60,9
2017-05-19,3,Bed Number 3,100,76,24
2017-05-20,1,Bed Number 1,39,21,18
2017-05-20,2,Bed Number 2,27,10,17
2017-05-20,3,Bed Number 3,44,34,10
2017-05-21,1,Bed Number 1,31,21,10
2017-05-21,2,Bed Number 2,76,26,50
2017-05-21,3,Bed Number 3,30,12,18
2017-05-22,1,Bed Number 1,20,2,18
2017-05-22,2,Bed Number 2,70,52,18
2017-05-22,3,Bed Number 3,50,49,1
2017-05-23,1,Bed Number 1,87,37,50
2017-05-23,2,Bed Number 2,85,80,5
2017-05-23,3,Bed Number 3,43,4,39
2017-05-24,1,Bed Number 1,81,4,77
2017-05-24,2,Bed Number 2,92,66,26
2017-05-24,3,Bed Number 3,52,24,28
2017-05-25,1,Bed Number 1,80,11,69
2017-05-25,2,Bed Number 2,35,20,15
2017-05-25,3,Bed Number 3,68,17,51
2017-05-26,1,Bed Number 1,14,8,6
2017-05-26,2,Bed Number 2,92,7,85
2017-05-26,3,Bed Number 3,35,0,35
2017-05-27,1,Bed Number 1,49,41,8
2017-05-27,2,Bed Number 2,52,8,44
2017-05-27,3,Bed Number 3,18,6,12
2017-05-28,1,Bed Number 1,71,13,58
2017-05-28,2,Bed Number 2,12,12,0
2017-05-28,3,Bed Number 3,40,25,15
2017-05-29,1,Bed Number 1,52,25,27
2017-05-29,2,Bed Number 2,70,67,3
2017-05-29,3,Bed Number 3,96,89,7
2017-05-30,1,Bed Number 1,30,5,25
2017-05-30,2,Bed Number 2,23,6,17
2017-05-30,3,Bed Number 3,15,0,15
2017-05-31,1,Bed Number 1,59,43,16
2017-05-31,2,Bed Number 2,21,13,8
2017-05-31,3,Bed Number 3,60,38,22
2017-06-01,1,Bed Number 1,77,73,4
2017-06-01,2,Bed Number 2,17,1,16
2017-06-01,3,Bed Number 3,85,84,1
2017-06-02,1,Bed Number 1,62,51,11
2017-06-02,2,Bed Number 2,18,4,14
2017-06-02,3,Bed Number 3,12,3,9
2017-06-03,1,Bed Number 1,74,42,32
2017-06-03,2,Bed Number 2,52,48,4
2017-06-03,3,Bed Number 3,14,3,11
2017-06-04,1,Bed Number 1,45,14,31
2017-06-04,2,Bed Number 2,35,3,32
2017-06-04,3,Bed Number 3,67,36,31
2017-06-05,1,Bed Number 1,31,5,26
2017-06-05,2,Bed Number 2,77,62,15
2017-06-05,3,Bed Number 3,30,12,18
2017-06-06,1,Bed Number 1,64,16,48
2017-06-06,2,Bed Number 2,41,7,34
2017-06-06,3,Bed Number 3,52,17,35
2017-06-07,1,Bed Number 1,12,3,9
2017-06-07,2,Bed Number 2,50,12,38
2017-06-07,3,Bed Number 3,11,7,4
2017-06-08,1,Bed Number 1,62,53,9
2017-06-08,2,Bed Number 2,69,62,7
2017-06-08,3,Bed Number 3,15,11,4
2017-06-09,1,Bed Number 1,76,37,39
2017-06-09,2,Bed Number 2,66,1,65
2017-06-09,3,Bed Number 3,34,14,20
2017-06-10,1,Bed Number 1,88,35,53
2017-06-10,2,Bed Number 2,71,28,43
2017-06-10,3,Bed Number 3,55,13,42
2017-06-11,1,Bed Number 1,18,6,12
2017-06-11,2,Bed Number 2,16,2,14
2017-06-11,3,Bed Number 3,89,68,21
2017-06-12,1,Bed Number 1,11,8,3
2017-06-12,2,Bed Number 2,90,16,74
2017-06-12,3,Bed Number 3,62,15,47
2017-06-13,1,Bed Number 1,32,3,29
2017-06-13,2,Bed Number 2,31,7,24
2017-06-13,3,Bed Number 3,91,86,5
2017-06-14,1,Bed Number 1,16,11,5
2017-06-14,2,Bed Number 2,55,41,14
2017-06-14,3,Bed Number 3,53,51,2
2017-06-15,1,Bed Number 1,58,19,39
2017-06-15,2,Bed Number 2,34,27,7
2017-06-15,3,Bed Number 3,13,7,6
2017-06-16,1,Bed Number 1,60,40,20
2017-06-16,2,Bed Number 2,41,17,24
2017-06-16,3,Bed Number 3,40,40,0
2017-06-17,1,Bed Number 1,88,80,8
2017-06-17,2,Bed Number 2,82,10,72
2017-06-17,3,Bed Number 3,79,65,14
2017-06-18,1,Bed Number 1,12,9,3
2017-06-18,2,Bed Number 2,24,22,2
2017-06-18,3,Bed Number 3,47,24,23
2017-06-19,1,Bed Number 1,74,36,38
2017-06-19,2,Bed Number 2,97,21,76
2017-06-19,3,Bed Number 3,51,11,40
2017-06-20,1,Bed Number 1,93,39,54
2017-06-20,2,Bed Number 2,23,14,9
2017-06-20,3,Bed Number 3,66,10,56
2017-06-21,1,Bed Number 1,10,0,10
2017-06-21,2,Bed Number 2,32,15,17
2017-06-21,3,Bed Number 3,54,15,39
2017-06-22,1,Bed Number 1,50,50,0
2017-06-22,2,Bed Number 2,77,69,8
2017-06-22,3,Bed Number 3,72,72,0
2017-06-23,1,Bed Number 1,29,25,4
2017-06-23,2,Bed Number 2,13,3,10
2017-06-23,3,Bed Number 3,10,7,3
2017-06-24,1,Bed Number 1,82,34,48
2017-06-24,2,Bed Number 2,34,21,13
2017-06-24,3,Bed Number 3,29,28,1
2017-06-25,1,Bed Number 1,18,11,7
2017-06-25,2,Bed Number 2,24,16,8
2017-06-25,3,Bed Number 3,46,18,28
2017-06-26,1,Bed Number 1,73,62,11
2017-06-26,2,Bed Number 2,81,39,42
2017-06-26,3,Bed Number 3,53,14,39
2017-06-27,1,Bed Number 1,78,63,15
2017-06-27,2,Bed Number 2,13,10,3
2017-06-27,3,Bed Number 3,61,5,56
2017-06-28,1,Bed Number 1,93,48,45
2017-06-28,2,Bed Number 2,10,8,2
2017-06-28,3,Bed Number 3,38,18,20
2017-06-29,1,Bed Number 1,18,11,7
2017-06-29,2,Bed Number 2,85,54,31
2017-06-29,3,Bed Number 3,50,24,26
2017-06-30,1,Bed Number 1,29,8,21
2017-06-30,2,Bed Number 2,17,15,2
2017-06-30,3,Bed Number 3,29,4,25
2017-07-01,1,Bed Number 1,47,12,35
2017-07-01,2,Bed Number 2,38,23,15
2017-07-01,3,Bed Number 3,87,2,85
2017-07-02,1,Bed Number 1,79,19,60
2017-07-02,2,Bed Number 2,82,57,25
2017-07-02,3,Bed Number 3,15,11,4
2017-07-03,1,Bed Number 1,33,3,30
2017-07-03,2,Bed Number 2,58,45,13
2017-07-03,3,Bed Number 3,73,26,47
2017-07-04,1,Bed Number 1,37,23,14
2017-07-04,2,Bed Number 2,74,25,49
2017-07-04,3,Bed Number 3,73,28,45
2017-07-05,1,Bed Number 1,98,0,98
2017-07-05,2,Bed Number 2,74,42,32
2017-07-05,3,Bed Number 3,67,0,67
2017-07-06,1,Bed Number 1,59,29,30
2017-07-06,2,Bed Number 2,22,1,21
2017-07-06,3,Bed Number 3,61,4,57
2017-07-07,1,Bed Number 1,73,14,59
2017-07-07,2,Bed Number 2,78,29,49
2017-07-07,3,Bed Number 3,88,29,59
2017-07-08,1,Bed Number 1,81,64,17
2017-07-08,2,Bed Number 2,39,22,17
2017-07-08,3,Bed Number 3,82,80,2
2017-07-09,1,Bed Number 1,16,7,9
2017-07-09,2,Bed Number 2,18,8,10
2017-07-09,3,Bed Number 3,33,0,33
2017-07-10,1,Bed Number 1,55,11,44
2017-07-10,2,Bed Number 2,14,8,6
2017-07-10,3,Bed Number 3,43,19,24
2017-07-11,1,Bed Number 1,69,56,13
2017-07-11,2,Bed Number 2,12,0,12
2017-07-11,3,Bed Number 3,72,12,60
2017-07-12,1,Bed Number 1,35,14,21
2017-07-12,2,Bed Number 2,49,38,11
2017-07-12,3,Bed Number 3,60,0,60
2017-07-13,1,Bed Number 1,27,0,27
2017-07-13,2,Bed Number 2,29,14,15
2017-07-13,3,Bed Number 3,39,19,20
2017-07-14,1,Bed Number 1,47,19,28
2017-07-14,2,Bed Number 2,13,7,6
2017-07-14,3,Bed Number 3,97,8,89
2017-07-15,1,Bed Number 1,53,9,44
2017-07-15,2,Bed Number 2,81,40,41
2017-07-15,3,Bed Number 3,74,45,29
2017-07-16,1,Bed Number 1,12,5,7
2017-07-16,2,Bed Number 2,70,25,45
2017-07-16,3,Bed Number 3,86,34,52
2017-07-17,1,Bed Number 1,55,33,22
2017-07-17,2,Bed Number 2,39,5,34
2017-07-17,3,Bed Number 3,23,16,7
2017-07-18,1,Bed Number 1,47,35,12
2017-07-18,2,Bed Number 2,86,65,21
2017-07-18,3,Bed Number 3,66,32,34
2017-07-19,1,Bed Number 1,79,36,43
2017-07-19,2,Bed Number 2,52,26,26
2017-07-19,3,Bed Number 3,61,49,12
2017-07-20,1,Bed Number 1,88,83,5
2017-07-20,2,Bed Number 2,41,11,30
2017-07-20,3,Bed Number 3,11,6,5
2017-07-21,1,Bed Number 1,42,3,39
2017-07-21,2,Bed Number 2,47,22,25
2017-07-21,3,Bed Number 3,80,47,33
2017-07-22,1,Bed Number 1,22,9,13
2017-07-22,2,Bed Number 2,15,0,15
2017-07-22,3,Bed Number 3,51,33,18
2017-07-23,1,Bed Number 1,41,3,38
2017-07-23,2,Bed Number 2,58,22,36
2017-07-23,3,Bed Number 3,76,61,15
2017-07-24,1,Bed Number 1,63,41,22
2017-07-24,2,Bed Number 2,71,60,11
2017-07-24,3,Bed Number 3,38,24,14
2017-07-25,1,Bed Number 1,84,37,47
2017-07-25,2,Bed Number 2,73,70,3
2017-07-25,3,Bed Number 3,25,2,23
2017-07-26,1,Bed Number 1,32,0,32
2017-07-26,2,Bed Number 2,35,14,21
2017-07-26,3,Bed Number 3,65,57,8
2017-07-27,1,Bed Number 1,14,12,2
2017-07-27,2,Bed Number 2,30,19,11
2017-07-27,3,Bed Number 3,79,65,14
2017-07-28,1,Bed Number 1,39,25,14
2017-07-28,2,Bed Number 2,16,12,4
2017-07-28,3,Bed Number 3,18,9,9
2017-07-29,1,Bed Number 1,93,23,70
2017-07-29,2,Bed Number 2,71,61,10
2017-07-29,3,Bed Number 3,12,0,12
2017-07-30,1,Bed Number 1,25,18,7
2017-07-30,2,Bed Number 2,76,60,16
2017-07-30,3,Bed Number 3,100,33,67
2017-07-31,1,Bed Number 1,93,51,42
2017-07-31,2,Bed Number 2,19,7,12
2017-07-31,3,Bed Number 3,30,13,17
2017-08-01,1,Bed Number 1,12,9,3
2017-08-01,2,Bed Number 2,90,87,3
2017-08-01,3,Bed Number 3,37,4,33
2017-08-02,1,Bed Number 1,87,66,21
2017-08-02,2,Bed Number 2,73,19,54
2017-08-02,3,Bed Number 3,82,48,34
2017-08-03,1,Bed Number 1,15,4,11
2017-08-03,2,Bed Number 2,81,36,45
2017-08-03,3,Bed Number 3,50,28,22
2017-08-04,1,Bed Number 1,41,22,19
2017-08-04,2,Bed Number 2,61,51,10
2017-08-04,3,Bed Number 3,59,44,15
2017-08-05,1,Bed Number 1,59,50,9
2017-08-05,2,Bed Number 2,28,6,22
2017-08-05,3,Bed Number 3,80,65,15
2017-08-06,1,Bed Number 1,46,36,10
2017-08-06,2,Bed Number 2,64,12,52
2017-08-06,3,Bed Number 3,36,2,34
2017-08-07,1,Bed Number 1,91,5,86
2017-08-07,2,Bed Number 2,96,77,19
2017-08-07,3,Bed Number 3,28,0,28
2017-08-08,1,Bed Number 1,14,8,6
2017-08-08,2,Bed Number 2,29,12,17
2017-08-08,3,Bed Number 3,23,1,22
2017-08-09,1,Bed Number 1,42,41,1
2017-08-09,2,Bed Number 2,43,41,2
2017-08-09,3,Bed Number 3,46,2,44
2017-08-10,1,Bed Number 1,97,16,81
2017-08-10,2,Bed Number 2,45,3,42
2017-08-10,3,Bed Number 3,53,36,17
2017-08-11,1,Bed Number 1,95,40,55
2017-08-11,2,Bed Number 2,90,59,31
2017-08-11,3,Bed Number 3,37,37,0
2017-08-12,1,Bed Number 1,93,20,73
2017-08-12,2,Bed Number 2,53,39,14
2017-08-12,3,Bed Number 3,66,7,59
2017-08-13,1,Bed Number 1,65,27,38
2017-08-13,2,Bed Number 2,21,15,6
2017-08-13,3,Bed Number 3,27,1,26
2017-08-14,1,Bed Number 1,85,59,26
2017-08-14,2,Bed Number 2,78,38,40
2017-08-14,3,Bed Number 3,23,22,1
2017-08-15,1,Bed Number 1,66,24,42
2017-08-15,2,Bed Number 2,12,5,7
2017-08-15,3,Bed Number 3,17,15,2
2017-08-16,1,Bed Number 1,62,56,6
2017-08-16,2,Bed Number 2,74,43,31
2017-08-16,3,Bed Number 3,70,44,26
2017-08-17,1,Bed Number 1,75,20,55
2017-08-17,2,Bed Number 2,37,35,2
2017-08-17,3,Bed Number 3,76,41,35
2017-08-18,1,Bed Number 1,29,18,11
2017-08-18,2,Bed Number 2,24,19,5
2017-08-18,3,Bed Number 3,87,67,20
2017-08-19,1,Bed Number 1,84,57,27
2017-08-19,2,Bed Number 2,75,4,71
2017-08-19,3,Bed Number 3,29,7,22
2017-08-20,1,Bed Number 1,94,75,19
2017-08-20,2,Bed Number 2,50,0,50
2017-08-20,3,Bed Number 3,70,48,22
2017-08-21,1,Bed Number 1,84,14,70
2017-08-21,2,Bed Number 2,60,8,52
2017-08-21,3,Bed Number 3,31,6,25
2017-08-22,1,Bed Number 1,22,18,4
2017-08-22,2,Bed Number 2,42,30,12
2017-08-22,3,Bed Number 3,80,25,55
2017-08-23,1,Bed Number 1,73,62,11
2017-08-23,2,Bed Number 2,67,8,59
2017-08-23,3,Bed Number 3,69,28,41
2017-08-24,1,Bed Number 1,17,13,4
2017-08-24,2,Bed Number 2,39,23,16
2017-08-24,3,Bed Number 3,38,1,37
2017-08-25,1,Bed Number 1,41,27,14
2017-08-25,2,Bed Number 2,99,42,57
2017-08-25,3,Bed Number 3,65,9,56
2017-08-26,1,Bed Number 1,36,32,4
2017-08-26,2,Bed Number 2,15,2,13
2017-08-26,3,Bed Number 3,29,26,3
2017-08-27,1,Bed Number 1,58,32,26
2017-08-27,2,Bed Number 2,68,9,59
2017-08-27,3,Bed Number 3,50,40,10
2017-08-28,1,Bed Number 1,10,3,7
2017-08-28,2,Bed Number 2,93,5,88
2017-08-28,3,Bed Number 3,61,54,7
2017-08-29,1,Bed Number 1,33,29,4
2017-08-29,2,Bed Number 2,55,0,55
2017-08-29,3,Bed Number 3,69,2,67
2017-08-30,1,Bed Number 1,46,38,8
2017-08-30,2,Bed Number 2,93,58,35
2017-08-30,3,Bed Number 3,34,6,28
2017-08-31,1,Bed Number 1,22,1,21
2017-08-31,2,Bed Number 2,40,22,18
2017-08-31,3,Bed Number 3,89,66,23
2017-09-01,1,Bed Number 1,86,80,6
2017-09-01,2,Bed Number 2,53,51,2
2017-09-01,3,Bed Number 3,74,63,11
2017-09-02,1,Bed Number 1,44,4,40
2017-09-02,2,Bed Number 2,66,8,58
2017-09-02,3,Bed Number 3,72,56,16
2017-09-03,1,Bed Number 1,64,29,35
2017-09-03,2,Bed Number 2,25,23,2
2017-09-03,3,Bed Number 3,35,7,28
2017-09-04,1,Bed Number 1,99,82,17
2017-09-04,2,Bed Number 2,23,3,20
2017-09-04,3,Bed Number 3,62,61,1
2017-09-05,1,Bed Number 1,99,87,12
2017-09-05,2,Bed Number 2,45,26,19
2017-09-05,3,Bed Number 3,63,1,62
2017-09-06,1,Bed Number 1,89,6,83
2017-09-06,2,Bed Number 2,39,15,24
2017-09-06,3,Bed Number 3,61,37,24
2017-09-07,1,Bed Number 1,40,16,24
2017-09-07,2,Bed Number 2,49,26,23
2017-09-07,3,Bed Number 3,66,5,61
2017-09-08,1,Bed Number 1,98,3,95
2017-09-08,2,Bed Number 2,22,0,22
2017-09-08,3,Bed Number 3,98,93,5
2017-09-09,1,Bed Number 1,72,4,68
2017-09-09,2,Bed Number 2,95,13,82
2017-09-09,3,Bed Number 3,71,35,36
2017-09-10,1,Bed Number 1,48,44,4
2017-09-10,2,Bed Number 2,36,17,19
2017-09-10,3,Bed Number 3,47,32,15
2017-09-11,1,Bed Number 1,90,27,63
2017-09-11,2,Bed Number 2,63,42,21
2017-09-11,3,Bed Number 3,23,3,20
2017-09-12,1,Bed Number 1,92,74,18
2017-09-12,2,Bed Number 2,92,24,68
2017-09-12,3,Bed Number 3,96,96,0
2017-09-13,1,Bed Number 1,38,29,9
2017-09-13,2,Bed Number 2,99,29,70
2017-09-13,3,Bed Number 3,17,1,16
2017-09-14,1,Bed Number 1,41,38,3
2017-09-14,2,Bed Number 2,59,23,36
2017-09-14,3,Bed Number 3,44,32,12
2017-09-15,1,Bed Number 1,94,5,89
2017-09-15,2,Bed Number 2,69,36,33
2017-09-15,3,Bed Number 3,52,4,48
2017-09-16,1,Bed Number 1,24,23,1
2017-09-16,2,Bed Number 2,90,74,16
2017-09-16,3,Bed Number 3,81,13,68
2017-09-17,1,Bed Number 1,16,9,7
2017-09-17,2,Bed Number 2,61,18,43
2017-09-17,3,Bed Number 3,45,7,38
2017-09-18,1,Bed Number 1,45,14,31
2017-09-18,2,Bed Number 2,16,7,9
2017-09-18,3,Bed Number 3,57,48,9
2017-09-19,1,Bed Number 1,54,4,50
2017-09-19,2,Bed Number 2,82,75,7
2017-09-19,3,Bed Number 3,85,27,58
2017-09-20,1,Bed Number 1,96,52,44
2017-09-20,2,Bed Number 2,27,1,26
2017-09-20,3,Bed Number 3,70,23,47
2017-09-21,1,Bed Number 1,87,57,30
2017-09-21,2,Bed Number 2,14,5,9
2017-09-21,3,Bed Number 3,72,67,5
2017-09-22,1,Bed Number 1,16,7,9
2017-09-22,2,Bed Number 2,86,71,15
2017-09-22,3,Bed Number 3,61,42,19
2017-09-23,1,Bed Number 1,54,14,40
2017-09-23,2,Bed Number 2,97,13,84
2017-09-23,3,Bed Number 3,70,6,64
2017-09-24,1,Bed Number 1,39,5,34
2017-09-24,2,Bed Number 2,19,17,2
2017-09-24,3,Bed Number 3,76,64,12
2017-09-25,1,Bed Number 1,56,51,5
2017-09-25,2,Bed Number 2,28,4,24
2017-09-25,3,Bed Number 3,55,9,46
2017-09-26,1,Bed Number 1,33,11,22
2017-09-26,2,Bed Number 2,55,6,49
2017-09-26,3,Bed Number 3,40,5,35
2017-09-27,1,Bed Number 1,12,10,2
2017-09-27,2,Bed Number 2,14,14,0
2017-09-27,3,Bed Number 3,69,27,42
2017-09-28,1,Bed Number 1,53,22,31
2017-09-28,2,Bed Number 2,19,3,16
2017-09-28,3,Bed Number 3,11,7,4
2017-09-29,1,Bed Number 1,100,85,15
2017-09-29,2,Bed Number 2,26,21,5
2017-09-29,3,Bed Number 3,31,13,18
2017-09-30,1,Bed Number 1,71,59,12
2017-09-30,2,Bed Number 2,73,67,6
2017-09-30,3,Bed Number 3,49,13,36
2017-10-01,1,Bed Number 1,72,62,10
2017-10-01,2,Bed Number 2,39,19,20
2017-10-01,3,Bed Number 3,26,24,2
2017-10-02,1,Bed Number 1,71,57,14
2017-10-02,2,Bed Number 2,47,24,23
2017-10-02,3,Bed Number 3,70,32,38
2017-10-03,1,Bed Number 1,81,23,58
2017-10-03,2,Bed Number 2,95,45,50
2017-10-03,3,Bed Number 3,49,22,27
2017-10-04,1,Bed Number 1,64,27,37
2017-10-04,2,Bed Number 2,98,8,90
2017-10-04,3,Bed Number 3,93,23,70
2017-10-05,1,Bed Number 1,95,61,34
2017-10-05,2,Bed Number 2,68,31,37
2017-10-05,3,Bed Number 3,24,11,13
2017-10-06,1,Bed Number 1,13,3,10
2017-10-06,2,Bed Number 2,63,5,58
2017-10-06,3,Bed Number 3,37,2,35
2017-10-07,1,Bed Number 1,84,0,84
2017-10-07,2,Bed Number 2,39,31,8
2017-10-07,3,Bed Number 3,18,10,8
2017-10-08,1,Bed Number 1,53,8,45
2017-10-08,2,Bed Number 2,91,52,39
2017-10-08,3,Bed Number 3,91,8,83
2017-10-09,1,Bed Number 1,81,38,43
2017-10-09,2,Bed Number 2,84,50,34
2017-10-09,3,Bed Number 3,14,10,4
2017-10-10,1,Bed Number 1,70,41,29
2017-10-10,2,Bed Number 2,90,16,74
2017-10-10,3,Bed Number 3,65,8,57
2017-10-11,1,Bed Number 1,93,40,53
2017-10-11,2,Bed Number 2,45,38,7
2017-10-11,3,Bed Number 3,51,5,46
2017-10-12,1,Bed Number 1,24,17,7
2017-10-12,2,Bed Number 2,78,62,16
2017-10-12,3,Bed Number 3,79,39,40
2017-10-13,1,Bed Number 1,42,39,3
2017-10-13,2,Bed Number 2,76,3,73
2017-10-13,3,Bed Number 3,33,25,8
2017-10-14,1,Bed Number 1,30,30,0
2017-10-14,2,Bed Number 2,84,19,65
2017-10-14,3,Bed Number 3,31,27,4
2017-10-15,1,Bed Number 1,62,54,8
2017-10-15,2,Bed Number 2,83,57,26
2017-10-15,3,Bed Number 3,67,37,30
2017-10-16,1,Bed Number 1,54,25,29
2017-10-16,2,Bed Number 2,81,2,79
2017-10-16,3,Bed Number 3,70,38,32
2017-10-17,1,Bed Number 1,91,21,70
2017-10-17,2,Bed Number 2,77,14,63
2017-10-17,3,Bed Number 3,44,39,5
2017-10-18,1,Bed Number 1,82,62,20
2017-10-18,2,Bed Number 2,42,21,21
2017-10-18,3,Bed Number 3,96,24,72
2017-10-19,1,Bed Number 1,69,48,21
2017-10-19,2,Bed Number 2,53,12,41
2017-10-19,3,Bed Number 3,10,0,10
2017-10-20,1,Bed Number 1,98,60,38
2017-10-20,2,Bed Number 2,31,7,24
2017-10-20,3,Bed Number 3,50,30,20
2017-10-21,1,Bed Number 1,22,2,20
2017-10-21,2,Bed Number 2,67,1,66
2017-10-21,3,Bed Number 3,32,32,0
2017-10-22,1,Bed Number 1,10,9,1
2017-10-22,2,Bed Number 2,40,20,20
2017-10-22,3,Bed Number 3,55,48,7
2017-10-23,1,Bed Number 1,93,70,23
2017-10-23,2,Bed Number 2,54,30,24
2017-10-23,3,Bed Number 3,17,11,6
2017-10-24,1,Bed Number 1,96,11,85
2017-10-24,2,Bed Number 2,47,0,47
2017-10-24,3,Bed Number 3,92,73,19
2017-10-25,1,Bed Number 1,86,6,80
2017-10-25,2,Bed Number 2,56,36,20
2017-10-25,3,Bed Number 3,95,82,13
2017-10-26,1,Bed Number 1,19,0,19
2017-10-26,2,Bed Number 2,78,39,39
2017-10-26,3,Bed Number 3,44,18,26
2017-10-27,1,Bed Number 1,82,24,58
2017-10-27,2,Bed Number 2,89,55,34
2017-10-27,3,Bed Number 3,42,25,17
2017-10-28,1,Bed Number 1,87,47,40
2017-10-28,2,Bed Number 2,38,26,12
2017-10-28,3,Bed Number 3,77,71,6
2017-10-29,1,Bed Number 1,94,6,88
2017-10-29,2,Bed Number 2,57,31,26
2017-10-29,3,Bed Number 3,63,9,54
2017-10-30,1,Bed Number 1,86,80,6
2017-10-30,2,Bed Number 2,45,26,19
2017-10-30,3,Bed Number 3,37,11,26
2017-10-31,1,Bed Number 1,33,4,29
2017-10-31,2,Bed Number 2,21,0,21
2017-10-31,3,Bed Number 3,16,9,7
2017-11-01,1,Bed Number 1,36,33,3
2017-11-01,2,Bed Number 2,15,5,10
2017-11-01,3,Bed Number 3,34,11,23
2017-11-02,1,Bed Number 1,43,7,36
2017-11-02,2,Bed Number 2,82,64,18
2017-11-02,3,Bed Number 3,65,63,2
2017-11-03,1,Bed Number 1,49,49,0
2017-11-03,2,Bed Number 2,95,49,46
2017-11-03,3,Bed Number 3,89,60,29
2017-11-04,1,Bed Number 1,79,60,19
2017-11-04,2,Bed Number 2,20,8,12
2017-11-04,3,Bed Number 3,21,11,10
2017-11-05,1,Bed Number 1,30,21,9
2017-11-05,2,Bed Number 2,53,47,6
2017-11-05,3,Bed Number 3,79,30,49
2017-11-06,1,Bed Number 1,42,12,30
2017-11-06,2,Bed Number 2,54,1,53
2017-11-06,3,Bed Number 3,60,29,31
2017-11-07,1,Bed Number 1,69,16,53
2017-11-07,2,Bed Number 2,27,8,19
2017-11-07,3,Bed Number 3,28,12,16
2017-11-08,1,Bed Number 1,84,75,9
2017-11-08,2,Bed Number 2,100,44,56
2017-11-08,3,Bed Number 3,48,10,38
2017-11-09,1,Bed Number 1,74,26,48
2017-11-09,2,Bed Number 2,77,17,60
2017-11-09,3,Bed Number 3,13,7,6
2017-11-10,1,Bed Number 1,66,6,60
2017-11-10,2,Bed Number 2,53,10,43
2017-11-10,3,Bed Number 3,57,27,30
2017-11-11,1,Bed Number 1,76,75,1
2017-11-11,2,Bed Number 2,71,43,28
2017-11-11,3,Bed Number 3,42,4,38
2017-11-12,1,Bed Number 1,36,27,9
2017-11-12,2,Bed Number 2,64,33,31
2017-11-12,3,Bed Number 3,79,25,54
2017-11-13,1,Bed Number 1,18,7,11
2017-11-13,2,Bed Number 2,27,0,27
2017-11-13,3,Bed Number 3,32,25,7
2017-11-14,1,Bed Number 1,59,3,56
2017-11-14,2,Bed Number 2,62,9,53
2017-11-14,3,Bed Number 3,78,20,58
2017-11-15,1,Bed Number 1,43,12,31
2017-11-15,2,Bed Number 2,84,83,1
2017-11-15,3,Bed Number 3,63,37,26
2017-11-16,1,Bed Number 1,90,40,50
2017-11-16,2,Bed Number 2,35,30,5
2017-11-16,3,Bed Number 3,37,14,23
2017-11-17,1,Bed Number 1,45,27,18
2017-11-17,2,Bed Number 2,17,14,3
2017-11-17,3,Bed Number 3,46,44,2
2017-11-18,1,Bed Number 1,36,1,35
2017-11-18,2,Bed Number 2,12,7,5
2017-11-18,3,Bed Number 3,56,5,51
2017-11-19,1,Bed Number 1,63,34,29
2017-11-19,2,Bed Number 2,75,39,36
2017-11-19,3,Bed Number 3,79,71,8
2017-11-20,1,Bed Number 1,51,3,48
2017-11-20,2,Bed Number 2,58,8,50
2017-11-20,3,Bed Number 3,43,40,3
2017-11-21,1,Bed Number 1,88,83,5
2017-11-21,2,Bed Number 2,42,32,10
2017-11-21,3,Bed Number 3,53,48,5
2017-11-22,1,Bed Number 1,62,34,28
2017-11-22,2,Bed Number 2,70,42,28
2017-11-22,3,Bed Number 3,33,0,33
2017-11-23,1,Bed Number 1,95,41,54
2017-11-23,2,Bed Number 2,27,20,7
2017-11-23,3,Bed Number 3,54,51,3
2017-11-24,1,Bed Number 1,17,2,15
2017-11-24,2,Bed Number 2,58,3,55
2017-11-24,3,Bed Number 3,43,21,22
2017-11-25,1,Bed Number 1,29,29,0
2017-11-25,2,Bed Number 2,44,8,36
2017-11-25,3,Bed Number 3,60,56,4
2017-11-26,1,Bed Number 1,47,20,27
2017-11-26,2,Bed Number 2,36,32,4
2017-11-26,3,Bed Number 3,53,18,35
2017-11-27,1,Bed Number 1,75,57,18
2017-11-27,2,Bed Number 2,70,53,17
2017-11-27,3,Bed Number 3,82,12,70
2017-11-28,1,Bed Number 1,17,2,15
2017-11-28,2,Bed Number 2,23,9,14
2017-11-28,3,Bed Number 3,64,60,4
2017-11-29,1,Bed Number 1,74,6,68
2017-11-29,2,Bed Number 2,78,45,33
2017-11-29,3,Bed Number 3,69,16,53
2017-11-30,1,Bed Number 1,55,4,51
2017-11-30,2,Bed Number 2,44,9,35
2017-11-30,3,Bed Number 3,73,58,15
2017-12-01,1,Bed Number 1,57,2,55
2017-12-01,2,Bed Number 2,21,4,17
2017-12-01,3,Bed Number 3,89,62,27
2017-12-02,1,Bed Number 1,39,6,33
2017-12-02,2,Bed Number 2,45,19,26
2017-12-02,3,Bed Number 3,53,35,18
2017-12-03,1,Bed Number 1,95,9,86
2017-12-03,2,Bed Number 2,87,82,5
2017-12-03,3,Bed Number 3,24,5,19
2017-12-04,1,Bed Number 1,33,25,8
2017-12-04,2,Bed Number 2,58,23,35
2017-12-04,3,Bed Number 3,86,46,40
2017-12-05,1,Bed Number 1,89,57,32
2017-12-05,2,Bed Number 2,97,22,75
2017-12-05,3,Bed Number 3,64,39,25
2017-12-06,1,Bed Number 1,66,9,57
2017-12-06,2,Bed Number 2,89,35,54
2017-12-06,3,Bed Number 3,38,19,19
2017-12-07,1,Bed Number 1,45,33,12
2017-12-07,2,Bed Number 2,47,15,32
2017-12-07,3,Bed Number 3,11,7,4
2017-12-08,1,Bed Number 1,59,8,51
2017-12-08,2,Bed Number 2,92,4,88
2017-12-08,3,Bed Number 3,73,73,0
2017-12-09,1,Bed Number 1,32,13,19
2017-12-09,2,Bed Number 2,95,76,19
2017-12-09,3,Bed Number 3,98,90,8
2017-12-10,1,Bed Number 1,69,36,33
2017-12-10,2,Bed Number 2,44,33,11
2017-12-10,3,Bed Number 3,27,26,1
2017-12-11,1,Bed Number 1,36,18,18
2017-12-11,2,Bed Number 2,55,29,26
2017-12-11,3,Bed Number 3,92,10,82
2017-12-12,1,Bed Number 1,47,14,33
2017-12-12,2,Bed Number 2,30,2,28
2017-12-12,3,Bed Number 3,67,28,39
2017-12-13,1,Bed Number 1,89,45,44
2017-12-13,2,Bed Number 2,28,20,8
2017-12-13,3,Bed Number 3,88,74,14
2017-12-14,1,Bed Number 1,38,25,13
2017-12-14,2,Bed Number 2,22,8,14
2017-12-14,3,Bed Number 3,80,8,72
2017-12-15,1,Bed Number 1,54,5,49
2017-12-15,2,Bed Number 2,93,29,64
2017-12-15,3,Bed Number 3,38,6,32
2017-12-16,1,Bed Number 1,81,66,15
2017-12-16,2,Bed Number 2,55,22,33
2017-12-16,3,Bed Number 3,23,12,11
2017-12-17,1,Bed Number 1,81,69,12
2017-12-17,2,Bed Number 2,57,51,6
2017-12-17,3,Bed Number 3,86,39,47
2017-12-18,1,Bed Number 1,47,33,14
2017-12-18,2,Bed Number 2,61,53,8
2017-12-18,3,Bed Number 3,65,43,22
2017-12-19,1,Bed Number 1,22,9,13
2017-12-19,2,Bed Number 2,64,6,58
2017-12-19,3,Bed Number 3,85,58,27
2017-12-20,1,Bed Number 1,95,50,45
2017-12-20,2,Bed Number 2,81,71,10
2017-12-20,3,Bed Number 3,20,9,11
2017-12-21,1,Bed Number 1,92,78,14
2017-12-21,2,Bed Number 2,37,20,17
2017-12-21,3,Bed Number 3,91,11,80
2017-12-22,1,Bed Number 1,67,55,12
2017-12-22,2,Bed Number 2,45,34,11
2017-12-22,3,Bed Number 3,38,24,14
2017-12-23,1,Bed Number 1,36,12,24
2017-12-23,2,Bed Number 2,80,76,4
2017-12-23,3,Bed Number 3,93,76,17
2017-12-24,1,Bed Number 1,91,2,89
2017-12-24,2,Bed Number 2,17,17,0
2017-12-24,3,Bed Number 3,62,29,33
2017-12-25,1,Bed Number 1,16,12,4
2017-12-25,2,Bed Number 2,33,10,23
2017-12-25,3,Bed Number 3,78,49,29
2017-12-26,1,Bed Number 1,92,15,77
2017-12-26,2,Bed Number 2,39,6,33
2017-12-26,3,Bed Number 3,17,8,9
2017-12-27,1,Bed Number 1,43,0,43
2017-12-27,2,Bed Number 2,27,25,2
2017-12-27,3,Bed Number 3,17,0,17
2017-12-28,1,Bed Number 1,11,7,4
2017-12-28,2,Bed Number 2,84,62,22
2017-12-28,3,Bed Number 3,23,23,0
2017-12-29,1,Bed Number 1,25,24,1
2017-12-29,2,Bed Number 2,51,3,48
2017-12-29,3,Bed Number 3,17,0,17
2017-12-30,1,Bed Number 1,47,12,35
2017-12-30,2,Bed Number 2,64,49,15
2017-12-30,3,Bed Number 3,87,6,81
2017-12-31,1,Bed Number 1,71,26,45
2017-12-31,2,Bed Number 2,15,3,12
2017-12-31,3,Bed Number 3,15,14,1
2018-01-01,1,Bed Number 1,87,52,35
2018-01-01,2,Bed Number 2,60,56,4
2018-01-01,3,Bed Number 3,97,83,14
2018-01-02,1,Bed Number 1,18,7,11
2018-01-02,2,Bed Number 2,78,42,36
2018-01-02,3,Bed Number 3,21,5,16
2018-01-03,1,Bed Number 1,39,24,15
2018-01-03,2,Bed Number 2,49,11,38
2018-01-03,3,Bed Number 3,56,28,28
2018-01-04,1,Bed Number 1,28,0,28
2018-01-04,2,Bed Number 2,23,21,2
2018-01-04,3,Bed Number 3,23,20,3
2018-01-05,1,Bed Number 1,97,40,57
2018-01-05,2,Bed Number 2,73,47,26
2018-01-05,3,Bed Number 3,52,42,10
2018-01-06,1,Bed Number 1,60,9,51
2018-01-06,2,Bed Number 2,22,9,13
2018-01-06,3,Bed Number 3,78,46,32
2018-01-07,1,Bed Number 1,37,11,26
2018-01-07,2,Bed Number 2,96,57,39
2018-01-07,3,Bed Number 3,20,8,12
2018-01-08,1,Bed Number 1,46,29,17
2018-01-08,2,Bed Number 2,71,11,60
2018-01-08,3,Bed Number 3,25,20,5
2018-01-09,1,Bed Number 1,64,6,58
2018-01-09,2,Bed Number 2,48,19,29
2018-01-09,3,Bed Number 3,16,11,5
2018-01-10,1,Bed Number 1,34,3,31
2018-01-10,2,Bed Number 2,72,35,37
2018-01-10,3,Bed Number 3,31,21,10
2018-01-11,1,Bed Number 1,27,20,7
2018-01-11,2,Bed Number 2,36,19,17
2018-01-11,3,Bed Number 3,80,64,16
2018-01-12,1,Bed Number 1,94,25,69
2018-01-12,2,Bed Number 2,38,36,2
2018-01-12,3,Bed Number 3,77,20,57
2018-01-13,1,Bed Number 1,48,42,6
2018-01-13,2,Bed Number 2,39,6,33
2018-01-13,3,Bed Number 3,50,23,27
2018-01-14,1,Bed Number 1,38,32,6
2018-01-14,2,Bed Number 2,69,45,24
2018-01-14,3,Bed Number 3,18,5,13
2018-01-15,1,Bed Number 1,63,54,9
2018-01-15,2,Bed Number 2,21,14,7
2018-01-15,3,Bed Number 3,14,11,3
2018-01-16,1,Bed Number 1,63,24,39
2018-01-16,2,Bed Number 2,37,16,21
2018-01-16,3,Bed Number 3,50,7,43
2018-01-17,1,Bed Number 1,48,23,25
2018-01-17,2,Bed Number 2,73,19,54
2018-01-17,3,Bed Number 3,62,32,30
2018-01-18,1,Bed Number 1,67,25,42
2018-01-18,2,Bed Number 2,77,36,41
2018-01-18,3,Bed Number 3,84,76,8
2018-01-19,1,Bed Number 1,74,57,17
2018-01-19,2,Bed Number 2,100,64,36
2018-01-19,3,Bed Number 3,21,18,3
2018-01-20,1,Bed Number 1,64,59,5
2018-01-20,2,Bed Number 2,60,55,5
2018-01-20,3,Bed Number 3,89,18,71
2018-01-21,1,Bed Number 1,90,82,8
2018-01-21,2,Bed Number 2,27,13,14
2018-01-21,3,Bed Number 3,46,7,39
2018-01-22,1,Bed Number 1,60,34,26
2018-01-22,2,Bed Number 2,85,85,0
2018-01-22,3,Bed Number 3,89,23,66
2018-01-23,1,Bed Number 1,70,22,48
2018-01-23,2,Bed Number 2,55,41,14
2018-01-23,3,Bed Number 3,43,28,15
2018-01-24,1,Bed Number 1,52,14,38
2018-01-24,2,Bed Number 2,26,20,6
2018-01-24,3,Bed Number 3,74,43,31
2018-01-25,1,Bed Number 1,98,10,88
2018-01-25,2,Bed Number 2,12,4,8
2018-01-25,3,Bed Number 3,83,64,19
2018-01-26,1,Bed Number 1,48,11,37
2018-01-26,2,Bed Number 2,24,0,24
2018-01-26,3,Bed Number 3,92,66,26
2018-01-27,1,Bed Number 1,22,22,0
2018-01-27,2,Bed Number 2,79,40,39
2018-01-27,3,Bed Number 3,13,2,11
2018-01-28,1,Bed Number 1,71,5,66
2018-01-28,2,Bed Number 2,29,6,23
2018-01-28,3,Bed Number 3,66,6,60
2018-01-29,1,Bed Number 1,79,40,39
2018-01-29,2,Bed Number 2,74,44,30
2018-01-29,3,Bed Number 3,66,13,53
2018-01-30,1,Bed Number 1,86,73,13
2018-01-30,2,Bed Number 2,47,32,15
2018-01-30,3,Bed Number 3,78,35,43
2018-01-31,1,Bed Number 1,55,7,48
2018-01-31,2,Bed Number 2,19,0,19
2018-01-31,3,Bed Number 3,36,6,30
2018-02-01,1,Bed Number 1,66,9,57
2018-02-01,2,Bed Number 2,75,49,26
2018-02-01,3,Bed Number 3,49,40,9
2018-02-02,1,Bed Number 1,53,16,37
2018-02-02,2,Bed Number 2,33,11,22
2018-02-02,3,Bed Number 3,14,12,2
2018-02-03,1,Bed Number 1,22,6,16
2018-02-03,2,Bed Number 2,88,10,78
2018-02-03,3,Bed Number 3,82,27,55
2018-02-04,1,Bed Number 1,74,62,12
2018-02-04,2,Bed Number 2,27,23,4
2018-02-04,3,Bed Number 3,18,13,5
2018-02-05,1,Bed Number 1,19,13,6
2018-02-05,2,Bed Number 2,61,58,3
2018-02-05,3,Bed Number 3,22,8,14
2018-02-06,1,Bed Number 1,65,49,16
2018-02-06,2,Bed Number 2,40,26,14
2018-02-06,3,Bed Number 3,29,27,2
2018-02-07,1,Bed Number 1,78,41,37
2018-02-07,2,Bed Number 2,18,5,13
2018-02-07,3,Bed Number 3,70,28,42
2018-02-08,1,Bed Number 1,17,5,12
2018-02-08,2,Bed Number 2,76,47,29
2018-02-08,3,Bed Number 3,84,79,5
2018-02-09,1,Bed Number 1,17,11,6
2018-02-09,2,Bed Number 2,79,57,22
2018-02-09,3,Bed Number 3,33,16,17
2018-02-10,1,Bed Number 1,18,18,0
2018-02-10,2,Bed Number 2,51,24,27
2018-02-10,3,Bed Number 3,57,2,55
2018-02-11,1,Bed Number 1,30,8,22
2018-02-11,2,Bed Number 2,97,45,52
2018-02-11,3,Bed Number 3,76,6,70
2018-02-12,1,Bed Number 1,78,29,49
2018-02-12,2,Bed Number 2,25,14,11
2018-02-12,3,Bed Number 3,74,1,73
2018-02-13,1,Bed Number 1,45,31,14
2018-02-13,2,Bed Number 2,75,66,9
2018-02-13,3,Bed Number 3,68,35,33
2018-02-14,1,Bed Number 1,63,57,6
2018-02-14,2,Bed Number 2,22,19,3
2018-02-14,3,Bed Number 3,83,9,74
2018-02-15,1,Bed Number 1,37,33,4
2018-02-15,2,Bed Number 2,91,21,70
2018-02-15,3,Bed Number 3,73,71,2
2018-02-16,1,Bed Number 1,74,33,41
2018-02-16,2,Bed Number 2,83,37,46
2018-02-16,3,Bed Number 3,66,9,57
2018-02-17,1,Bed Number 1,21,10,11
2018-02-17,2,Bed Number 2,88,70,18
2018-02-17,3,Bed Number 3,51,24,27
2018-02-18,1,Bed Number 1,78,41,37
2018-02-18,2,Bed Number 2,86,61,25
2018-02-18,3,Bed Number 3,73,43,30
2018-02-19,1,Bed Number 1,35,18,17
2018-02-19,2,Bed Number 2,80,54,26
2018-02-19,3,Bed Number 3,85,46,39
2018-02-20,1,Bed Number 1,40,40,0
2018-02-20,2,Bed Number 2,27,14,13
2018-02-20,3,Bed Number 3,75,43,32
2018-02-21,1,Bed Number 1,82,64,18
2018-02-21,2,Bed Number 2,35,35,0
2018-02-21,3,Bed Number 3,30,17,13
2018-02-22,1,Bed Number 1,86,23,63
2018-02-22,2,Bed Number 2,19,13,6
2018-02-22,3,Bed Number 3,79,56,23
2018-02-23,1,Bed Number 1,74,30,44
2018-02-23,2,Bed Number 2,27,2,25
2018-02-23,3,Bed Number 3,72,65,7
2018-02-24,1,Bed Number 1,14,5,9
2018-02-24,2,Bed Number 2,78,21,57
2018-02-24,3,Bed Number 3,22,20,2
2018-02-25,1,Bed Number 1,22,22,0
2018-02-25,2,Bed Number 2,59,25,34
2018-02-25,3,Bed Number 3,37,34,3
2018-02-26,1,Bed Number 1,47,34,13
2018-02-26,2,Bed Number 2,78,76,2
2018-02-26,3,Bed Number 3,40,34,6
2018-02-27,1,Bed Number 1,25,15,10
2018-02-27,2,Bed Number 2,93,22,71
2018-02-27,3,Bed Number 3,20,17,3
2018-02-28,1,Bed Number 1,63,22,41
2018-02-28,2,Bed Number 2,89,85,4
2018-02-28,3,Bed Number 3,36,34,2
2018-03-01,1,Bed Number 1,93,27,66
2018-03-01,2,Bed Number 2,30,10,20
2018-03-01,3,Bed Number 3,46,44,2
2018-03-02,1,Bed Number 1,97,52,45
2018-03-02,2,Bed Number 2,38,13,25
2018-03-02,3,Bed Number 3,25,8,17
2018-03-03,1,Bed Number 1,26,4,22
2018-03-03,2,Bed Number 2,16,11,5
2018-03-03,3,Bed Number 3,25,13,12
2018-03-04,1,Bed Number 1,82,46,36
2018-03-04,2,Bed Number 2,22,18,4
2018-03-04,3,Bed Number 3,81,59,22
2018-03-05,1,Bed Number 1,32,5,27
2018-03-05,2,Bed Number 2,22,11,11
2018-03-05,3,Bed Number 3,46,17,29
2018-03-06,1,Bed Number 1,73,73,0
2018-03-06,2,Bed Number 2,46,24,22
2018-03-06,3,Bed Number 3,49,31,18
2018-03-07,1,Bed Number 1,90,66,24
2018-03-07,2,Bed Number 2,26,25,1
2018-03-07,3,Bed Number 3,14,10,4
2018-03-08,1,Bed Number 1,68,3,65
2018-03-08,2,Bed Number 2,77,46,31
2018-03-08,3,Bed Number 3,86,85,1
2018-03-09,1,Bed Number 1,89,38,51
2018-03-09,2,Bed Number 2,82,40,42
2018-03-09,3,Bed Number 3,74,41,33
2018-03-10,1,Bed Number 1,22,21,1
2018-03-10,2,Bed Number 2,94,41,53
2018-03-10,3,Bed Number 3,81,20,61
2018-03-11,1,Bed Number 1,71,34,37
2018-03-11,2,Bed Number 2,15,15,0
2018-03-11,3,Bed Number 3,75,43,32
2018-03-12,1,Bed Number 1,15,12,3
2018-03-12,2,Bed Number 2,99,20,79
2018-03-12,3,Bed Number 3,64,47,17
2018-03-13,1,Bed Number 1,47,12,35
2018-03-13,2,Bed Number 2,39,30,9
2018-03-13,3,Bed Number 3,31,7,24
2018-03-14,1,Bed Number 1,65,12,53
2018-03-14,2,Bed Number 2,10,4,6
2018-03-14,3,Bed Number 3,84,13,71
2018-03-15,1,Bed Number 1,70,63,7
2018-03-15,2,Bed Number 2,49,9,40
2018-03-15,3,Bed Number 3,100,33,67
2018-03-16,1,Bed Number 1,30,27,3
2018-03-16,2,Bed Number 2,55,35,20
2018-03-16,3,Bed Number 3,22,16,6
2018-03-17,1,Bed Number 1,45,0,45
2018-03-17,2,Bed Number 2,30,28,2
2018-03-17,3,Bed Number 3,17,16,1
2018-03-18,1,Bed Number 1,68,6,62
2018-03-18,2,Bed Number 2,32,31,1
2018-03-18,3,Bed Number 3,97,37,60
2018-03-19,1,Bed Number 1,94,61,33
2018-03-19,2,Bed Number 2,96,23,73
2018-03-19,3,Bed Number 3,50,31,19
2018-03-20,1,Bed Number 1,16,10,6
2018-03-20,2,Bed Number 2,77,25,52
2018-03-20,3,Bed Number 3,91,16,75
2018-03-21,1,Bed Number 1,35,9,26
2018-03-21,2,Bed Number 2,70,61,9
2018-03-21,3,Bed Number 3,12,9,3
2018-03-22,1,Bed Number 1,81,59,22
2018-03-22,2,Bed Number 2,52,33,19
2018-03-22,3,Bed Number 3,42,39,3
2018-03-23,1,Bed Number 1,50,33,17
2018-03-23,2,Bed Number 2,96,26,70
2018-03-23,3,Bed Number 3,46,43,3
2018-03-24,1,Bed Number 1,99,76,23
2018-03-24,2,Bed Number 2,40,14,26
2018-03-24,3,Bed Number 3,68,61,7
2018-03-25,1,Bed Number 1,88,3,85
2018-03-25,2,Bed Number 2,64,25,39
2018-03-25,3,Bed Number 3,26,8,18
2018-03-26,1,Bed Number 1,51,48,3
2018-03-26,2,Bed Number 2,42,18,24
2018-03-26,3,Bed Number 3,76,28,48
2018-03-27,1,Bed Number 1,69,54,15
2018-03-27,2,Bed Number 2,53,31,22
2018-03-27,3,Bed Number 3,35,29,6
2018-03-28,1,Bed Number 1,56,45,11
2018-03-28,2,Bed Number 2,30,6,24
2018-03-28,3,Bed Number 3,34,32,2
2018-03-29,1,Bed Number 1,70,12,58
2018-03-29,2,Bed Number 2,74,53,21
2018-03-29,3,Bed Number 3,94,40,54
2018-03-30,1,Bed Number 1,81,57,24
2018-03-30,2,Bed Number 2,67,15,52
2018-03-30,3,Bed Number 3,65,44,21
2018-03-31,1,Bed Number 1,13,5,8
2018-03-31,2,Bed Number 2,62,55,7
2018-03-31,3,Bed Number 3,61,6,55
2018-04-01,1,Bed Number 1,73,37,36
2018-04-01,2,Bed Number 2,49,31,18
2018-04-01,3,Bed Number 3,70,65,5
2018-04-02,1,Bed Number 1,33,29,4
2018-04-02,2,Bed Number 2,65,48,17
2018-04-02,3,Bed Number 3,70,43,27
2018-04-03,1,Bed Number 1,77,63,14
2018-04-03,2,Bed Number 2,35,29,6
2018-04-03,3,Bed Number 3,14,1,13
2018-04-04,1,Bed Number 1,94,68,26
2018-04-04,2,Bed Number 2,55,1,54
2018-04-04,3,Bed Number 3,85,12,73
2018-04-05,1,Bed Number 1,63,39,24
2018-04-05,2,Bed Number 2,57,38,19
2018-04-05,3,Bed Number 3,82,24,58
2018-04-06,1,Bed Number 1,41,34,7
2018-04-06,2,Bed Number 2,52,15,37
2018-04-06,3,Bed Number 3,90,57,33
2018-04-07,1,Bed Number 1,28,8,20
2018-04-07,2,Bed Number 2,71,47,24
2018-04-07,3,Bed Number 3,27,23,4
2018-04-08,1,Bed Number 1,99,28,71
2018-04-08,2,Bed Number 2,30,12,18
2018-04-08,3,Bed Number 3,85,12,73
2018-04-09,1,Bed Number 1,21,7,14
2018-04-09,2,Bed Number 2,100,32,68
2018-04-09,3,Bed Number 3,33,28,5
2018-04-10,1,Bed Number 1,89,8,81
2018-04-10,2,Bed Number 2,99,21,78
2018-04-10,3,Bed Number 3,81,67,14
2018-04-11,1,Bed Number 1,46,17,29
2018-04-11,2,Bed Number 2,66,10,56
2018-04-11,3,Bed Number 3,37,25,12
2018-04-12,1,Bed Number 1,31,21,10
2018-04-12,2,Bed Number 2,20,3,17
2018-04-12,3,Bed Number 3,50,35,15
2018-04-13,1,Bed Number 1,76,16,60
2018-04-13,2,Bed Number 2,62,38,24
2018-04-13,3,Bed Number 3,57,17,40
2018-04-14,1,Bed Number 1,93,46,47
2018-04-14,2,Bed Number 2,25,0,25
2018-04-14,3,Bed Number 3,53,15,38
2018-04-15,1,Bed Number 1,84,36,48
2018-04-15,2,Bed Number 2,84,23,61
2018-04-15,3,Bed Number 3,78,11,67
2018-04-16,1,Bed Number 1,26,17,9
2018-04-16,2,Bed Number 2,93,66,27
2018-04-16,3,Bed Number 3,53,49,4
2018-04-17,1,Bed Number 1,45,21,24
2018-04-17,2,Bed Number 2,70,58,12
2018-04-17,3,Bed Number 3,36,36,0
2018-04-18,1,Bed Number 1,22,15,7
2018-04-18,2,Bed Number 2,61,28,33
2018-04-18,3,Bed Number 3,19,15,4
2018-04-19,1,Bed Number 1,85,52,33
2018-04-19,2,Bed Number 2,23,1,22
2018-04-19,3,Bed Number 3,52,24,28
2018-04-20,1,Bed Number 1,79,55,24
2018-04-20,2,Bed Number 2,22,21,1
2018-04-20,3,Bed Number 3,15,15,0
2018-04-21,1,Bed Number 1,30,16,14
2018-04-21,2,Bed Number 2,17,13,4
2018-04-21,3,Bed Number 3,62,53,9
2018-04-22,1,Bed Number 1,38,27,11
2018-04-22,2,Bed Number 2,31,28,3
2018-04-22,3,Bed Number 3,49,13,36
2018-04-23,1,Bed Number 1,62,2,60
2018-04-23,2,Bed Number 2,63,28,35
2018-04-23,3,Bed Number 3,77,7,70
2018-04-24,1,Bed Number 1,16,10,6
2018-04-24,2,Bed Number 2,43,13,30
2018-04-24,3,Bed Number 3,36,2,34
2018-04-25,1,Bed Number 1,23,10,13
2018-04-25,2,Bed Number 2,59,11,48
2018-04-25,3,Bed Number 3,93,45,48
2018-04-26,1,Bed Number 1,64,52,12
2018-04-26,2,Bed Number 2,60,42,18
2018-04-26,3,Bed Number 3,82,32,50
2018-04-27,1,Bed Number 1,11,10,1
2018-04-27,2,Bed Number 2,98,43,55
2018-04-27,3,Bed Number 3,94,58,36
2018-04-28,1,Bed Number 1,81,32,49
2018-04-28,2,Bed Number 2,30,21,9
2018-04-28,3,Bed Number 3,93,70,23
2018-04-29,1,Bed Number 1,93,15,78
2018-04-29,2,Bed Number 2,68,24,44
2018-04-29,3,Bed Number 3,54,38,16
2018-04-30,1,Bed Number 1,34,0,34
2018-04-30,2,Bed Number 2,22,22,0
2018-04-30,3,Bed Number 3,13,6,7
2018-05-01,1,Bed Number 1,44,29,15
2018-05-01,2,Bed Number 2,85,14,71
2018-05-01,3,Bed Number 3,64,49,15
2018-05-02,1,Bed Number 1,63,5,58
2018-05-02,2,Bed Number 2,21,5,16
2018-05-02,3,Bed Number 3,15,1,14
2018-05-03,1,Bed Number 1,87,52,35
2018-05-03,2,Bed Number 2,71,42,29
2018-05-03,3,Bed Number 3,24,4,20
2018-05-04,1,Bed Number 1,84,35,49
2018-05-04,2,Bed Number 2,72,1,71
2018-05-04,3,Bed Number 3,35,21,14
2018-05-05,1,Bed Number 1,84,28,56
2018-05-05,2,Bed Number 2,47,31,16
2018-05-05,3,Bed Number 3,67,39,28
2018-05-06,1,Bed Number 1,43,11,32
2018-05-06,2,Bed Number 2,49,46,3
2018-05-06,3,Bed Number 3,34,16,18
2018-05-07,1,Bed Number 1,17,10,7
2018-05-07,2,Bed Number 2,34,31,3
2018-05-07,3,Bed Number 3,96,63,33
2018-05-08,1,Bed Number 1,47,25,22
2018-05-08,2,Bed Number 2,53,53,0
2018-05-08,3,Bed Number 3,24,19,5
2018-05-09,1,Bed Number 1,87,7,80
2018-05-09,2,Bed Number 2,34,16,18
2018-05-09,3,Bed Number 3,64,27,37
2018-05-10,1,Bed Number 1,18,18,0
2018-05-10,2,Bed Number 2,25,19,6
2018-05-10,3,Bed Number 3,65,63,2
2018-05-11,1,Bed Number 1,62,8,54
2018-05-11,2,Bed Number 2,44,24,20
2018-05-11,3,Bed Number 3,13,13,0
2018-05-12,1,Bed Number 1,32,12,20
2018-05-12,2,Bed Number 2,39,37,2
2018-05-12,3,Bed Number 3,81,8,73
2018-05-13,1,Bed Number 1,68,67,1
2018-05-13,2,Bed Number 2,22,17,5
2018-05-13,3,Bed Number 3,95,16,79
2018-05-14,1,Bed Number 1,25,9,16
2018-05-14,2,Bed Number 2,85,51,34
2018-05-14,3,Bed Number 3,34,16,18
2018-05-15,1,Bed Number 1,28,3,25
2018-05-15,2,Bed Number 2,90,78,12
2018-05-15,3,Bed Number 3,25,14,11
2018-05-16,1,Bed Number 1,82,72,10
2018-05-16,2,Bed Number 2,42,24,18
2018-05-16,3,Bed Number 3,80,75,5
2018-05-17,1,Bed Number 1,60,21,39
2018-05-17,2,Bed Number 2,61,42,19
2018-05-17,3,Bed Number 3,81,42,39
2018-05-18,1,Bed Number 1,72,65,7
2018-05-18,2,Bed Number 2,59,49,10
2018-05-18,3,Bed Number 3,82,53,29
2018-05-19,1,Bed Number 1,66,49,17
2018-05-19,2,Bed Number 2,12,1,11
2018-05-19,3,Bed Number 3,10,5,5
2018-05-20,1,Bed Number 1,46,42,4
2018-05-20,2,Bed Number 2,24,17,7
2018-05-20,3,Bed Number 3,42,41,1
2018-05-21,1,Bed Number 1,58,14,44
2018-05-21,2,Bed Number 2,87,35,52
2018-05-21,3,Bed Number 3,27,26,1
2018-05-22,1,Bed Number 1,83,28,55
2018-05-22,2,Bed Number 2,23,20,3
2018-05-22,3,Bed Number 3,71,42,29
2018-05-23,1,Bed Number 1,54,27,27
2018-05-23,2,Bed Number 2,84,64,20
2018-05-23,3,Bed Number 3,63,16,47
2018-05-24,1,Bed Number 1,11,10,1
2018-05-24,2,Bed Number 2,76,10,66
2018-05-24,3,Bed Number 3,58,32,26
2018-05-25,1,Bed Number 1,34,22,12
2018-05-25,2,Bed Number 2,39,22,17
2018-05-25,3,Bed Number 3,83,80,3
2018-05-26,1,Bed Number 1,35,9,26
2018-05-26,2,Bed Number 2,46,13,33
2018-05-26,3,Bed Number 3,83,35,48
2018-05-27,1,Bed Number 1,95,93,2
2018-05-27,2,Bed Number 2,54,26,28
2018-05-27,3,Bed Number 3,18,7,11
2018-05-28,1,Bed Number 1,64,31,33
2018-05-28,2,Bed Number 2,38,0,38
2018-05-28,3,Bed Number 3,23,5,18
2018-05-29,1,Bed Number 1,55,6,49
2018-05-29,2,Bed Number 2,48,38,10
2018-05-29,3,Bed Number 3,65,19,46
2018-05-30,1,Bed Number 1,88,29,59
2018-05-30,2,Bed Number 2,44,15,29
2018-05-30,3,Bed Number 3,78,51,27
2018-05-31,1,Bed Number 1,16,6,10
2018-05-31,2,Bed Number 2,24,14,10
2018-05-31,3,Bed Number 3,22,9,13
2018-06-01,1,Bed Number 1,70,62,8
2018-06-01,2,Bed Number 2,60,40,20
2018-06-01,3,Bed Number 3,26,3,23
2018-06-02,1,Bed Number 1,44,17,27
2018-06-02,2,Bed Number 2,33,5,28
2018-06-02,3,Bed Number 3,35,2,33
2018-06-03,1,Bed Number 1,82,51,31
2018-06-03,2,Bed Number 2,74,31,43
2018-06-03,3,Bed Number 3,62,28,34
2018-06-04,1,Bed Number 1,47,36,11
2018-06-04,2,Bed Number 2,57,18,39
2018-06-04,3,Bed Number 3,27,21,6
2018-06-05,1,Bed Number 1,27,21,6
2018-06-05,2,Bed Number 2,73,40,33
2018-06-05,3,Bed Number 3,70,21,49
2018-06-06,1,Bed Number 1,42,17,25
2018-06-06,2,Bed Number 2,22,3,19
2018-06-06,3,Bed Number 3,20,12,8
2018-06-07,1,Bed Number 1,47,33,14
2018-06-07,2,Bed Number 2,32,0,32
2018-06-07,3,Bed Number 3,24,8,16
2018-06-08,1,Bed Number 1,54,41,13
2018-06-08,2,Bed Number 2,44,17,27
2018-06-08,3,Bed Number 3,86,43,43
2018-06-09,1,Bed Number 1,22,18,4
2018-06-09,2,Bed Number 2,94,87,7
2018-06-09,3,Bed Number 3,59,49,10
2018-06-10,1,Bed Number 1,95,18,77
2018-06-10,2,Bed Number 2,39,21,18
2018-06-10,3,Bed Number 3,41,36,5
2018-06-11,1,Bed Number 1,59,3,56
2018-06-11,2,Bed Number 2,57,0,57
2018-06-11,3,Bed Number 3,17,9,8
2018-06-12,1,Bed Number 1,94,57,37
2018-06-12,2,Bed Number 2,76,74,2
2018-06-12,3,Bed Number 3,90,36,54
2018-06-13,1,Bed Number 1,94,44,50
2018-06-13,2,Bed Number 2,68,11,57
2018-06-13,3,Bed Number 3,73,72,1
2018-06-14,1,Bed Number 1,91,16,75
2018-06-14,2,Bed Number 2,67,21,46
2018-06-14,3,Bed Number 3,36,32,4
2018-06-15,1,Bed Number 1,10,8,2
2018-06-15,2,Bed Number 2,13,10,3
2018-06-15,3,Bed Number 3,67,60,7
2018-06-16,1,Bed Number 1,77,63,14
2018-06-16,2,Bed Number 2,10,3,7
2018-06-16,3,Bed Number 3,36,7,29
2018-06-17,1,Bed Number 1,13,4,9
2018-06-17,2,Bed Number 2,38,35,3
2018-06-17,3,Bed Number 3,65,38,27
2018-06-18,1,Bed Number 1,64,23,41
2018-06-18,2,Bed Number 2,49,24,25
2018-06-18,3,Bed Number 3,69,12,57
2018-06-19,1,Bed Number 1,12,12,0
2018-06-19,2,Bed Number 2,77,50,27
2018-06-19,3,Bed Number 3,85,75,10
2018-06-20,1,Bed Number 1,92,66,26
2018-06-20,2,Bed Number 2,46,14,32
2018-06-20,3,Bed Number 3,18,2,16
2018-06-21,1,Bed Number 1,89,25,64
2018-06-21,2,Bed Number 2,90,27,63
2018-06-21,3,Bed Number 3,44,21,23
2018-06-22,1,Bed Number 1,99,3,96
2018-06-22,2,Bed Number 2,80,12,68
2018-06-22,3,Bed Number 3,68,39,29
2018-06-23,1,Bed Number 1,86,28,58
2018-06-23,2,Bed Number 2,70,56,14
2018-06-23,3,Bed Number 3,36,7,29
2018-06-24,1,Bed Number 1,17,2,15
2018-06-24,2,Bed Number 2,49,33,16
2018-06-24,3,Bed Number 3,88,46,42
2018-06-25,1,Bed Number 1,62,61,1
2018-06-25,2,Bed Number 2,14,6,8
2018-06-25,3,Bed Number 3,73,27,46
2018-06-26,1,Bed Number 1,66,5,61
2018-06-26,2,Bed Number 2,71,31,40
2018-06-26,3,Bed Number 3,26,18,8
2018-06-27,1,Bed Number 1,98,40,58
2018-06-27,2,Bed Number 2,79,33,46
2018-06-27,3,Bed Number 3,97,78,19
2018-06-28,1,Bed Number 1,23,16,7
2018-06-28,2,Bed Number 2,82,0,82
2018-06-28,3,Bed Number 3,10,7,3
2018-06-29,1,Bed Number 1,60,39,21
2018-06-29,2,Bed Number 2,88,71,17
2018-06-29,3,Bed Number 3,84,39,45
2018-06-30,1,Bed Number 1,58,54,4
2018-06-30,2,Bed Number 2,43,26,17
2018-06-30,3,Bed Number 3,87,60,27
2018-07-01,1,Bed Number 1,69,18,51
2018-07-01,2,Bed Number 2,45,44,1
2018-07-01,3,Bed Number 3,77,24,53
2018-07-02,1,Bed Number 1,47,32,15
2018-07-02,2,Bed Number 2,18,9,9
2018-07-02,3,Bed Number 3,54,46,8
2018-07-03,1,Bed Number 1,12,0,12
2018-07-03,2,Bed Number 2,15,4,11
2018-07-03,3,Bed Number 3,67,15,52
2018-07-04,1,Bed Number 1,80,80,0
2018-07-04,2,Bed Number 2,74,23,51
2018-07-04,3,Bed Number 3,19,5,14
2018-07-05,1,Bed Number 1,16,5,11
2018-07-05,2,Bed Number 2,93,44,49
2018-07-05,3,Bed Number 3,53,26,27
2018-07-06,1,Bed Number 1,70,19,51
2018-07-06,2,Bed Number 2,58,44,14
2018-07-06,3,Bed Number 3,15,12,3
2018-07-07,1,Bed Number 1,87,35,52
2018-07-07,2,Bed Number 2,25,24,1
2018-07-07,3,Bed Number 3,21,8,13
2018-07-08,1,Bed Number 1,59,40,19
2018-07-08,2,Bed Number 2,17,9,8
2018-07-08,3,Bed Number 3,49,44,5
2018-07-09,1,Bed Number 1,30,1,29
2018-07-09,2,Bed Number 2,47,24,23
2018-07-09,3,Bed Number 3,96,8,88
2018-07-10,1,Bed Number 1,37,7,30
2018-07-10,2,Bed Number 2,86,19,67
2018-07-10,3,Bed Number 3,12,12,0
2018-07-11,1,Bed Number 1,95,86,9
2018-07-11,2,Bed Number 2,58,16,42
2018-07-11,3,Bed Number 3,66,34,32
2018-07-12,1,Bed Number 1,93,48,45
2018-07-12,2,Bed Number 2,69,46,23
2018-07-12,3,Bed Number 3,29,24,5
2018-07-13,1,Bed Number 1,28,7,21
2018-07-13,2,Bed Number 2,47,20,27
2018-07-13,3,Bed Number 3,67,53,14
2018-07-14,1,Bed Number 1,86,57,29
2018-07-14,2,Bed Number 2,81,77,4
2018-07-14,3,Bed Number 3,59,35,24
2018-07-15,1,Bed Number 1,36,22,14
2018-07-15,2,Bed Number 2,56,22,34
2018-07-15,3,Bed Number 3,76,16,60
2018-07-16,1,Bed Number 1,40,19,21
2018-07-16,2,Bed Number 2,53,8,45
2018-07-16,3,Bed Number 3,59,19,40
2018-07-17,1,Bed Number 1,98,46,52
2018-07-17,2,Bed Number 2,19,17,2
2018-07-17,3,Bed Number 3,44,40,4
2018-07-18,1,Bed Number 1,97,89,8
2018-07-18,2,Bed Number 2,83,76,7
2018-07-18,3,Bed Number 3,90,79,11
2018-07-19,1,Bed Number 1,91,3,88
2018-07-19,2,Bed Number 2,29,18,11
2018-07-19,3,Bed Number 3,89,55,34
2018-07-20,1,Bed Number 1,85,36,49
2018-07-20,2,Bed Number 2,68,9,59
2018-07-20,3,Bed Number 3,11,9,2
2018-07-21,1,Bed Number 1,53,22,31
2018-07-21,2,Bed Number 2,67,58,9
2018-07-21,3,Bed Number 3,72,39,33
2018-07-22,1,Bed Number 1,60,21,39
2018-07-22,2,Bed Number 2,18,2,16
2018-07-22,3,Bed Number 3,57,0,57
2018-07-23,1,Bed Number 1,39,7,32
2018-07-23,2,Bed Number 2,86,55,31
2018-07-23,3,Bed Number 3,85,52,33
2018-07-24,1,Bed Number 1,87,56,31
2018-07-24,2,Bed Number 2,16,11,5
2018-07-24,3,Bed Number 3,70,68,2
2018-07-25,1,Bed Number 1,41,14,27
2018-07-25,2,Bed Number 2,87,43,44
2018-07-25,3,Bed Number 3,71,20,51
2018-07-26,1,Bed Number 1,18,1,17
2018-07-26,2,Bed Number 2,39,23,16
2018-07-26,3,Bed Number 3,15,10,5
2018-07-27,1,Bed Number 1,77,29,48
2018-07-27,2,Bed Number 2,18,5,13
2018-07-27,3,Bed Number 3,96,21,75
2018-07-28,1,Bed Number 1,43,23,20
2018-07-28,2,Bed Number 2,15,5,10
2018-07-28,3,Bed Number 3,83,61,22
2018-07-29,1,Bed Number 1,34,16,18
2018-07-29,2,Bed Number 2,54,41,13
2018-07-29,3,Bed Number 3,37,15,22
2018-07-30,1,Bed Number 1,83,53,30
2018-07-30,2,Bed Number 2,65,11,54
2018-07-30,3,Bed Number 3,85,7,78
2018-07-31,1,Bed Number 1,18,12,6
2018-07-31,2,Bed Number 2,33,28,5
2018-07-31,3,Bed Number 3,31,13,18
2018-08-01,1,Bed Number 1,43,43,0
2018-08-01,2,Bed Number 2,75,6,69
2018-08-01,3,Bed Number 3,12,8,4
2018-08-02,1,Bed Number 1,47,45,2
2018-08-02,2,Bed Number 2,39,15,24
2018-08-02,3,Bed Number 3,89,59,30
2018-08-03,1,Bed Number 1,25,0,25
2018-08-03,2,Bed Number 2,21,10,11
2018-08-03,3,Bed Number 3,13,12,1
2018-08-04,1,Bed Number 1,73,59,14
2018-08-04,2,Bed Number 2,60,18,42
2018-08-04,3,Bed Number 3,99,69,30
2018-08-05,1,Bed Number 1,69,53,16
2018-08-05,2,Bed Number 2,10,5,5
2018-08-05,3,Bed Number 3,30,26,4
2018-08-06,1,Bed Number 1,20,9,11
2018-08-06,2,Bed Number 2,91,89,2
2018-08-06,3,Bed Number 3,36,33,3
2018-08-07,1,Bed Number 1,10,2,8
2018-08-07,2,Bed Number 2,54,54,0
2018-08-07,3,Bed Number 3,17,6,11
2018-08-08,1,Bed Number 1,61,35,26
2018-08-08,2,Bed Number 2,67,46,21
2018-08-08,3,Bed Number 3,89,19,70
2018-08-09,1,Bed Number 1,13,11,2
2018-08-09,2,Bed Number 2,36,10,26
2018-08-09,3,Bed Number 3,49,11,38
2018-08-10,1,Bed Number 1,73,12,61
2018-08-10,2,Bed Number 2,89,3,86
2018-08-10,3,Bed Number 3,63,1,62
2018-08-11,1,Bed Number 1,12,2,10
2018-08-11,2,Bed Number 2,16,16,0
2018-08-11,3,Bed Number 3,21,0,21
2018-08-12,1,Bed Number 1,36,15,21
2018-08-12,2,Bed Number 2,75,45,30
2018-08-12,3,Bed Number 3,67,16,51
2018-08-13,1,Bed Number 1,96,21,75
2018-08-13,2,Bed Number 2,42,24,18
2018-08-13,3,Bed Number 3,77,36,41
2018-08-14,1,Bed Number 1,28,28,0
2018-08-14,2,Bed Number 2,66,14,52
2018-08-14,3,Bed Number 3,97,27,70
2018-08-15,1,Bed Number 1,99,79,20
2018-08-15,2,Bed Number 2,83,12,71
2018-08-15,3,Bed Number 3,76,25,51
2018-08-16,1,Bed Number 1,20,6,14
2018-08-16,2,Bed Number 2,16,10,6
2018-08-16,3,Bed Number 3,54,30,24
2018-08-17,1,Bed Number 1,60,55,5
2018-08-17,2,Bed Number 2,72,25,47
2018-08-17,3,Bed Number 3,24,18,6
2018-08-18,1,Bed Number 1,91,41,50
2018-08-18,2,Bed Number 2,63,59,4
2018-08-18,3,Bed Number 3,23,21,2
2018-08-19,1,Bed Number 1,16,6,10
2018-08-19,2,Bed Number 2,78,51,27
2018-08-19,3,Bed Number 3,75,1,74
2018-08-20,1,Bed Number 1,29,2,27
2018-08-20,2,Bed Number 2,69,20,49
2018-08-20,3,Bed Number 3,11,10,1
2018-08-21,1,Bed Number 1,17,4,13
2018-08-21,2,Bed Number 2,61,47,14
2018-08-21,3,Bed Number 3,71,58,13
2018-08-22,1,Bed Number 1,54,17,37
2018-08-22,2,Bed Number 2,39,7,32
2018-08-22,3,Bed Number 3,66,45,21
2018-08-23,1,Bed Number 1,45,38,7
2018-08-23,2,Bed Number 2,50,20,30
2018-08-23,3,Bed Number 3,57,54,3
2018-08-24,1,Bed Number 1,90,48,42
2018-08-24,2,Bed Number 2,83,28,55
2018-08-24,3,Bed Number 3,55,35,20
2018-08-25,1,Bed Number 1,85,81,4
2018-08-25,2,Bed Number 2,76,32,44
2018-08-25,3,Bed Number 3,79,1,78
2018-08-26,1,Bed Number 1,19,19,0
2018-08-26,2,Bed Number 2,23,5,18
2018-08-26,3,Bed Number 3,87,25,62
2018-08-27,1,Bed Number 1,62,34,28
2018-08-27,2,Bed Number 2,47,37,10
2018-08-27,3,Bed Number 3,20,8,12
2018-08-28,1,Bed Number 1,25,13,12
2018-08-28,2,Bed Number 2,59,2,57
2018-08-28,3,Bed Number 3,53,37,16
2018-08-29,1,Bed Number 1,26,0,26
2018-08-29,2,Bed Number 2,50,44,6
2018-08-29,3,Bed Number 3,15,13,2
2018-08-30,1,Bed Number 1,54,0,54
2018-08-30,2,Bed Number 2,26,25,1
2018-08-30,3,Bed Number 3,77,48,29
2018-08-31,1,Bed Number 1,40,35,5
2018-08-31,2,Bed Number 2,82,20,62
2018-08-31,3,Bed Number 3,52,48,4
2018-09-01,1,Bed Number 1,56,51,5
2018-09-01,2,Bed Number 2,10,7,3
2018-09-01,3,Bed Number 3,19,0,19
2018-09-02,1,Bed Number 1,50,3,47
2018-09-02,2,Bed Number 2,23,8,15
2018-09-02,3,Bed Number 3,12,4,8
2018-09-03,1,Bed Number 1,35,33,2
2018-09-03,2,Bed Number 2,45,18,27
2018-09-03,3,Bed Number 3,38,29,9
2018-09-04,1,Bed Number 1,83,35,48
2018-09-04,2,Bed Number 2,86,63,23
2018-09-04,3,Bed Number 3,32,27,5
2018-09-05,1,Bed Number 1,89,22,67
2018-09-05,2,Bed Number 2,79,53,26
2018-09-05,3,Bed Number 3,98,7,91
2018-09-06,1,Bed Number 1,73,20,53
2018-09-06,2,Bed Number 2,85,52,33
2018-09-06,3,Bed Number 3,90,13,77
2018-09-07,1,Bed Number 1,45,0,45
2018-09-07,2,Bed Number 2,24,14,10
2018-09-07,3,Bed Number 3,78,16,62
2018-09-08,1,Bed Number 1,32,20,12
2018-09-08,2,Bed Number 2,53,50,3
2018-09-08,3,Bed Number 3,99,46,53
2018-09-09,1,Bed Number 1,78,60,18
2018-09-09,2,Bed Number 2,39,5,34
2018-09-09,3,Bed Number 3,54,23,31
2018-09-10,1,Bed Number 1,13,5,8
2018-09-10,2,Bed Number 2,50,12,38
2018-09-10,3,Bed Number 3,63,29,34
2018-09-11,1,Bed Number 1,55,50,5
2018-09-11,2,Bed Number 2,11,8,3
2018-09-11,3,Bed Number 3,71,4,67
2018-09-12,1,Bed Number 1,74,33,41
2018-09-12,2,Bed Number 2,51,41,10
2018-09-12,3,Bed Number 3,60,37,23
2018-09-13,1,Bed Number 1,65,3,62
2018-09-13,2,Bed Number 2,64,32,32
2018-09-13,3,Bed Number 3,35,8,27
2018-09-14,1,Bed Number 1,64,41,23
2018-09-14,2,Bed Number 2,78,15,63
2018-09-14,3,Bed Number 3,45,5,40
2018-09-15,1,Bed Number 1,47,27,20
2018-09-15,2,Bed Number 2,42,39,3
2018-09-15,3,Bed Number 3,50,11,39
2018-09-16,1,Bed Number 1,76,62,14
2018-09-16,2,Bed Number 2,20,7,13
2018-09-16,3,Bed Number 3,26,19,7
2018-09-17,1,Bed Number 1,72,19,53
2018-09-17,2,Bed Number 2,46,42,4
2018-09-17,3,Bed Number 3,18,6,12
2018-09-18,1,Bed Number 1,22,22,0
2018-09-18,2,Bed Number 2,76,1,75
2018-09-18,3,Bed Number 3,46,4,42
2018-09-19,1,Bed Number 1,10,2,8
2018-09-19,2,Bed Number 2,37,23,14
2018-09-19,3,Bed Number 3,91,27,64
2018-09-20,1,Bed Number 1,61,10,51
2018-09-20,2,Bed Number 2,48,30,18
2018-09-20,3,Bed Number 3,21,15,6
2018-09-21,1,Bed Number 1,62,17,45
2018-09-21,2,Bed Number 2,44,11,33
2018-09-21,3,Bed Number 3,76,51,25
2018-09-22,1,Bed Number 1,79,19,60
2018-09-22,2,Bed Number 2,97,69,28
2018-09-22,3,Bed Number 3,59,6,53
2018-09-23,1,Bed Number 1,42,19,23
2018-09-23,2,Bed Number 2,40,10,30
2018-09-23,3,Bed Number 3,53,33,20
2018-09-24,1,Bed Number 1,19,4,15
2018-09-24,2,Bed Number 2,41,21,20
2018-09-24,3,Bed Number 3,66,33,33
2018-09-25,1,Bed Number 1,35,3,32
2018-09-25,2,Bed Number 2,11,8,3
2018-09-25,3,Bed Number 3,12,12,0
2018-09-26,1,Bed Number 1,32,31,1
2018-09-26,2,Bed Number 2,11,6,5
2018-09-26,3,Bed Number 3,14,9,5
2018-09-27,1,Bed Number 1,32,29,3
2018-09-27,2,Bed Number 2,26,14,12
2018-09-27,3,Bed Number 3,28,23,5
2018-09-28,1,Bed Number 1,13,4,9
2018-09-28,2,Bed Number 2,40,31,9
2018-09-28,3,Bed Number 3,21,18,3
2018-09-29,1,Bed Number 1,91,33,58
2018-09-29,2,Bed Number 2,73,36,37
2018-09-29,3,Bed Number 3,75,32,43
2018-09-30,1,Bed Number 1,21,10,11
2018-09-30,2,Bed Number 2,26,25,1
2018-09-30,3,Bed Number 3,56,43,13
2018-10-01,1,Bed Number 1,68,42,26
2018-10-01,2,Bed Number 2,11,7,4
2018-10-01,3,Bed Number 3,51,22,29
2018-10-02,1,Bed Number 1,19,11,8
2018-10-02,2,Bed Number 2,89,29,60
2018-10-02,3,Bed Number 3,11,8,3
2018-10-03,1,Bed Number 1,72,31,41
2018-10-03,2,Bed Number 2,19,8,11
2018-10-03,3,Bed Number 3,75,5,70
2018-10-04,1,Bed Number 1,52,14,38
2018-10-04,2,Bed Number 2,55,9,46
2018-10-04,3,Bed Number 3,66,20,46
2018-10-05,1,Bed Number 1,16,5,11
2018-10-05,2,Bed Number 2,82,21,61
2018-10-05,3,Bed Number 3,43,14,29
2018-10-06,1,Bed Number 1,68,47,21
2018-10-06,2,Bed Number 2,10,0,10
2018-10-06,3,Bed Number 3,66,10,56
2018-10-07,1,Bed Number 1,83,65,18
2018-10-07,2,Bed Number 2,25,9,16
2018-10-07,3,Bed Number 3,17,13,4
2018-10-08,1,Bed Number 1,48,43,5
2018-10-08,2,Bed Number 2,10,6,4
2018-10-08,3,Bed Number 3,18,12,6
2018-10-09,1,Bed Number 1,23,4,19
2018-10-09,2,Bed Number 2,81,49,32
2018-10-09,3,Bed Number 3,28,7,21
2018-10-10,1,Bed Number 1,99,19,80
2018-10-10,2,Bed Number 2,24,13,11
2018-10-10,3,Bed Number 3,46,15,31
2018-10-11,1,Bed Number 1,56,27,29
2018-10-11,2,Bed Number 2,38,37,1
2018-10-11,3,Bed Number 3,47,47,0
2018-10-12,1,Bed Number 1,58,26,32
2018-10-12,2,Bed Number 2,87,9,78
2018-10-12,3,Bed Number 3,11,10,1
2018-10-13,1,Bed Number 1,17,0,17
2018-10-13,2,Bed Number 2,68,62,6
2018-10-13,3,Bed Number 3,38,25,13
2018-10-14,1,Bed Number 1,95,48,47
2018-10-14,2,Bed Number 2,26,24,2
2018-10-14,3,Bed Number 3,46,17,29
2018-10-15,1,Bed Number 1,92,19,73
2018-10-15,2,Bed Number 2,46,45,1
2018-10-15,3,Bed Number 3,31,19,12
2018-10-16,1,Bed Number 1,20,0,20
2018-10-16,2,Bed Number 2,58,42,16
2018-10-16,3,Bed Number 3,46,16,30
2018-10-17,1,Bed Number 1,92,30,62
2018-10-17,2,Bed Number 2,39,30,9
2018-10-17,3,Bed Number 3,91,78,13
2018-10-18,1,Bed Number 1,65,41,24
2018-10-18,2,Bed Number 2,98,48,50
2018-10-18,3,Bed Number 3,68,43,25
2018-10-19,1,Bed Number 1,10,0,10
2018-10-19,2,Bed Number 2,12,4,8
2018-10-19,3,Bed Number 3,26,7,19
2018-10-20,1,Bed Number 1,48,24,24
2018-10-20,2,Bed Number 2,24,22,2
2018-10-20,3,Bed Number 3,57,9,48
2018-10-21,1,Bed Number 1,79,0,79
2018-10-21,2,Bed Number 2,73,21,52
2018-10-21,3,Bed Number 3,58,52,6
2018-10-22,1,Bed Number 1,74,43,31
2018-10-22,2,Bed Number 2,83,13,70
2018-10-22,3,Bed Number 3,53,24,29
2018-10-23,1,Bed Number 1,33,16,17
2018-10-23,2,Bed Number 2,44,17,27
2018-10-23,3,Bed Number 3,28,15,13
2018-10-24,1,Bed Number 1,98,73,25
2018-10-24,2,Bed Number 2,14,14,0
2018-10-24,3,Bed Number 3,62,44,18
2018-10-25,1,Bed Number 1,83,60,23
2018-10-25,2,Bed Number 2,93,28,65
2018-10-25,3,Bed Number 3,88,27,61
2018-10-26,1,Bed Number 1,93,26,67
2018-10-26,2,Bed Number 2,27,14,13
2018-10-26,3,Bed Number 3,17,17,0
2018-10-27,1,Bed Number 1,38,36,2
2018-10-27,2,Bed Number 2,31,15,16
2018-10-27,3,Bed Number 3,60,32,28
2018-10-28,1,Bed Number 1,26,10,16
2018-10-28,2,Bed Number 2,16,4,12
2018-10-28,3,Bed Number 3,70,4,66
2018-10-29,1,Bed Number 1,75,26,49
2018-10-29,2,Bed Number 2,63,43,20
2018-10-29,3,Bed Number 3,54,21,33
2018-10-30,1,Bed Number 1,44,41,3
2018-10-30,2,Bed Number 2,37,20,17
2018-10-30,3,Bed Number 3,30,4,26
2018-10-31,1,Bed Number 1,43,6,37
2018-10-31,2,Bed Number 2,57,12,45
2018-10-31,3,Bed Number 3,45,34,11
2018-11-01,1,Bed Number 1,23,9,14
2018-11-01,2,Bed Number 2,66,11,55
2018-11-01,3,Bed Number 3,55,2,53
2018-11-02,1,Bed Number 1,98,77,21
2018-11-02,2,Bed Number 2,27,20,7
2018-11-02,3,Bed Number 3,61,55,6
2018-11-03,1,Bed Number 1,81,18,63
2018-11-03,2,Bed Number 2,78,41,37
2018-11-03,3,Bed Number 3,74,67,7
2018-11-04,1,Bed Number 1,13,13,0
2018-11-04,2,Bed Number 2,35,23,12
2018-11-04,3,Bed Number 3,47,22,25
2018-11-05,1,Bed Number 1,18,13,5
2018-11-05,2,Bed Number 2,99,28,71
2018-11-05,3,Bed Number 3,67,48,19
2018-11-06,1,Bed Number 1,18,6,12
2018-11-06,2,Bed Number 2,77,55,22
2018-11-06,3,Bed Number 3,11,5,6
2018-11-07,1,Bed Number 1,49,22,27
2018-11-07,2,Bed Number 2,65,32,33
2018-11-07,3,Bed Number 3,47,31,16
2018-11-08,1,Bed Number 1,23,15,8
2018-11-08,2,Bed Number 2,96,81,15
2018-11-08,3,Bed Number 3,38,16,22
2018-11-09,1,Bed Number 1,69,16,53
2018-11-09,2,Bed Number 2,43,20,23
2018-11-09,3,Bed Number 3,43,35,8
2018-11-10,1,Bed Number 1,75,34,41
2018-11-10,2,Bed Number 2,29,11,18
2018-11-10,3,Bed Number 3,26,17,9
2018-11-11,1,Bed Number 1,67,56,11
2018-11-11,2,Bed Number 2,22,16,6
2018-11-11,3,Bed Number 3,16,7,9
2018-11-12,1,Bed Number 1,13,11,2
2018-11-12,2,Bed Number 2,70,45,25
2018-11-12,3,Bed Number 3,59,12,47
2018-11-13,1,Bed Number 1,54,33,21
2018-11-13,2,Bed Number 2,88,16,72
2018-11-13,3,Bed Number 3,70,7,63
2018-11-14,1,Bed Number 1,92,78,14
2018-11-14,2,Bed Number 2,58,33,25
2018-11-14,3,Bed Number 3,24,0,24
2018-11-15,1,Bed Number 1,31,6,25
2018-11-15,2,Bed Number 2,52,12,40
2018-11-15,3,Bed Number 3,60,49,11
2018-11-16,1,Bed Number 1,38,12,26
2018-11-16,2,Bed Number 2,54,27,27
2018-11-16,3,Bed Number 3,44,18,26
2018-11-17,1,Bed Number 1,17,10,7
2018-11-17,2,Bed Number 2,92,46,46
2018-11-17,3,Bed Number 3,81,24,57
2018-11-18,1,Bed Number 1,82,1,81
2018-11-18,2,Bed Number 2,48,34,14
2018-11-18,3,Bed Number 3,83,6,77
2018-11-19,1,Bed Number 1,59,8,51
2018-11-19,2,Bed Number 2,51,14,37
2018-11-19,3,Bed Number 3,18,9,9
2018-11-20,1,Bed Number 1,12,5,7
2018-11-20,2,Bed Number 2,85,55,30
2018-11-20,3,Bed Number 3,17,14,3
2018-11-21,1,Bed Number 1,43,15,28
2018-11-21,2,Bed Number 2,28,13,15
2018-11-21,3,Bed Number 3,21,14,7
2018-11-22,1,Bed Number 1,50,18,32
2018-11-22,2,Bed Number 2,43,20,23
2018-11-22,3,Bed Number 3,27,21,6
2018-11-23,1,Bed Number 1,34,27,7
2018-11-23,2,Bed Number 2,94,38,56
2018-11-23,3,Bed Number 3,65,24,41
2018-11-24,1,Bed Number 1,80,39,41
2018-11-24,2,Bed Number 2,74,16,58
2018-11-24,3,Bed Number 3,49,35,14
2018-11-25,1,Bed Number 1,37,24,13
2018-11-25,2,Bed Number 2,10,4,6
2018-11-25,3,Bed Number 3,16,8,8
2018-11-26,1,Bed Number 1,39,19,20
2018-11-26,2,Bed Number 2,15,9,6
2018-11-26,3,Bed Number 3,78,22,56
2018-11-27,1,Bed Number 1,67,13,54
2018-11-27,2,Bed Number 2,12,9,3
2018-11-27,3,Bed Number 3,26,10,16
2018-11-28,1,Bed Number 1,17,4,13
2018-11-28,2,Bed Number 2,87,49,38
2018-11-28,3,Bed Number 3,74,26,48
2018-11-29,1,Bed Number 1,35,7,28
2018-11-29,2,Bed Number 2,32,23,9
2018-11-29,3,Bed Number 3,69,30,39
2018-11-30,1,Bed Number 1,67,34,33
2018-11-30,2,Bed Number 2,21,21,0
2018-11-30,3,Bed Number 3,55,9,46
2018-12-01,1,Bed Number 1,22,13,9
2018-12-01,2,Bed Number 2,81,35,46
2018-12-01,3,Bed Number 3,76,4,72
2018-12-02,1,Bed Number 1,96,92,4
2018-12-02,2,Bed Number 2,93,47,46
2018-12-02,3,Bed Number 3,68,31,37
2018-12-03,1,Bed Number 1,69,38,31
2018-12-03,2,Bed Number 2,19,1,18
2018-12-03,3,Bed Number 3,18,6,12
2018-12-04,1,Bed Number 1,51,22,29
2018-12-04,2,Bed Number 2,46,37,9
2018-12-04,3,Bed Number 3,68,23,45
2018-12-05,1,Bed Number 1,93,73,20
2018-12-05,2,Bed Number 2,41,0,41
2018-12-05,3,Bed Number 3,30,6,24
2018-12-06,1,Bed Number 1,51,8,43
2018-12-06,2,Bed Number 2,57,29,28
2018-12-06,3,Bed Number 3,15,8,7
2018-12-07,1,Bed Number 1,80,32,48
2018-12-07,2,Bed Number 2,37,7,30
2018-12-07,3,Bed Number 3,77,17,60
2018-12-08,1,Bed Number 1,71,21,50
2018-12-08,2,Bed Number 2,39,32,7
2018-12-08,3,Bed Number 3,99,8,91
2018-12-09,1,Bed Number 1,76,8,68
2018-12-09,2,Bed Number 2,96,42,54
2018-12-09,3,Bed Number 3,80,25,55
2018-12-10,1,Bed Number 1,62,30,32
2018-12-10,2,Bed Number 2,68,5,63
2018-12-10,3,Bed Number 3,37,11,26
2018-12-11,1,Bed Number 1,41,16,25
2018-12-11,2,Bed Number 2,87,46,41
2018-12-11,3,Bed Number 3,83,82,1
2018-12-12,1,Bed Number 1,26,20,6
2018-12-12,2,Bed Number 2,57,4,53
2018-12-12,3,Bed Number 3,34,13,21
2018-12-13,1,Bed Number 1,80,57,23
2018-12-13,2,Bed Number 2,11,8,3
2018-12-13,3,Bed Number 3,63,22,41
2018-12-14,1,Bed Number 1,47,28,19
2018-12-14,2,Bed Number 2,92,13,79
2018-12-14,3,Bed Number 3,42,35,7
2018-12-15,1,Bed Number 1,68,39,29
2018-12-15,2,Bed Number 2,73,4,69
2018-12-15,3,Bed Number 3,77,3,74
2018-12-16,1,Bed Number 1,32,20,12
2018-12-16,2,Bed Number 2,39,29,10
2018-12-16,3,Bed Number 3,54,39,15
2018-12-17,1,Bed Number 1,54,24,30
2018-12-17,2,Bed Number 2,90,63,27
2018-12-17,3,Bed Number 3,54,30,24
2018-12-18,1,Bed Number 1,51,23,28
2018-12-18,2,Bed Number 2,93,71,22
2018-12-18,3,Bed Number 3,96,70,26
2018-12-19,1,Bed Number 1,52,17,35
2018-12-19,2,Bed Number 2,53,12,41
2018-12-19,3,Bed Number 3,34,18,16
2018-12-20,1,Bed Number 1,55,10,45
2018-12-20,2,Bed Number 2,54,32,22
2018-12-20,3,Bed Number 3,85,73,12
2018-12-21,1,Bed Number 1,47,47,0
2018-12-21,2,Bed Number 2,17,2,15
2018-12-21,3,Bed Number 3,51,40,11
2018-12-22,1,Bed Number 1,53,53,0
2018-12-22,2,Bed Number 2,29,12,17
2018-12-22,3,Bed Number 3,61,18,43
2018-12-23,1,Bed Number 1,75,52,23
2018-12-23,2,Bed Number 2,94,17,77
2018-12-23,3,Bed Number 3,94,24,70
2018-12-24,1,Bed Number 1,46,11,35
2018-12-24,2,Bed Number 2,28,14,14
2018-12-24,3,Bed Number 3,19,9,10
2018-12-25,1,Bed Number 1,28,22,6
2018-12-25,2,Bed Number 2,10,9,1
2018-12-25,3,Bed Number 3,78,22,56
2018-12-26,1,Bed Number 1,84,63,21
2018-12-26,2,Bed Number 2,41,15,26
2018-12-26,3,Bed Number 3,37,16,21
2018-12-27,1,Bed Number 1,84,8,76
2018-12-27,2,Bed Number 2,16,10,6
2018-12-27,3,Bed Number 3,71,58,13
2018-12-28,1,Bed Number 1,99,56,43
2018-12-28,2,Bed Number 2,88,25,63
2018-12-28,3,Bed Number 3,95,67,28
2018-12-29,1,Bed Number 1,55,9,46
2018-12-29,2,Bed Number 2,16,5,11
2018-12-29,3,Bed Number 3,96,23,73
2018-12-30,1,Bed Number 1,17,4,13
2018-12-30,2,Bed Number 2,62,62,0
2018-12-30,3,Bed Number 3,78,22,56
2018-12-31,1,Bed Number 1,63,26,37
2018-12-31,2,Bed Number 2,79,17,62
2018-12-31,3,Bed Number 3,58,25,33
2019-01-01,1,Bed Number 1,97,56,41
2019-01-01,2,Bed Number 2,18,9,9
2019-01-01,3,Bed Number 3,98,73,25
2019-01-02,1,Bed Number 1,93,0,93
2019-01-02,2,Bed Number 2,43,29,14
2019-01-02,3,Bed Number 3,26,0,26
2019-01-03,1,Bed Number 1,34,12,22
2019-01-03,2,Bed Number 2,85,81,4
2019-01-03,3,Bed Number 3,94,21,73
2019-01-04,1,Bed Number 1,82,79,3
2019-01-04,2,Bed Number 2,62,5,57
2019-01-04,3,Bed Number 3,20,12,8
2019-01-05,1,Bed Number 1,15,10,5
2019-01-05,2,Bed Number 2,98,43,55
2019-01-05,3,Bed Number 3,38,9,29
2019-01-06,1,Bed Number 1,95,47,48
2019-01-06,2,Bed Number 2,14,0,14
2019-01-06,3,Bed Number 3,39,14,25
2019-01-07,1,Bed Number 1,75,25,50
2019-01-07,2,Bed Number 2,33,14,19
2019-01-07,3,Bed Number 3,45,36,9
2019-01-08,1,Bed Number 1,76,16,60
2019-01-08,2,Bed Number 2,22,14,8
2019-01-08,3,Bed Number 3,35,11,24
2019-01-09,1,Bed Number 1,85,31,54
2019-01-09,2,Bed Number 2,62,11,51
2019-01-09,3,Bed Number 3,38,11,27
2019-01-10,1,Bed Number 1,90,41,49
2019-01-10,2,Bed Number 2,17,13,4
2019-01-10,3,Bed Number 3,42,6,36
2019-01-11,1,Bed Number 1,45,40,5
2019-01-11,2,Bed Number 2,69,59,10
2019-01-11,3,Bed Number 3,33,4,29
2019-01-12,1,Bed Number 1,93,81,12
2019-01-12,2,Bed Number 2,14,11,3
2019-01-12,3,Bed Number 3,44,30,14
2019-01-13,1,Bed Number 1,73,3,70
2019-01-13,2,Bed Number 2,10,3,7
2019-01-13,3,Bed Number 3,46,21,25
2019-01-14,1,Bed Number 1,26,12,14
2019-01-14,2,Bed Number 2,70,28,42
2019-01-14,3,Bed Number 3,84,64,20
2019-01-15,1,Bed Number 1,35,10,25
2019-01-15,2,Bed Number 2,75,8,67
2019-01-15,3,Bed Number 3,13,12,1
2019-01-16,1,Bed Number 1,82,33,49
2019-01-16,2,Bed Number 2,31,14,17
2019-01-16,3,Bed Number 3,16,9,7
2019-01-17,1,Bed Number 1,49,41,8
2019-01-17,2,Bed Number 2,15,10,5
2019-01-17,3,Bed Number 3,36,25,11
2019-01-18,1,Bed Number 1,18,17,1
2019-01-18,2,Bed Number 2,37,10,27
2019-01-18,3,Bed Number 3,54,22,32
2019-01-19,1,Bed Number 1,81,63,18
2019-01-19,2,Bed Number 2,100,18,82
2019-01-19,3,Bed Number 3,27,8,19
2019-01-20,1,Bed Number 1,91,32,59
2019-01-20,2,Bed Number 2,92,29,63
2019-01-20,3,Bed Number 3,10,6,4
2019-01-21,1,Bed Number 1,61,32,29
2019-01-21,2,Bed Number 2,26,10,16
2019-01-21,3,Bed Number 3,67,62,5
2019-01-22,1,Bed Number 1,56,53,3
2019-01-22,2,Bed Number 2,43,2,41
2019-01-22,3,Bed Number 3,82,36,46
2019-01-23,1,Bed Number 1,42,14,28
2019-01-23,2,Bed Number 2,39,14,25
2019-01-23,3,Bed Number 3,74,7,67
2019-01-24,1,Bed Number 1,13,7,6
2019-01-24,2,Bed Number 2,42,14,28
2019-01-24,3,Bed Number 3,18,13,5
2019-01-25,1,Bed Number 1,72,16,56
2019-01-25,2,Bed Number 2,65,1,64
2019-01-25,3,Bed Number 3,66,27,39
2019-01-26,1,Bed Number 1,98,73,25
2019-01-26,2,Bed Number 2,87,59,28
2019-01-26,3,Bed Number 3,51,31,20
2019-01-27,1,Bed Number 1,70,46,24
2019-01-27,2,Bed Number 2,50,0,50
2019-01-27,3,Bed Number 3,66,8,58
2019-01-28,1,Bed Number 1,25,16,9
2019-01-28,2,Bed Number 2,19,8,11
2019-01-28,3,Bed Number 3,97,66,31
2019-01-29,1,Bed Number 1,100,15,85
2019-01-29,2,Bed Number 2,36,11,25
2019-01-29,3,Bed Number 3,64,54,10
2019-01-30,1,Bed Number 1,23,2,21
2019-01-30,2,Bed Number 2,45,31,14
2019-01-30,3,Bed Number 3,95,82,13
2019-01-31,1,Bed Number 1,14,10,4
2019-01-31,2,Bed Number 2,95,53,42
2019-01-31,3,Bed Number 3,100,44,56
2019-02-01,1,Bed Number 1,28,15,13
2019-02-01,2,Bed Number 2,82,3,79
2019-02-01,3,Bed Number 3,26,13,13
2019-02-02,1,Bed Number 1,67,35,32
2019-02-02,2,Bed Number 2,70,46,24
2019-02-02,3,Bed Number 3,23,9,14
2019-02-03,1,Bed Number 1,49,34,15
2019-02-03,2,Bed Number 2,38,1,37
2019-02-03,3,Bed Number 3,93,25,68
2019-02-04,1,Bed Number 1,45,15,30
2019-02-04,2,Bed Number 2,68,62,6
2019-02-04,3,Bed Number 3,37,12,25
2019-02-05,1,Bed Number 1,31,13,18
2019-02-05,2,Bed Number 2,97,0,97
2019-02-05,3,Bed Number 3,100,73,27
2019-02-06,1,Bed Number 1,94,80,14
2019-02-06,2,Bed Number 2,57,16,41
2019-02-06,3,Bed Number 3,94,56,38
2019-02-07,1,Bed Number 1,35,23,12
2019-02-07,2,Bed Number 2,36,29,7
2019-02-07,3,Bed Number 3,22,16,6
2019-02-08,1,Bed Number 1,16,1,15
2019-02-08,2,Bed Number 2,39,9,30
2019-02-08,3,Bed Number 3,91,67,24
2019-02-09,1,Bed Number 1,20,12,8
2019-02-09,2,Bed Number 2,50,9,41
2019-02-09,3,Bed Number 3,40,11,29
2019-02-10,1,Bed Number 1,98,17,81
2019-02-10,2,Bed Number 2,91,31,60
2019-02-10,3,Bed Number 3,100,64,36
2019-02-11,1,Bed Number 1,65,42,23
2019-02-11,2,Bed Number 2,28,4,24
2019-02-11,3,Bed Number 3,48,25,23
2019-02-12,1,Bed Number 1,28,16,12
2019-02-12,2,Bed Number 2,90,42,48
2019-02-12,3,Bed Number 3,61,49,12
2019-02-13,1,Bed Number 1,10,1,9
2019-02-13,2,Bed Number 2,99,55,44
2019-02-13,3,Bed Number 3,94,69,25
2019-02-14,1,Bed Number 1,100,91,9
2019-02-14,2,Bed Number 2,18,18,0
2019-02-14,3,Bed Number 3,59,50,9
2019-02-15,1,Bed Number 1,33,9,24
2019-02-15,2,Bed Number 2,22,4,18
2019-02-15,3,Bed Number 3,12,12,0
2019-02-16,1,Bed Number 1,49,45,4
2019-02-16,2,Bed Number 2,15,1,14
2019-02-16,3,Bed Number 3,22,7,15
2019-02-17,1,Bed Number 1,24,2,22
2019-02-17,2,Bed Number 2,94,61,33
2019-02-17,3,Bed Number 3,18,15,3
2019-02-18,1,Bed Number 1,81,20,61
2019-02-18,2,Bed Number 2,84,67,17
2019-02-18,3,Bed Number 3,19,13,6
2019-02-19,1,Bed Number 1,35,14,21
2019-02-19,2,Bed Number 2,24,6,18
2019-02-19,3,Bed Number 3,78,5,73
2019-02-20,1,Bed Number 1,50,34,16
2019-02-20,2,Bed Number 2,24,14,10
2019-02-20,3,Bed Number 3,93,24,69
2019-02-21,1,Bed Number 1,76,42,34
2019-02-21,2,Bed Number 2,53,15,38
2019-02-21,3,Bed Number 3,32,5,27
2019-02-22,1,Bed Number 1,27,3,24
2019-02-22,2,Bed Number 2,45,5,40
2019-02-22,3,Bed Number 3,54,10,44
2019-02-23,1,Bed Number 1,45,11,34
2019-02-23,2,Bed Number 2,40,14,26
2019-02-23,3,Bed Number 3,34,12,22
2019-02-24,1,Bed Number 1,60,4,56
2019-02-24,2,Bed Number 2,70,42,28
2019-02-24,3,Bed Number 3,95,80,15
2019-02-25,1,Bed Number 1,92,27,65
2019-02-25,2,Bed Number 2,76,72,4
2019-02-25,3,Bed Number 3,67,14,53
2019-02-26,1,Bed Number 1,40,8,32
2019-02-26,2,Bed Number 2,38,14,24
2019-02-26,3,Bed Number 3,53,32,21
2019-02-27,1,Bed Number 1,93,1,92
2019-02-27,2,Bed Number 2,77,26,51
2019-02-27,3,Bed Number 3,14,4,10
2019-02-28,1,Bed Number 1,58,35,23
2019-02-28,2,Bed Number 2,53,7,46
2019-02-28,3,Bed Number 3,97,87,10
2019-03-01,1,Bed Number 1,81,6,75
2019-03-01,2,Bed Number 2,49,32,17
2019-03-01,3,Bed Number 3,65,10,55
2019-03-02,1,Bed Number 1,66,47,19
2019-03-02,2,Bed Number 2,60,55,5
2019-03-02,3,Bed Number 3,27,13,14
2019-03-03,1,Bed Number 1,49,18,31
2019-03-03,2,Bed Number 2,100,84,16
2019-03-03,3,Bed Number 3,82,47,35
2019-03-04,1,Bed Number 1,77,51,26
2019-03-04,2,Bed Number 2,19,15,4
2019-03-04,3,Bed Number 3,96,83,13
2019-03-05,1,Bed Number 1,43,42,1
2019-03-05,2,Bed Number 2,35,18,17
2019-03-05,3,Bed Number 3,80,57,23
2019-03-06,1,Bed Number 1,59,46,13
2019-03-06,2,Bed Number 2,12,5,7
2019-03-06,3,Bed Number 3,21,11,10
2019-03-07,1,Bed Number 1,78,57,21
2019-03-07,2,Bed Number 2,36,19,17
2019-03-07,3,Bed Number 3,76,48,28
2019-03-08,1,Bed Number 1,39,15,24
2019-03-08,2,Bed Number 2,49,42,7
2019-03-08,3,Bed Number 3,82,4,78
2019-03-09,1,Bed Number 1,15,12,3
2019-03-09,2,Bed Number 2,23,20,3
2019-03-09,3,Bed Number 3,95,11,84
2019-03-10,1,Bed Number 1,24,5,19
2019-03-10,2,Bed Number 2,13,1,12
2019-03-10,3,Bed Number 3,46,5,41
2019-03-11,1,Bed Number 1,60,32,28
2019-03-11,2,Bed Number 2,59,55,4
2019-03-11,3,Bed Number 3,69,65,4
2019-03-12,1,Bed Number 1,36,36,0
2019-03-12,2,Bed Number 2,75,14,61
2019-03-12,3,Bed Number 3,13,3,10
2019-03-13,1,Bed Number 1,95,74,21
2019-03-13,2,Bed Number 2,42,32,10
2019-03-13,3,Bed Number 3,73,13,60
2019-03-14,1,Bed Number 1,87,20,67
2019-03-14,2,Bed Number 2,76,44,32
2019-03-14,3,Bed Number 3,74,49,25
2019-03-15,1,Bed Number 1,24,1,23
2019-03-15,2,Bed Number 2,12,0,12
2019-03-15,3,Bed Number 3,89,6,83
2019-03-16,1,Bed Number 1,34,11,23
2019-03-16,2,Bed Number 2,89,4,85
2019-03-16,3,Bed Number 3,46,27,19
2019-03-17,1,Bed Number 1,25,0,25
2019-03-17,2,Bed Number 2,79,5,74
2019-03-17,3,Bed Number 3,96,92,4
2019-03-18,1,Bed Number 1,22,12,10
2019-03-18,2,Bed Number 2,55,51,4
2019-03-18,3,Bed Number 3,45,22,23
2019-03-19,1,Bed Number 1,75,27,48
2019-03-19,2,Bed Number 2,20,20,0
2019-03-19,3,Bed Number 3,32,30,2
2019-03-20,1,Bed Number 1,85,84,1
2019-03-20,2,Bed Number 2,81,58,23
2019-03-20,3,Bed Number 3,15,1,14
2019-03-21,1,Bed Number 1,82,4,78
2019-03-21,2,Bed Number 2,37,32,5
2019-03-21,3,Bed Number 3,27,19,8
2019-03-22,1,Bed Number 1,66,62,4
2019-03-22,2,Bed Number 2,22,16,6
2019-03-22,3,Bed Number 3,37,3,34
2019-03-23,1,Bed Number 1,35,16,19
2019-03-23,2,Bed Number 2,18,11,7
2019-03-23,3,Bed Number 3,29,29,0
2019-03-24,1,Bed Number 1,46,18,28
2019-03-24,2,Bed Number 2,67,39,28
2019-03-24,3,Bed Number 3,42,21,21
2019-03-25,1,Bed Number 1,30,30,0
2019-03-25,2,Bed Number 2,10,2,8
2019-03-25,3,Bed Number 3,66,46,20
2019-03-26,1,Bed Number 1,44,38,6
2019-03-26,2,Bed Number 2,33,28,5
2019-03-26,3,Bed Number 3,39,26,13
2019-03-27,1,Bed Number 1,79,24,55
2019-03-27,2,Bed Number 2,91,81,10
2019-03-27,3,Bed Number 3,73,69,4
2019-03-28,1,Bed Number 1,47,19,28
2019-03-28,2,Bed Number 2,18,0,18
2019-03-28,3,Bed Number 3,59,25,34
2019-03-29,1,Bed Number 1,35,8,27
2019-03-29,2,Bed Number 2,77,24,53
2019-03-29,3,Bed Number 3,13,5,8
2019-03-30,1,Bed Number 1,94,71,23
2019-03-30,2,Bed Number 2,66,15,51
2019-03-30,3,Bed Number 3,63,34,29
2019-03-31,1,Bed Number 1,54,12,42
2019-03-31,2,Bed Number 2,23,13,10
2019-03-31,3,Bed Number 3,44,40,4
2019-04-01,1,Bed Number 1,45,30,15
2019-04-01,2,Bed Number 2,36,22,14
2019-04-01,3,Bed Number 3,79,6,73
2019-04-02,1,Bed Number 1,92,12,80
2019-04-02,2,Bed Number 2,36,8,28
2019-04-02,3,Bed Number 3,83,11,72
2019-04-03,1,Bed Number 1,76,8,68
2019-04-03,2,Bed Number 2,39,19,20
2019-04-03,3,Bed Number 3,20,7,13
2019-04-04,1,Bed Number 1,40,22,18
2019-04-04,2,Bed Number 2,52,15,37
2019-04-04,3,Bed Number 3,49,49,0
2019-04-05,1,Bed Number 1,41,35,6
2019-04-05,2,Bed Number 2,25,11,14
2019-04-05,3,Bed Number 3,96,67,29
2019-04-06,1,Bed Number 1,56,15,41
2019-04-06,2,Bed Number 2,61,39,22
2019-04-06,3,Bed Number 3,17,14,3
2019-04-07,1,Bed Number 1,64,47,17
2019-04-07,2,Bed Number 2,56,40,16
2019-04-07,3,Bed Number 3,44,31,13
2019-04-08,1,Bed Number 1,75,72,3
2019-04-08,2,Bed Number 2,25,0,25
2019-04-08,3,Bed Number 3,76,50,26
2019-04-09,1,Bed Number 1,83,77,6
2019-04-09,2,Bed Number 2,69,31,38
2019-04-09,3,Bed Number 3,10,4,6
2019-04-10,1,Bed Number 1,58,55,3
2019-04-10,2,Bed Number 2,80,40,40
2019-04-10,3,Bed Number 3,37,36,1
2019-04-11,1,Bed Number 1,25,1,24
2019-04-11,2,Bed Number 2,10,7,3
2019-04-11,3,Bed Number 3,45,21,24
2019-04-12,1,Bed Number 1,78,44,34
2019-04-12,2,Bed Number 2,72,32,40
2019-04-12,3,Bed Number 3,68,56,12
2019-04-13,1,Bed Number 1,40,4,36
2019-04-13,2,Bed Number 2,53,32,21
2019-04-13,3,Bed Number 3,48,21,27
2019-04-14,1,Bed Number 1,27,25,2
2019-04-14,2,Bed Number 2,14,2,12
2019-04-14,3,Bed Number 3,72,38,34
2019-04-15,1,Bed Number 1,26,24,2
2019-04-15,2,Bed Number 2,30,5,25
2019-04-15,3,Bed Number 3,52,38,14
2019-04-16,1,Bed Number 1,55,46,9
2019-04-16,2,Bed Number 2,19,7,12
2019-04-16,3,Bed Number 3,36,29,7
2019-04-17,1,Bed Number 1,54,43,11
2019-04-17,2,Bed Number 2,32,27,5
2019-04-17,3,Bed Number 3,72,31,41
2019-04-18,1,Bed Number 1,14,13,1
2019-04-18,2,Bed Number 2,40,16,24
2019-04-18,3,Bed Number 3,45,43,2
2019-04-19,1,Bed Number 1,46,13,33
2019-04-19,2,Bed Number 2,39,12,27
2019-04-19,3,Bed Number 3,11,10,1
2019-04-20,1,Bed Number 1,93,72,21
2019-04-20,2,Bed Number 2,63,56,7
2019-04-20,3,Bed Number 3,86,57,29
2019-04-21,1,Bed Number 1,37,18,19
2019-04-21,2,Bed Number 2,46,33,13
2019-04-21,3,Bed Number 3,56,17,39
2019-04-22,1,Bed Number 1,68,21,47
2019-04-22,2,Bed Number 2,68,30,38
2019-04-22,3,Bed Number 3,95,24,71
2019-04-23,1,Bed Number 1,76,36,40
2019-04-23,2,Bed Number 2,65,48,17
2019-04-23,3,Bed Number 3,78,34,44
2019-04-24,1,Bed Number 1,72,32,40
2019-04-24,2,Bed Number 2,34,13,21
2019-04-24,3,Bed Number 3,13,7,6
2019-04-25,1,Bed Number 1,18,10,8
2019-04-25,2,Bed Number 2,32,32,0
2019-04-25,3,Bed Number 3,29,5,24
2019-04-26,1,Bed Number 1,27,7,20
2019-04-26,2,Bed Number 2,79,0,79
2019-04-26,3,Bed Number 3,83,50,33
2019-04-27,1,Bed Number 1,14,7,7
2019-04-27,2,Bed Number 2,11,11,0
2019-04-27,3,Bed Number 3,41,35,6
2019-04-28,1,Bed Number 1,86,47,39
2019-04-28,2,Bed Number 2,80,0,80
2019-04-28,3,Bed Number 3,30,17,13
2019-04-29,1,Bed Number 1,100,28,72
2019-04-29,2,Bed Number 2,52,52,0
2019-04-29,3,Bed Number 3,82,67,15
2019-04-30,1,Bed Number 1,98,96,2
2019-04-30,2,Bed Number 2,14,9,5
2019-04-30,3,Bed Number 3,91,85,6
2019-05-01,1,Bed Number 1,60,33,27
2019-05-01,2,Bed Number 2,39,19,20
2019-05-01,3,Bed Number 3,69,41,28
2019-05-02,1,Bed Number 1,91,0,91
2019-05-02,2,Bed Number 2,65,64,1
2019-05-02,3,Bed Number 3,77,3,74
2019-05-03,1,Bed Number 1,72,25,47
2019-05-03,2,Bed Number 2,73,23,50
2019-05-03,3,Bed Number 3,84,6,78
2019-05-04,1,Bed Number 1,59,13,46
2019-05-04,2,Bed Number 2,39,0,39
2019-05-04,3,Bed Number 3,87,8,79
2019-05-05,1,Bed Number 1,44,31,13
2019-05-05,2,Bed Number 2,34,22,12
2019-05-05,3,Bed Number 3,28,8,20
2019-05-06,1,Bed Number 1,49,29,20
2019-05-06,2,Bed Number 2,47,35,12
2019-05-06,3,Bed Number 3,55,2,53
2019-05-07,1,Bed Number 1,93,71,22
2019-05-07,2,Bed Number 2,58,21,37
2019-05-07,3,Bed Number 3,21,7,14
2019-05-08,1,Bed Number 1,59,9,50
2019-05-08,2,Bed Number 2,58,58,0
2019-05-08,3,Bed Number 3,29,14,15
2019-05-09,1,Bed Number 1,39,2,37
2019-05-09,2,Bed Number 2,44,7,37
2019-05-09,3,Bed Number 3,83,73,10
2019-05-10,1,Bed Number 1,72,50,22
2019-05-10,2,Bed Number 2,59,49,10
2019-05-10,3,Bed Number 3,16,14,2
2019-05-11,1,Bed Number 1,95,52,43
2019-05-11,2,Bed Number 2,14,7,7
2019-05-11,3,Bed Number 3,97,57,40
2019-05-12,1,Bed Number 1,35,32,3
2019-05-12,2,Bed Number 2,96,66,30
2019-05-12,3,Bed Number 3,49,39,10
2019-05-13,1,Bed Number 1,67,14,53
2019-05-13,2,Bed Number 2,26,9,17
2019-05-13,3,Bed Number 3,20,0,20
2019-05-14,1,Bed Number 1,69,62,7
2019-05-14,2,Bed Number 2,28,6,22
2019-05-14,3,Bed Number 3,30,7,23
2019-05-15,1,Bed Number 1,50,32,18
2019-05-15,2,Bed Number 2,10,10,0
2019-05-15,3,Bed Number 3,72,24,48
2019-05-16,1,Bed Number 1,43,9,34
2019-05-16,2,Bed Number 2,40,22,18
2019-05-16,3,Bed Number 3,69,57,12
2019-05-17,1,Bed Number 1,13,3,10
2019-05-17,2,Bed Number 2,74,63,11
2019-05-17,3,Bed Number 3,72,43,29
2019-05-18,1,Bed Number 1,58,2,56
2019-05-18,2,Bed Number 2,72,11,61
2019-05-18,3,Bed Number 3,69,33,36
2019-05-19,1,Bed Number 1,76,40,36
2019-05-19,2,Bed Number 2,36,24,12
2019-05-19,3,Bed Number 3,85,78,7
2019-05-20,1,Bed Number 1,18,15,3
2019-05-20,2,Bed Number 2,15,5,10
2019-05-20,3,Bed Number 3,49,47,2
2019-05-21,1,Bed Number 1,32,25,7
2019-05-21,2,Bed Number 2,37,9,28
2019-05-21,3,Bed Number 3,89,59,30
2019-05-22,1,Bed Number 1,51,8,43
2019-05-22,2,Bed Number 2,94,67,27
2019-05-22,3,Bed Number 3,78,36,42
2019-05-23,1,Bed Number 1,49,12,37
2019-05-23,2,Bed Number 2,36,18,18
2019-05-23,3,Bed Number 3,17,2,15
2019-05-24,1,Bed Number 1,74,53,21
2019-05-24,2,Bed Number 2,66,9,57
2019-05-24,3,Bed Number 3,10,0,10
2019-05-25,1,Bed Number 1,87,47,40
2019-05-25,2,Bed Number 2,84,37,47
2019-05-25,3,Bed Number 3,49,31,18
2019-05-26,1,Bed Number 1,39,35,4
2019-05-26,2,Bed Number 2,14,14,0
2019-05-26,3,Bed Number 3,65,55,10
2019-05-27,1,Bed Number 1,11,9,2
2019-05-27,2,Bed Number 2,63,28,35
2019-05-27,3,Bed Number 3,46,2,44
2019-05-28,1,Bed Number 1,44,17,27
2019-05-28,2,Bed Number 2,15,5,10
2019-05-28,3,Bed Number 3,95,39,56
2019-05-29,1,Bed Number 1,38,33,5
2019-05-29,2,Bed Number 2,23,0,23
2019-05-29,3,Bed Number 3,89,87,2
2019-05-30,1,Bed Number 1,83,20,63
2019-05-30,2,Bed Number 2,32,31,1
2019-05-30,3,Bed Number 3,72,20,52
2019-05-31,1,Bed Number 1,57,39,18
2019-05-31,2,Bed Number 2,34,25,9
2019-05-31,3,Bed Number 3,35,0,35
2019-06-01,1,Bed Number 1,80,71,9
2019-06-01,2,Bed Number 2,18,18,0
2019-06-01,3,Bed Number 3,36,34,2
2019-06-02,1,Bed Number 1,44,4,40
2019-06-02,2,Bed Number 2,14,10,4
2019-06-02,3,Bed Number 3,24,2,22
2019-06-03,1,Bed Number 1,75,12,63
2019-06-03,2,Bed Number 2,29,29,0
2019-06-03,3,Bed Number 3,69,20,49
2019-06-04,1,Bed Number 1,59,13,46
2019-06-04,2,Bed Number 2,32,31,1
2019-06-04,3,Bed Number 3,39,22,17
2019-06-05,1,Bed Number 1,55,48,7
2019-06-05,2,Bed Number 2,61,17,44
2019-06-05,3,Bed Number 3,29,5,24
2019-06-06,1,Bed Number 1,37,34,3
2019-06-06,2,Bed Number 2,41,35,6
2019-06-06,3,Bed Number 3,37,28,9
2019-06-07,1,Bed Number 1,21,2,19
2019-06-07,2,Bed Number 2,99,32,67
2019-06-07,3,Bed Number 3,90,40,50
2019-06-08,1,Bed Number 1,71,59,12
2019-06-08,2,Bed Number 2,28,25,3
2019-06-08,3,Bed Number 3,78,64,14
2019-06-09,1,Bed Number 1,12,0,12
2019-06-09,2,Bed Number 2,56,52,4
2019-06-09,3,Bed Number 3,69,42,27
2019-06-10,1,Bed Number 1,52,38,14
2019-06-10,2,Bed Number 2,76,8,68
2019-06-10,3,Bed Number 3,95,64,31
2019-06-11,1,Bed Number 1,64,45,19
2019-06-11,2,Bed Number 2,34,26,8
2019-06-11,3,Bed Number 3,53,5,48
2019-06-12,1,Bed Number 1,55,19,36
2019-06-12,2,Bed Number 2,23,4,19
2019-06-12,3,Bed Number 3,81,5,76
2019-06-13,1,Bed Number 1,97,17,80
2019-06-13,2,Bed Number 2,76,30,46
2019-06-13,3,Bed Number 3,85,22,63
2019-06-14,1,Bed Number 1,79,13,66
2019-06-14,2,Bed Number 2,73,65,8
2019-06-14,3,Bed Number 3,81,13,68
2019-06-15,1,Bed Number 1,22,11,11
2019-06-15,2,Bed Number 2,27,14,13
2019-06-15,3,Bed Number 3,55,31,24
2019-06-16,1,Bed Number 1,11,1,10
2019-06-16,2,Bed Number 2,71,68,3
2019-06-16,3,Bed Number 3,89,57,32
2019-06-17,1,Bed Number 1,76,5,71
2019-06-17,2,Bed Number 2,14,7,7
2019-06-17,3,Bed Number 3,74,61,13
2019-06-18,1,Bed Number 1,33,0,33
2019-06-18,2,Bed Number 2,74,27,47
2019-06-18,3,Bed Number 3,20,1,19
2019-06-19,1,Bed Number 1,93,90,3
2019-06-19,2,Bed Number 2,87,44,43
2019-06-19,3,Bed Number 3,11,8,3
2019-06-20,1,Bed Number 1,49,11,38
2019-06-20,2,Bed Number 2,29,10,19
2019-06-20,3,Bed Number 3,27,3,24
2019-06-21,1,Bed Number 1,64,49,15
2019-06-21,2,Bed Number 2,62,28,34
2019-06-21,3,Bed Number 3,80,37,43
2019-06-22,1,Bed Number 1,99,98,1
2019-06-22,2,Bed Number 2,29,25,4
2019-06-22,3,Bed Number 3,61,45,16
2019-06-23,1,Bed Number 1,99,31,68
2019-06-23,2,Bed Number 2,32,25,7
2019-06-23,3,Bed Number 3,16,10,6
2019-06-24,1,Bed Number 1,57,42,15
2019-06-24,2,Bed Number 2,85,52,33
2019-06-24,3,Bed Number 3,93,22,71
2019-06-25,1,Bed Number 1,18,12,6
2019-06-25,2,Bed Number 2,38,12,26
2019-06-25,3,Bed Number 3,74,39,35
2019-06-26,1,Bed Number 1,98,66,32
2019-06-26,2,Bed Number 2,66,19,47
2019-06-26,3,Bed Number 3,41,16,25
2019-06-27,1,Bed Number 1,40,31,9
2019-06-27,2,Bed Number 2,12,10,2
2019-06-27,3,Bed Number 3,21,13,8
2019-06-28,1,Bed Number 1,79,14,65
2019-06-28,2,Bed Number 2,18,2,16
2019-06-28,3,Bed Number 3,19,5,14
2019-06-29,1,Bed Number 1,61,11,50
2019-06-29,2,Bed Number 2,96,38,58
2019-06-29,3,Bed Number 3,34,31,3
2019-06-30,1,Bed Number 1,73,22,51
2019-06-30,2,Bed Number 2,49,37,12
2019-06-30,3,Bed Number 3,75,21,54
2019-07-01,1,Bed Number 1,97,54,43
2019-07-01,2,Bed Number 2,98,6,92
2019-07-01,3,Bed Number 3,99,70,29
2019-07-02,1,Bed Number 1,40,2,38
2019-07-02,2,Bed Number 2,14,13,1
2019-07-02,3,Bed Number 3,79,14,65
2019-07-03,1,Bed Number 1,81,68,13
2019-07-03,2,Bed Number 2,96,35,61
2019-07-03,3,Bed Number 3,47,47,0
2019-07-04,1,Bed Number 1,33,23,10
2019-07-04,2,Bed Number 2,54,10,44
2019-07-04,3,Bed Number 3,43,39,4
2019-07-05,1,Bed Number 1,45,45,0
2019-07-05,2,Bed Number 2,91,57,34
2019-07-05,3,Bed Number 3,26,15,11
2019-07-06,1,Bed Number 1,72,62,10
2019-07-06,2,Bed Number 2,69,59,10
2019-07-06,3,Bed Number 3,57,44,13
2019-07-07,1,Bed Number 1,19,15,4
2019-07-07,2,Bed Number 2,46,15,31
2019-07-07,3,Bed Number 3,69,67,2
2019-07-08,1,Bed Number 1,45,38,7
2019-07-08,2,Bed Number 2,29,14,15
2019-07-08,3,Bed Number 3,77,44,33
2019-07-09,1,Bed Number 1,55,35,20
2019-07-09,2,Bed Number 2,22,0,22
2019-07-09,3,Bed Number 3,65,37,28
2019-07-10,1,Bed Number 1,61,24,37
2019-07-10,2,Bed Number 2,82,29,53
2019-07-10,3,Bed Number 3,88,51,37
2019-07-11,1,Bed Number 1,80,14,66
2019-07-11,2,Bed Number 2,27,15,12
2019-07-11,3,Bed Number 3,14,2,12
2019-07-12,1,Bed Number 1,45,7,38
2019-07-12,2,Bed Number 2,48,42,6
2019-07-12,3,Bed Number 3,53,43,10
2019-07-13,1,Bed Number 1,92,26,66
2019-07-13,2,Bed Number 2,84,84,0
2019-07-13,3,Bed Number 3,45,39,6
2019-07-14,1,Bed Number 1,72,34,38
2019-07-14,2,Bed Number 2,89,58,31
2019-07-14,3,Bed Number 3,45,23,22
2019-07-15,1,Bed Number 1,84,4,80
2019-07-15,2,Bed Number 2,85,78,7
2019-07-15,3,Bed Number 3,10,10,0
2019-07-16,1,Bed Number 1,95,54,41
2019-07-16,2,Bed Number 2,87,67,20
2019-07-16,3,Bed Number 3,19,19,0
2019-07-17,1,Bed Number 1,73,57,16
2019-07-17,2,Bed Number 2,83,43,40
2019-07-17,3,Bed Number 3,90,32,58
2019-07-18,1,Bed Number 1,92,27,65
2019-07-18,2,Bed Number 2,99,15,84
2019-07-18,3,Bed Number 3,94,42,52
2019-07-19,1,Bed Number 1,40,19,21
2019-07-19,2,Bed Number 2,95,27,68
2019-07-19,3,Bed Number 3,22,0,22
2019-07-20,1,Bed Number 1,96,42,54
2019-07-20,2,Bed Number 2,49,1,48
2019-07-20,3,Bed Number 3,99,36,63
2019-07-21,1,Bed Number 1,75,27,48
2019-07-21,2,Bed Number 2,37,29,8
2019-07-21,3,Bed Number 3,72,50,22
2019-07-22,1,Bed Number 1,84,79,5
2019-07-22,2,Bed Number 2,46,8,38
2019-07-22,3,Bed Number 3,34,5,29
2019-07-23,1,Bed Number 1,31,2,29
2019-07-23,2,Bed Number 2,23,12,11
2019-07-23,3,Bed Number 3,11,2,9
2019-07-24,1,Bed Number 1,71,26,45
2019-07-24,2,Bed Number 2,43,39,4
2019-07-24,3,Bed Number 3,99,57,42
2019-07-25,1,Bed Number 1,98,11,87
2019-07-25,2,Bed Number 2,46,11,35
2019-07-25,3,Bed Number 3,84,35,49
2019-07-26,1,Bed Number 1,12,6,6
2019-07-26,2,Bed Number 2,91,37,54
2019-07-26,3,Bed Number 3,29,5,24
2019-07-27,1,Bed Number 1,21,13,8
2019-07-27,2,Bed Number 2,33,32,1
2019-07-27,3,Bed Number 3,16,0,16
2019-07-28,1,Bed Number 1,32,20,12
2019-07-28,2,Bed Number 2,29,20,9
2019-07-28,3,Bed Number 3,96,30,66
2019-07-29,1,Bed Number 1,56,39,17
2019-07-29,2,Bed Number 2,84,83,1
2019-07-29,3,Bed Number 3,83,83,0
2019-07-30,1,Bed Number 1,67,23,44
2019-07-30,2,Bed Number 2,92,80,12
2019-07-30,3,Bed Number 3,49,35,14
2019-07-31,1,Bed Number 1,64,39,25
2019-07-31,2,Bed Number 2,14,8,6
2019-07-31,3,Bed Number 3,47,4,43
2019-08-01,1,Bed Number 1,30,0,30
2019-08-01,2,Bed Number 2,52,44,8
2019-08-01,3,Bed Number 3,50,33,17
2019-08-02,1,Bed Number 1,55,1,54
2019-08-02,2,Bed Number 2,60,15,45
2019-08-02,3,Bed Number 3,40,38,2
2019-08-03,1,Bed Number 1,19,8,11
2019-08-03,2,Bed Number 2,95,83,12
2019-08-03,3,Bed Number 3,21,17,4
2019-08-04,1,Bed Number 1,34,27,7
2019-08-04,2,Bed Number 2,72,12,60
2019-08-04,3,Bed Number 3,50,36,14
2019-08-05,1,Bed Number 1,86,71,15
2019-08-05,2,Bed Number 2,57,56,1
2019-08-05,3,Bed Number 3,70,32,38
2019-08-06,1,Bed Number 1,44,31,13
2019-08-06,2,Bed Number 2,14,13,1
2019-08-06,3,Bed Number 3,31,16,15
2019-08-07,1,Bed Number 1,84,50,34
2019-08-07,2,Bed Number 2,41,36,5
2019-08-07,3,Bed Number 3,31,27,4
2019-08-08,1,Bed Number 1,94,91,3
2019-08-08,2,Bed Number 2,88,59,29
2019-08-08,3,Bed Number 3,43,7,36
2019-08-09,1,Bed Number 1,75,14,61
2019-08-09,2,Bed Number 2,58,42,16
2019-08-09,3,Bed Number 3,37,27,10
2019-08-10,1,Bed Number 1,12,9,3
2019-08-10,2,Bed Number 2,15,7,8
2019-08-10,3,Bed Number 3,51,51,0
2019-08-11,1,Bed Number 1,67,16,51
2019-08-11,2,Bed Number 2,90,7,83
2019-08-11,3,Bed Number 3,34,9,25
2019-08-12,1,Bed Number 1,92,70,22
2019-08-12,2,Bed Number 2,30,23,7
2019-08-12,3,Bed Number 3,53,10,43
2019-08-13,1,Bed Number 1,70,33,37
2019-08-13,2,Bed Number 2,34,25,9
2019-08-13,3,Bed Number 3,93,11,82
2019-08-14,1,Bed Number 1,40,16,24
2019-08-14,2,Bed Number 2,67,3,64
2019-08-14,3,Bed Number 3,28,27,1
2019-08-15,1,Bed Number 1,85,57,28
2019-08-15,2,Bed Number 2,18,4,14
2019-08-15,3,Bed Number 3,49,35,14
2019-08-16,1,Bed Number 1,37,34,3
2019-08-16,2,Bed Number 2,14,9,5
2019-08-16,3,Bed Number 3,65,38,27
2019-08-17,1,Bed Number 1,64,53,11
2019-08-17,2,Bed Number 2,11,8,3
2019-08-17,3,Bed Number 3,58,50,8
2019-08-18,1,Bed Number 1,44,16,28
2019-08-18,2,Bed Number 2,47,5,42
2019-08-18,3,Bed Number 3,66,36,30
2019-08-19,1,Bed Number 1,91,11,80
2019-08-19,2,Bed Number 2,30,16,14
2019-08-19,3,Bed Number 3,12,3,9
2019-08-20,1,Bed Number 1,74,38,36
2019-08-20,2,Bed Number 2,55,34,21
2019-08-20,3,Bed Number 3,42,8,34
2019-08-21,1,Bed Number 1,95,34,61
2019-08-21,2,Bed Number 2,74,43,31
2019-08-21,3,Bed Number 3,56,44,12
2019-08-22,1,Bed Number 1,35,22,13
2019-08-22,2,Bed Number 2,38,35,3
2019-08-22,3,Bed Number 3,57,46,11
2019-08-23,1,Bed Number 1,89,71,18
2019-08-23,2,Bed Number 2,54,14,40
2019-08-23,3,Bed Number 3,80,7,73
2019-08-24,1,Bed Number 1,64,13,51
2019-08-24,2,Bed Number 2,15,1,14
2019-08-24,3,Bed Number 3,35,13,22
2019-08-25,1,Bed Number 1,65,56,9
2019-08-25,2,Bed Number 2,76,24,52
2019-08-25,3,Bed Number 3,97,39,58
2019-08-26,1,Bed Number 1,60,3,57
2019-08-26,2,Bed Number 2,78,53,25
2019-08-26,3,Bed Number 3,76,14,62
2019-08-27,1,Bed Number 1,79,29,50
2019-08-27,2,Bed Number 2,24,21,3
2019-08-27,3,Bed Number 3,11,5,6
2019-08-28,1,Bed Number 1,93,57,36
2019-08-28,2,Bed Number 2,48,36,12
2019-08-28,3,Bed Number 3,76,14,62
2019-08-29,1,Bed Number 1,96,50,46
2019-08-29,2,Bed Number 2,79,21,58
2019-08-29,3,Bed Number 3,15,3,12
2019-08-30,1,Bed Number 1,46,9,37
2019-08-30,2,Bed Number 2,54,8,46
2019-08-30,3,Bed Number 3,64,55,9
2019-08-31,1,Bed Number 1,34,26,8
2019-08-31,2,Bed Number 2,66,8,58
2019-08-31,3,Bed Number 3,65,48,17
2019-09-01,1,Bed Number 1,36,12,24
2019-09-01,2,Bed Number 2,35,23,12
2019-09-01,3,Bed Number 3,53,9,44
2019-09-02,1,Bed Number 1,24,20,4
2019-09-02,2,Bed Number 2,83,63,20
2019-09-02,3,Bed Number 3,22,13,9
2019-09-03,1,Bed Number 1,23,19,4
2019-09-03,2,Bed Number 2,11,11,0
2019-09-03,3,Bed Number 3,63,14,49
2019-09-04,1,Bed Number 1,83,64,19
2019-09-04,2,Bed Number 2,28,11,17
2019-09-04,3,Bed Number 3,74,46,28
2019-09-05,1,Bed Number 1,63,55,8
2019-09-05,2,Bed Number 2,58,17,41
2019-09-05,3,Bed Number 3,40,29,11
2019-09-06,1,Bed Number 1,61,60,1
2019-09-06,2,Bed Number 2,73,69,4
2019-09-06,3,Bed Number 3,70,59,11
2019-09-07,1,Bed Number 1,69,46,23
2019-09-07,2,Bed Number 2,37,8,29
2019-09-07,3,Bed Number 3,62,59,3
2019-09-08,1,Bed Number 1,32,6,26
2019-09-08,2,Bed Number 2,98,47,51
2019-09-08,3,Bed Number 3,79,9,70
2019-09-09,1,Bed Number 1,39,0,39
2019-09-09,2,Bed Number 2,56,31,25
2019-09-09,3,Bed Number 3,44,38,6
2019-09-10,1,Bed Number 1,45,40,5
2019-09-10,2,Bed Number 2,52,48,4
2019-09-10,3,Bed Number 3,34,15,19
2019-09-11,1,Bed Number 1,89,56,33
2019-09-11,2,Bed Number 2,34,10,24
2019-09-11,3,Bed Number 3,97,73,24
2019-09-12,1,Bed Number 1,13,0,13
2019-09-12,2,Bed Number 2,65,60,5
2019-09-12,3,Bed Number 3,32,21,11
2019-09-13,1,Bed Number 1,60,38,22
2019-09-13,2,Bed Number 2,20,14,6
2019-09-13,3,Bed Number 3,32,27,5
2019-09-14,1,Bed Number 1,59,44,15
2019-09-14,2,Bed Number 2,88,58,30
2019-09-14,3,Bed Number 3,95,76,19
2019-09-15,1,Bed Number 1,58,27,31
2019-09-15,2,Bed Number 2,90,85,5
2019-09-15,3,Bed Number 3,60,46,14
2019-09-16,1,Bed Number 1,88,80,8
2019-09-16,2,Bed Number 2,60,34,26
2019-09-16,3,Bed Number 3,31,18,13
2019-09-17,1,Bed Number 1,28,15,13
2019-09-17,2,Bed Number 2,73,10,63
2019-09-17,3,Bed Number 3,23,17,6
2019-09-18,1,Bed Number 1,79,7,72
2019-09-18,2,Bed Number 2,83,55,28
2019-09-18,3,Bed Number 3,100,22,78
2019-09-19,1,Bed Number 1,52,49,3
2019-09-19,2,Bed Number 2,59,8,51
2019-09-19,3,Bed Number 3,99,20,79
2019-09-20,1,Bed Number 1,60,19,41
2019-09-20,2,Bed Number 2,97,30,67
2019-09-20,3,Bed Number 3,71,7,64
2019-09-21,1,Bed Number 1,62,30,32
2019-09-21,2,Bed Number 2,97,92,5
2019-09-21,3,Bed Number 3,57,28,29
2019-09-22,1,Bed Number 1,36,19,17
2019-09-22,2,Bed Number 2,44,22,22
2019-09-22,3,Bed Number 3,24,5,19
2019-09-23,1,Bed Number 1,77,58,19
2019-09-23,2,Bed Number 2,17,14,3
2019-09-23,3,Bed Number 3,84,63,21
2019-09-24,1,Bed Number 1,10,6,4
2019-09-24,2,Bed Number 2,48,36,12
2019-09-24,3,Bed Number 3,45,41,4
2019-09-25,1,Bed Number 1,24,24,0
2019-09-25,2,Bed Number 2,64,6,58
2019-09-25,3,Bed Number 3,16,7,9
2019-09-26,1,Bed Number 1,40,23,17
2019-09-26,2,Bed Number 2,97,86,11
2019-09-26,3,Bed Number 3,54,49,5
2019-09-27,1,Bed Number 1,69,58,11
2019-09-27,2,Bed Number 2,78,44,34
2019-09-27,3,Bed Number 3,41,24,17
2019-09-28,1,Bed Number 1,75,70,5
2019-09-28,2,Bed Number 2,98,28,70
2019-09-28,3,Bed Number 3,88,76,12
2019-09-29,1,Bed Number 1,70,65,5
2019-09-29,2,Bed Number 2,15,10,5
2019-09-29,3,Bed Number 3,25,11,14
2019-09-30,1,Bed Number 1,45,40,5
2019-09-30,2,Bed Number 2,76,17,59
2019-09-30,3,Bed Number 3,71,47,24
2019-10-01,1,Bed Number 1,23,22,1
2019-10-01,2,Bed Number 2,27,26,1
2019-10-01,3,Bed Number 3,35,8,27
2019-10-02,1,Bed Number 1,74,58,16
2019-10-02,2,Bed Number 2,64,45,19
2019-10-02,3,Bed Number 3,46,29,17
2019-10-03,1,Bed Number 1,74,60,14
2019-10-03,2,Bed Number 2,55,16,39
2019-10-03,3,Bed Number 3,87,72,15
2019-10-04,1,Bed Number 1,91,60,31
2019-10-04,2,Bed Number 2,64,33,31
2019-10-04,3,Bed Number 3,89,28,61
2019-10-05,1,Bed Number 1,30,28,2
2019-10-05,2,Bed Number 2,83,9,74
2019-10-05,3,Bed Number 3,91,82,9
2019-10-06,1,Bed Number 1,74,63,11
2019-10-06,2,Bed Number 2,68,42,26
2019-10-06,3,Bed Number 3,12,3,9
2019-10-07,1,Bed Number 1,73,9,64
2019-10-07,2,Bed Number 2,58,47,11
2019-10-07,3,Bed Number 3,33,11,22
2019-10-08,1,Bed Number 1,68,12,56
2019-10-08,2,Bed Number 2,27,21,6
2019-10-08,3,Bed Number 3,40,26,14
2019-10-09,1,Bed Number 1,63,11,52
2019-10-09,2,Bed Number 2,54,38,16
2019-10-09,3,Bed Number 3,97,96,1
2019-10-10,1,Bed Number 1,49,9,40
2019-10-10,2,Bed Number 2,49,49,0
2019-10-10,3,Bed Number 3,84,66,18
2019-10-11,1,Bed Number 1,29,19,10
2019-10-11,2,Bed Number 2,26,5,21
2019-10-11,3,Bed Number 3,61,36,25
2019-10-12,1,Bed Number 1,76,24,52
2019-10-12,2,Bed Number 2,89,50,39
2019-10-12,3,Bed Number 3,17,15,2
2019-10-13,1,Bed Number 1,84,68,16
2019-10-13,2,Bed Number 2,54,14,40
2019-10-13,3,Bed Number 3,71,43,28
2019-10-14,1,Bed Number 1,66,15,51
2019-10-14,2,Bed Number 2,79,61,18
2019-10-14,3,Bed Number 3,95,17,78
2019-10-15,1,Bed Number 1,38,7,31
2019-10-15,2,Bed Number 2,99,78,21
2019-10-15,3,Bed Number 3,80,49,31
2019-10-16,1,Bed Number 1,74,13,61
2019-10-16,2,Bed Number 2,52,6,46
2019-10-16,3,Bed Number 3,11,6,5
2019-10-17,1,Bed Number 1,93,35,58
2019-10-17,2,Bed Number 2,25,24,1
2019-10-17,3,Bed Number 3,39,14,25
2019-10-18,1,Bed Number 1,42,5,37
2019-10-18,2,Bed Number 2,28,23,5
2019-10-18,3,Bed Number 3,72,10,62
2019-10-19,1,Bed Number 1,11,2,9
2019-10-19,2,Bed Number 2,92,9,83
2019-10-19,3,Bed Number 3,13,7,6
2019-10-20,1,Bed Number 1,77,60,17
2019-10-20,2,Bed Number 2,98,69,29
2019-10-20,3,Bed Number 3,40,37,3
2019-10-21,1,Bed Number 1,65,48,17
2019-10-21,2,Bed Number 2,10,10,0
2019-10-21,3,Bed Number 3,63,18,45
2019-10-22,1,Bed Number 1,45,45,0
2019-10-22,2,Bed Number 2,62,11,51
2019-10-22,3,Bed Number 3,37,29,8
2019-10-23,1,Bed Number 1,46,38,8
2019-10-23,2,Bed Number 2,22,0,22
2019-10-23,3,Bed Number 3,40,29,11
2019-10-24,1,Bed Number 1,28,23,5
2019-10-24,2,Bed Number 2,57,32,25
2019-10-24,3,Bed Number 3,88,22,66
2019-10-25,1,Bed Number 1,77,52,25
2019-10-25,2,Bed Number 2,29,4,25
2019-10-25,3,Bed Number 3,95,69,26
2019-10-26,1,Bed Number 1,58,28,30
2019-10-26,2,Bed Number 2,100,0,100
2019-10-26,3,Bed Number 3,91,26,65
2019-10-27,1,Bed Number 1,75,4,71
2019-10-27,2,Bed Number 2,29,17,12
2019-10-27,3,Bed Number 3,91,9,82
2019-10-28,1,Bed Number 1,100,12,88
2019-10-28,2,Bed Number 2,61,17,44
2019-10-28,3,Bed Number 3,56,34,22
2019-10-29,1,Bed Number 1,59,35,24
2019-10-29,2,Bed Number 2,80,48,32
2019-10-29,3,Bed Number 3,57,49,8
2019-10-30,1,Bed Number 1,29,17,12
2019-10-30,2,Bed Number 2,86,62,24
2019-10-30,3,Bed Number 3,75,36,39
2019-10-31,1,Bed Number 1,63,49,14
2019-10-31,2,Bed Number 2,20,1,19
2019-10-31,3,Bed Number 3,25,18,7
2019-11-01,1,Bed Number 1,87,62,25
2019-11-01,2,Bed Number 2,83,59,24
2019-11-01,3,Bed Number 3,59,23,36
2019-11-02,1,Bed Number 1,56,41,15
2019-11-02,2,Bed Number 2,93,20,73
2019-11-02,3,Bed Number 3,46,14,32
2019-11-03,1,Bed Number 1,79,6,73
2019-11-03,2,Bed Number 2,13,2,11
2019-11-03,3,Bed Number 3,33,12,21
2019-11-04,1,Bed Number 1,34,18,16
2019-11-04,2,Bed Number 2,37,0,37
2019-11-04,3,Bed Number 3,75,64,11
2019-11-05,1,Bed Number 1,60,39,21
2019-11-05,2,Bed Number 2,79,6,73
2019-11-05,3,Bed Number 3,42,34,8
2019-11-06,1,Bed Number 1,55,36,19
2019-11-06,2,Bed Number 2,21,8,13
2019-11-06,3,Bed Number 3,21,1,20
2019-11-07,1,Bed Number 1,13,13,0
2019-11-07,2,Bed Number 2,73,25,48
2019-11-07,3,Bed Number 3,54,30,24
2019-11-08,1,Bed Number 1,40,34,6
2019-11-08,2,Bed Number 2,54,16,38
2019-11-08,3,Bed Number 3,75,23,52
2019-11-09,1,Bed Number 1,17,12,5
2019-11-09,2,Bed Number 2,64,14,50
2019-11-09,3,Bed Number 3,52,17,35
2019-11-10,1,Bed Number 1,83,20,63
2019-11-10,2,Bed Number 2,19,5,14
2019-11-10,3,Bed Number 3,99,6,93
2019-11-11,1,Bed Number 1,29,8,21
2019-11-11,2,Bed Number 2,10,7,3
2019-11-11,3,Bed Number 3,13,2,11
2019-11-12,1,Bed Number 1,39,24,15
2019-11-12,2,Bed Number 2,15,8,7
2019-11-12,3,Bed Number 3,92,79,13
2019-11-13,1,Bed Number 1,35,19,16
2019-11-13,2,Bed Number 2,21,18,3
2019-11-13,3,Bed Number 3,85,37,48
2019-11-14,1,Bed Number 1,30,13,17
2019-11-14,2,Bed Number 2,80,1,79
2019-11-14,3,Bed Number 3,66,59,7
2019-11-15,1,Bed Number 1,38,4,34
2019-11-15,2,Bed Number 2,67,28,39
2019-11-15,3,Bed Number 3,72,12,60
2019-11-16,1,Bed Number 1,35,18,17
2019-11-16,2,Bed Number 2,93,13,80
2019-11-16,3,Bed Number 3,16,9,7
2019-11-17,1,Bed Number 1,72,35,37
2019-11-17,2,Bed Number 2,42,31,11
2019-11-17,3,Bed Number 3,15,0,15
2019-11-18,1,Bed Number 1,61,3,58
2019-11-18,2,Bed Number 2,94,26,68
2019-11-18,3,Bed Number 3,96,33,63
2019-11-19,1,Bed Number 1,31,31,0
2019-11-19,2,Bed Number 2,99,99,0
2019-11-19,3,Bed Number 3,49,0,49
2019-11-20,1,Bed Number 1,84,29,55
2019-11-20,2,Bed Number 2,33,3,30
2019-11-20,3,Bed Number 3,72,29,43
2019-11-21,1,Bed Number 1,24,4,20
2019-11-21,2,Bed Number 2,13,12,1
2019-11-21,3,Bed Number 3,73,10,63
2019-11-22,1,Bed Number 1,65,37,28
2019-11-22,2,Bed Number 2,65,1,64
2019-11-22,3,Bed Number 3,44,25,19
2019-11-23,1,Bed Number 1,81,55,26
2019-11-23,2,Bed Number 2,77,76,1
2019-11-23,3,Bed Number 3,24,10,14
2019-11-24,1,Bed Number 1,75,59,16
2019-11-24,2,Bed Number 2,40,26,14
2019-11-24,3,Bed Number 3,62,49,13
2019-11-25,1,Bed Number 1,81,70,11
2019-11-25,2,Bed Number 2,51,7,44
2019-11-25,3,Bed Number 3,74,24,50
2019-11-26,1,Bed Number 1,54,42,12
2019-11-26,2,Bed Number 2,70,17,53
2019-11-26,3,Bed Number 3,24,18,6
2019-11-27,1,Bed Number 1,45,15,30
2019-11-27,2,Bed Number 2,88,55,33
2019-11-27,3,Bed Number 3,24,9,15
2019-11-28,1,Bed Number 1,77,68,9
2019-11-28,2,Bed Number 2,61,43,18
2019-11-28,3,Bed Number 3,90,12,78
2019-11-29,1,Bed Number 1,29,28,1
2019-11-29,2,Bed Number 2,60,56,4
2019-11-29,3,Bed Number 3,38,14,24
2019-11-30,1,Bed Number 1,27,27,0
2019-11-30,2,Bed Number 2,17,10,7
2019-11-30,3,Bed Number 3,58,5,53
2019-12-01,1,Bed Number 1,37,2,35
2019-12-01,2,Bed Number 2,50,29,21
2019-12-01,3,Bed Number 3,94,52,42
2019-12-02,1,Bed Number 1,23,4,19
2019-12-02,2,Bed Number 2,12,3,9
2019-12-02,3,Bed Number 3,54,10,44
2019-12-03,1,Bed Number 1,42,8,34
2019-12-03,2,Bed Number 2,55,4,51
2019-12-03,3,Bed Number 3,54,34,20
2019-12-04,1,Bed Number 1,55,10,45
2019-12-04,2,Bed Number 2,80,75,5
2019-12-04,3,Bed Number 3,86,57,29
2019-12-05,1,Bed Number 1,24,10,14
2019-12-05,2,Bed Number 2,86,34,52
2019-12-05,3,Bed Number 3,53,11,42
2019-12-06,1,Bed Number 1,16,10,6
2019-12-06,2,Bed Number 2,33,22,11
2019-12-06,3,Bed Number 3,98,74,24
2019-12-07,1,Bed Number 1,82,20,62
2019-12-07,2,Bed Number 2,86,10,76
2019-12-07,3,Bed Number 3,42,42,0
2019-12-08,1,Bed Number 1,88,19,69
2019-12-08,2,Bed Number 2,83,81,2
2019-12-08,3,Bed Number 3,59,14,45
2019-12-09,1,Bed Number 1,47,9,38
2019-12-09,2,Bed Number 2,77,12,65
2019-12-09,3,Bed Number 3,11,1,10
2019-12-10,1,Bed Number 1,71,49,22
2019-12-10,2,Bed Number 2,59,38,21
2019-12-10,3,Bed Number 3,53,20,33
2019-12-11,1,Bed Number 1,24,2,22
2019-12-11,2,Bed Number 2,96,49,47
2019-12-11,3,Bed Number 3,80,24,56
2019-12-12,1,Bed Number 1,77,18,59
2019-12-12,2,Bed Number 2,82,13,69
2019-12-12,3,Bed Number 3,34,25,9
2019-12-13,1,Bed Number 1,80,15,65
2019-12-13,2,Bed Number 2,58,18,40
2019-12-13,3,Bed Number 3,91,12,79
2019-12-14,1,Bed Number 1,57,32,25
2019-12-14,2,Bed Number 2,58,0,58
2019-12-14,3,Bed Number 3,38,12,26
2019-12-15,1,Bed Number 1,67,11,56
2019-12-15,2,Bed Number 2,32,24,8
2019-12-15,3,Bed Number 3,93,44,49
2019-12-16,1,Bed Number 1,87,6,81
2019-12-16,2,Bed Number 2,100,25,75
2019-12-16,3,Bed Number 3,39,1,38
2019-12-17,1,Bed Number 1,28,17,11
2019-12-17,2,Bed Number 2,50,46,4
2019-12-17,3,Bed Number 3,60,58,2
2019-12-18,1,Bed Number 1,75,70,5
2019-12-18,2,Bed Number 2,61,15,46
2019-12-18,3,Bed Number 3,68,21,47
2019-12-19,1,Bed Number 1,13,7,6
2019-12-19,2,Bed Number 2,33,2,31
2019-12-19,3,Bed Number 3,80,37,43
2019-12-20,1,Bed Number 1,90,86,4
2019-12-20,2,Bed Number 2,95,37,58
2019-12-20,3,Bed Number 3,80,52,28
2019-12-21,1,Bed Number 1,24,1,23
2019-12-21,2,Bed Number 2,32,14,18
2019-12-21,3,Bed Number 3,87,28,59
2019-12-22,1,Bed Number 1,61,21,40
2019-12-22,2,Bed Number 2,24,2,22
2019-12-22,3,Bed Number 3,19,11,8
2019-12-23,1,Bed Number 1,58,33,25
2019-12-23,2,Bed Number 2,100,23,77
2019-12-23,3,Bed Number 3,78,71,7
2019-12-24,1,Bed Number 1,34,16,18
2019-12-24,2,Bed Number 2,37,25,12
2019-12-24,3,Bed Number 3,76,28,48
2019-12-25,1,Bed Number 1,51,19,32
2019-12-25,2,Bed Number 2,93,47,46
2019-12-25,3,Bed Number 3,42,27,15
2019-12-26,1,Bed Number 1,42,30,12
2019-12-26,2,Bed Number 2,20,7,13
2019-12-26,3,Bed Number 3,24,11,13
2019-12-27,1,Bed Number 1,58,35,23
2019-12-27,2,Bed Number 2,86,70,16
2019-12-27,3,Bed Number 3,91,88,3
2019-12-28,1,Bed Number 1,16,12,4
2019-12-28,2,Bed Number 2,71,45,26
2019-12-28,3,Bed Number 3,66,16,50
2019-12-29,1,Bed Number 1,49,31,18
2019-12-29,2,Bed Number 2,27,16,11
2019-12-29,3,Bed Number 3,31,26,5
2019-12-30,1,Bed Number 1,32,0,32
2019-12-30,2,Bed Number 2,40,8,32
2019-12-30,3,Bed Number 3,53,48,5
2019-12-31,1,Bed Number 1,90,80,10
2019-12-31,2,Bed Number 2,49,45,4
2019-12-31,3,Bed Number 3,70,58,12
2020-01-01,1,Bed Number 1,14,3,11
2020-01-01,2,Bed Number 2,52,40,12
2020-01-01,3,Bed Number 3,86,78,8
2020-01-02,1,Bed Number 1,20,5,15
2020-01-02,2,Bed Number 2,95,80,15
2020-01-02,3,Bed Number 3,52,10,42
2020-01-03,1,Bed Number 1,82,21,61
2020-01-03,2,Bed Number 2,85,30,55
2020-01-03,3,Bed Number 3,87,58,29
2020-01-04,1,Bed Number 1,20,11,9
2020-01-04,2,Bed Number 2,22,8,14
2020-01-04,3,Bed Number 3,49,6,43
2020-01-05,1,Bed Number 1,28,24,4
2020-01-05,2,Bed Number 2,99,18,81
2020-01-05,3,Bed Number 3,52,19,33
2020-01-06,1,Bed Number 1,14,5,9
2020-01-06,2,Bed Number 2,89,32,57
2020-01-06,3,Bed Number 3,78,11,67
2020-01-07,1,Bed Number 1,94,3,91
2020-01-07,2,Bed Number 2,67,61,6
2020-01-07,3,Bed Number 3,11,6,5
2020-01-08,1,Bed Number 1,86,59,27
2020-01-08,2,Bed Number 2,45,17,28
2020-01-08,3,Bed Number 3,83,81,2
2020-01-09,1,Bed Number 1,34,15,19
2020-01-09,2,Bed Number 2,19,11,8
2020-01-09,3,Bed Number 3,87,73,14
2020-01-10,1,Bed Number 1,71,19,52
2020-01-10,2,Bed Number 2,71,51,20
2020-01-10,3,Bed Number 3,15,15,0
2020-01-11,1,Bed Number 1,23,21,2
2020-01-11,2,Bed Number 2,16,1,15
2020-01-11,3,Bed Number 3,10,6,4
2020-01-12,1,Bed Number 1,35,29,6
2020-01-12,2,Bed Number 2,19,1,18
2020-01-12,3,Bed Number 3,46,32,14
2020-01-13,1,Bed Number 1,25,1,24
2020-01-13,2,Bed Number 2,30,18,12
2020-01-13,3,Bed Number 3,98,26,72
2020-01-14,1,Bed Number 1,77,64,13
2020-01-14,2,Bed Number 2,89,77,12
2020-01-14,3,Bed Number 3,18,2,16
2020-01-15,1,Bed Number 1,81,57,24
2020-01-15,2,Bed Number 2,10,7,3
2020-01-15,3,Bed Number 3,63,23,40
2020-01-16,1,Bed Number 1,31,12,19
2020-01-16,2,Bed Number 2,77,69,8
2020-01-16,3,Bed Number 3,30,1,29
2020-01-17,1,Bed Number 1,48,44,4
2020-01-17,2,Bed Number 2,65,10,55
2020-01-17,3,Bed Number 3,79,58,21
2020-01-18,1,Bed Number 1,97,58,39
2020-01-18,2,Bed Number 2,71,30,41
2020-01-18,3,Bed Number 3,31,30,1
2020-01-19,1,Bed Number 1,45,22,23
2020-01-19,2,Bed Number 2,63,44,19
2020-01-19,3,Bed Number 3,34,25,9
2020-01-20,1,Bed Number 1,14,5,9
2020-01-20,2,Bed Number 2,66,29,37
2020-01-20,3,Bed Number 3,90,30,60
2020-01-21,1,Bed Number 1,15,12,3
2020-01-21,2,Bed Number 2,30,17,13
2020-01-21,3,Bed Number 3,37,23,14
2020-01-22,1,Bed Number 1,99,89,10
2020-01-22,2,Bed Number 2,17,4,13
2020-01-22,3,Bed Number 3,12,0,12
2020-01-23,1,Bed Number 1,87,43,44
2020-01-23,2,Bed Number 2,59,18,41
2020-01-23,3,Bed Number 3,43,7,36
2020-01-24,1,Bed Number 1,37,31,6
2020-01-24,2,Bed Number 2,12,5,7
2020-01-24,3,Bed Number 3,68,56,12
2020-01-25,1,Bed Number 1,46,38,8
2020-01-25,2,Bed Number 2,44,40,4
2020-01-25,3,Bed Number 3,15,12,3
2020-01-26,1,Bed Number 1,97,76,21
2020-01-26,2,Bed Number 2,87,83,4
2020-01-26,3,Bed Number 3,37,27,10
2020-01-27,1,Bed Number 1,26,25,1
2020-01-27,2,Bed Number 2,31,17,14
2020-01-27,3,Bed Number 3,13,10,3
2020-01-28,1,Bed Number 1,67,51,16
2020-01-28,2,Bed Number 2,10,5,5
2020-01-28,3,Bed Number 3,16,13,3
2020-01-29,1,Bed Number 1,86,57,29
2020-01-29,2,Bed Number 2,25,8,17
2020-01-29,3,Bed Number 3,19,10,9
2020-01-30,1,Bed Number 1,95,57,38
2020-01-30,2,Bed Number 2,90,53,37
2020-01-30,3,Bed Number 3,12,11,1
2020-01-31,1,Bed Number 1,52,11,41
2020-01-31,2,Bed Number 2,93,5,88
2020-01-31,3,Bed Number 3,75,37,38
2020-02-01,1,Bed Number 1,97,49,48
2020-02-01,2,Bed Number 2,79,69,10
2020-02-01,3,Bed Number 3,57,6,51
2020-02-02,1,Bed Number 1,93,93,0
2020-02-02,2,Bed Number 2,41,7,34
2020-02-02,3,Bed Number 3,94,82,12
2020-02-03,1,Bed Number 1,12,2,10
2020-02-03,2,Bed Number 2,78,48,30
2020-02-03,3,Bed Number 3,89,1,88
2020-02-04,1,Bed Number 1,96,61,35
2020-02-04,2,Bed Number 2,48,6,42
2020-02-04,3,Bed Number 3,37,13,24
2020-02-05,1,Bed Number 1,14,3,11
2020-02-05,2,Bed Number 2,25,8,17
2020-02-05,3,Bed Number 3,97,25,72
2020-02-06,1,Bed Number 1,96,45,51
2020-02-06,2,Bed Number 2,58,18,40
2020-02-06,3,Bed Number 3,74,13,61
2020-02-07,1,Bed Number 1,93,82,11
2020-02-07,2,Bed Number 2,17,14,3
2020-02-07,3,Bed Number 3,53,36,17
2020-02-08,1,Bed Number 1,35,1,34
2020-02-08,2,Bed Number 2,34,6,28
2020-02-08,3,Bed Number 3,24,15,9
2020-02-09,1,Bed Number 1,79,48,31
2020-02-09,2,Bed Number 2,85,5,80
2020-02-09,3,Bed Number 3,47,20,27
2020-02-10,1,Bed Number 1,76,45,31
2020-02-10,2,Bed Number 2,68,36,32
2020-02-10,3,Bed Number 3,23,4,19
2020-02-11,1,Bed Number 1,90,18,72
2020-02-11,2,Bed Number 2,28,9,19
2020-02-11,3,Bed Number 3,86,57,29
2020-02-12,1,Bed Number 1,39,36,3
2020-02-12,2,Bed Number 2,94,46,48
2020-02-12,3,Bed Number 3,45,36,9
2020-02-13,1,Bed Number 1,66,1,65
2020-02-13,2,Bed Number 2,49,46,3
2020-02-13,3,Bed Number 3,61,5,56
2020-02-14,1,Bed Number 1,19,2,17
2020-02-14,2,Bed Number 2,14,5,9
2020-02-14,3,Bed Number 3,51,40,11
2020-02-15,1,Bed Number 1,14,2,12
2020-02-15,2,Bed Number 2,97,29,68
2020-02-15,3,Bed Number 3,76,67,9
2020-02-16,1,Bed Number 1,80,43,37
2020-02-16,2,Bed Number 2,97,15,82
2020-02-16,3,Bed Number 3,86,32,54
2020-02-17,1,Bed Number 1,42,12,30
2020-02-17,2,Bed Number 2,95,90,5
2020-02-17,3,Bed Number 3,16,6,10
2020-02-18,1,Bed Number 1,46,25,21
2020-02-18,2,Bed Number 2,92,34,58
2020-02-18,3,Bed Number 3,53,13,40
2020-02-19,1,Bed Number 1,28,0,28
2020-02-19,2,Bed Number 2,74,61,13
2020-02-19,3,Bed Number 3,79,37,42
2020-02-20,1,Bed Number 1,11,10,1
2020-02-20,2,Bed Number 2,39,14,25
2020-02-20,3,Bed Number 3,36,25,11
2020-02-21,1,Bed Number 1,94,71,23
2020-02-21,2,Bed Number 2,70,50,20
2020-02-21,3,Bed Number 3,74,28,46
2020-02-22,1,Bed Number 1,75,14,61
2020-02-22,2,Bed Number 2,49,30,19
2020-02-22,3,Bed Number 3,65,18,47
2020-02-23,1,Bed Number 1,12,10,2
2020-02-23,2,Bed Number 2,99,11,88
2020-02-23,3,Bed Number 3,76,57,19
2020-02-24,1,Bed Number 1,58,56,2
2020-02-24,2,Bed Number 2,19,17,2
2020-02-24,3,Bed Number 3,84,61,23
2020-02-25,1,Bed Number 1,34,23,11
2020-02-25,2,Bed Number 2,41,20,21
2020-02-25,3,Bed Number 3,96,73,23
2020-02-26,1,Bed Number 1,73,10,63
2020-02-26,2,Bed Number 2,16,8,8
2020-02-26,3,Bed Number 3,94,59,35
2020-02-27,1,Bed Number 1,64,33,31
2020-02-27,2,Bed Number 2,44,24,20
2020-02-27,3,Bed Number 3,65,51,14
2020-02-28,1,Bed Number 1,62,30,32
2020-02-28,2,Bed Number 2,91,63,28
2020-02-28,3,Bed Number 3,79,29,50
2020-02-29,1,Bed Number 1,18,13,5
2020-02-29,2,Bed Number 2,49,11,38
2020-02-29,3,Bed Number 3,32,6,26
2020-03-01,1,Bed Number 1,61,32,29
2020-03-01,2,Bed Number 2,52,50,2
2020-03-01,3,Bed Number 3,53,12,41
2020-03-02,1,Bed Number 1,61,25,36
2020-03-02,2,Bed Number 2,40,21,19
2020-03-02,3,Bed Number 3,56,48,8
2020-03-03,1,Bed Number 1,21,6,15
2020-03-03,2,Bed Number 2,96,66,30
2020-03-03,3,Bed Number 3,89,66,23
2020-03-04,1,Bed Number 1,26,5,21
2020-03-04,2,Bed Number 2,69,21,48
2020-03-04,3,Bed Number 3,41,2,39
2020-03-05,1,Bed Number 1,86,26,60
2020-03-05,2,Bed Number 2,34,2,32
2020-03-05,3,Bed Number 3,25,24,1
2020-03-06,1,Bed Number 1,45,10,35
2020-03-06,2,Bed Number 2,85,72,13
2020-03-06,3,Bed Number 3,38,33,5
2020-03-07,1,Bed Number 1,91,62,29
2020-03-07,2,Bed Number 2,27,16,11
2020-03-07,3,Bed Number 3,24,18,6
2020-03-08,1,Bed Number 1,99,92,7
2020-03-08,2,Bed Number 2,44,28,16
2020-03-08,3,Bed Number 3,13,9,4
2020-03-09,1,Bed Number 1,77,73,4
2020-03-09,2,Bed Number 2,89,76,13
2020-03-09,3,Bed Number 3,26,7,19
2020-03-10,1,Bed Number 1,57,55,2
2020-03-10,2,Bed Number 2,98,97,1
2020-03-10,3,Bed Number 3,34,8,26
2020-03-11,1,Bed Number 1,47,34,13
2020-03-11,2,Bed Number 2,24,0,24
2020-03-11,3,Bed Number 3,53,8,45
2020-03-12,1,Bed Number 1,24,5,19
2020-03-12,2,Bed Number 2,85,41,44
2020-03-12,3,Bed Number 3,98,39,59
2020-03-13,1,Bed Number 1,95,5,90
2020-03-13,2,Bed Number 2,48,3,45
2020-03-13,3,Bed Number 3,60,16,44
2020-03-14,1,Bed Number 1,78,31,47
2020-03-14,2,Bed Number 2,57,56,1
2020-03-14,3,Bed Number 3,24,21,3
2020-03-15,1,Bed Number 1,66,52,14
2020-03-15,2,Bed Number 2,55,13,42
2020-03-15,3,Bed Number 3,71,53,18
2020-03-16,1,Bed Number 1,43,0,43
2020-03-16,2,Bed Number 2,40,23,17
2020-03-16,3,Bed Number 3,18,11,7
2020-03-17,1,Bed Number 1,63,15,48
2020-03-17,2,Bed Number 2,54,25,29
2020-03-17,3,Bed Number 3,29,0,29
2020-03-18,1,Bed Number 1,80,55,25
2020-03-18,2,Bed Number 2,64,35,29
2020-03-18,3,Bed Number 3,77,55,22
2020-03-19,1,Bed Number 1,15,5,10
2020-03-19,2,Bed Number 2,24,19,5
2020-03-19,3,Bed Number 3,47,0,47
2020-03-20,1,Bed Number 1,66,32,34
2020-03-20,2,Bed Number 2,59,12,47
2020-03-20,3,Bed Number 3,18,0,18
2020-03-21,1,Bed Number 1,62,13,49
2020-03-21,2,Bed Number 2,40,38,2
2020-03-21,3,Bed Number 3,77,16,61
2020-03-22,1,Bed Number 1,18,13,5
2020-03-22,2,Bed Number 2,88,52,36
2020-03-22,3,Bed Number 3,72,54,18
2020-03-23,1,Bed Number 1,53,23,30
2020-03-23,2,Bed Number 2,92,92,0
2020-03-23,3,Bed Number 3,76,16,60
2020-03-24,1,Bed Number 1,75,74,1
2020-03-24,2,Bed Number 2,69,39,30
2020-03-24,3,Bed Number 3,16,9,7
2020-03-25,1,Bed Number 1,79,68,11
2020-03-25,2,Bed Number 2,17,13,4
2020-03-25,3,Bed Number 3,76,37,39
2020-03-26,1,Bed Number 1,18,3,15
2020-03-26,2,Bed Number 2,83,18,65
2020-03-26,3,Bed Number 3,47,42,5
2020-03-27,1,Bed Number 1,31,25,6
2020-03-27,2,Bed Number 2,23,4,19
2020-03-27,3,Bed Number 3,24,22,2
2020-03-28,1,Bed Number 1,70,21,49
2020-03-28,2,Bed Number 2,72,58,14
2020-03-28,3,Bed Number 3,18,10,8
2020-03-29,1,Bed Number 1,73,24,49
2020-03-29,2,Bed Number 2,19,6,13
2020-03-29,3,Bed Number 3,69,20,49
2020-03-30,1,Bed Number 1,24,3,21
2020-03-30,2,Bed Number 2,43,42,1
2020-03-30,3,Bed Number 3,33,31,2
2020-03-31,1,Bed Number 1,12,2,10
2020-03-31,2,Bed Number 2,49,2,47
2020-03-31,3,Bed Number 3,86,48,38
2020-04-01,1,Bed Number 1,48,44,4
2020-04-01,2,Bed Number 2,53,46,7
2020-04-01,3,Bed Number 3,70,28,42
2020-04-02,1,Bed Number 1,89,70,19
2020-04-02,2,Bed Number 2,34,18,16
2020-04-02,3,Bed Number 3,39,34,5
2020-04-03,1,Bed Number 1,78,69,9
2020-04-03,2,Bed Number 2,54,12,42
2020-04-03,3,Bed Number 3,88,63,25
2020-04-04,1,Bed Number 1,33,24,9
2020-04-04,2,Bed Number 2,30,18,12
2020-04-04,3,Bed Number 3,30,20,10
2020-04-05,1,Bed Number 1,32,8,24
2020-04-05,2,Bed Number 2,79,31,48
2020-04-05,3,Bed Number 3,66,6,60
2020-04-06,1,Bed Number 1,70,63,7
2020-04-06,2,Bed Number 2,16,14,2
2020-04-06,3,Bed Number 3,75,51,24
2020-04-07,1,Bed Number 1,67,35,32
2020-04-07,2,Bed Number 2,81,25,56
2020-04-07,3,Bed Number 3,66,46,20
2020-04-08,1,Bed Number 1,100,35,65
2020-04-08,2,Bed Number 2,71,50,21
2020-04-08,3,Bed Number 3,53,32,21
2020-04-09,1,Bed Number 1,73,33,40
2020-04-09,2,Bed Number 2,47,37,10
2020-04-09,3,Bed Number 3,22,17,5
2020-04-10,1,Bed Number 1,73,41,32
2020-04-10,2,Bed Number 2,37,6,31
2020-04-10,3,Bed Number 3,76,75,1
2020-04-11,1,Bed Number 1,36,1,35
2020-04-11,2,Bed Number 2,12,3,9
2020-04-11,3,Bed Number 3,61,56,5
2020-04-12,1,Bed Number 1,85,13,72
2020-04-12,2,Bed Number 2,24,3,21
2020-04-12,3,Bed Number 3,93,17,76
2020-04-13,1,Bed Number 1,65,37,28
2020-04-13,2,Bed Number 2,11,4,7
2020-04-13,3,Bed Number 3,94,92,2
2020-04-14,1,Bed Number 1,22,8,14
2020-04-14,2,Bed Number 2,13,4,9
2020-04-14,3,Bed Number 3,80,41,39
2020-04-15,1,Bed Number 1,16,0,16
2020-04-15,2,Bed Number 2,78,74,4
2020-04-15,3,Bed Number 3,16,11,5
2020-04-16,1,Bed Number 1,77,45,32
2020-04-16,2,Bed Number 2,82,32,50
2020-04-16,3,Bed Number 3,31,10,21
2020-04-17,1,Bed Number 1,23,0,23
2020-04-17,2,Bed Number 2,85,47,38
2020-04-17,3,Bed Number 3,17,9,8
2020-04-18,1,Bed Number 1,99,63,36
2020-04-18,2,Bed Number 2,45,20,25
2020-04-18,3,Bed Number 3,43,29,14
2020-04-19,1,Bed Number 1,74,0,74
2020-04-19,2,Bed Number 2,59,0,59
2020-04-19,3,Bed Number 3,94,15,79
2020-04-20,1,Bed Number 1,92,53,39
2020-04-20,2,Bed Number 2,94,3,91
2020-04-20,3,Bed Number 3,40,4,36
2020-04-21,1,Bed Number 1,19,11,8
2020-04-21,2,Bed Number 2,45,32,13
2020-04-21,3,Bed Number 3,49,24,25
2020-04-22,1,Bed Number 1,24,18,6
2020-04-22,2,Bed Number 2,14,4,10
2020-04-22,3,Bed Number 3,28,22,6
2020-04-23,1,Bed Number 1,75,54,21
2020-04-23,2,Bed Number 2,64,53,11
2020-04-23,3,Bed Number 3,61,1,60
2020-04-24,1,Bed Number 1,73,15,58
2020-04-24,2,Bed Number 2,83,22,61
2020-04-24,3,Bed Number 3,21,11,10
2020-04-25,1,Bed Number 1,98,62,36
2020-04-25,2,Bed Number 2,66,56,10
2020-04-25,3,Bed Number 3,51,43,8
2020-04-26,1,Bed Number 1,46,28,18
2020-04-26,2,Bed Number 2,19,0,19
2020-04-26,3,Bed Number 3,61,3,58
2020-04-27,1,Bed Number 1,63,31,32
2020-04-27,2,Bed Number 2,39,17,22
2020-04-27,3,Bed Number 3,97,30,67
2020-04-28,1,Bed Number 1,22,10,12
2020-04-28,2,Bed Number 2,79,48,31
2020-04-28,3,Bed Number 3,12,3,9
2020-04-29,1,Bed Number 1,44,5,39
2020-04-29,2,Bed Number 2,46,25,21
2020-04-29,3,Bed Number 3,12,2,10
2020-04-30,1,Bed Number 1,67,51,16
2020-04-30,2,Bed Number 2,18,16,2
2020-04-30,3,Bed Number 3,36,8,28
2020-05-01,1,Bed Number 1,83,83,0
2020-05-01,2,Bed Number 2,95,26,69
2020-05-01,3,Bed Number 3,13,3,10
2020-05-02,1,Bed Number 1,97,8,89
2020-05-02,2,Bed Number 2,16,16,0
2020-05-02,3,Bed Number 3,97,36,61
2020-05-03,1,Bed Number 1,98,72,26
2020-05-03,2,Bed Number 2,25,6,19
2020-05-03,3,Bed Number 3,53,18,35
2020-05-04,1,Bed Number 1,24,8,16
2020-05-04,2,Bed Number 2,57,39,18
2020-05-04,3,Bed Number 3,86,49,37
2020-05-05,1,Bed Number 1,12,7,5
2020-05-05,2,Bed Number 2,83,31,52
2020-05-05,3,Bed Number 3,73,11,62
2020-05-06,1,Bed Number 1,74,57,17
2020-05-06,2,Bed Number 2,26,15,11
2020-05-06,3,Bed Number 3,52,3,49
2020-05-07,1,Bed Number 1,29,15,14
2020-05-07,2,Bed Number 2,19,19,0
2020-05-07,3,Bed Number 3,62,44,18
2020-05-08,1,Bed Number 1,58,1,57
2020-05-08,2,Bed Number 2,33,12,21
2020-05-08,3,Bed Number 3,73,69,4
2020-05-09,1,Bed Number 1,63,53,10
2020-05-09,2,Bed Number 2,78,47,31
2020-05-09,3,Bed Number 3,32,3,29
2020-05-10,1,Bed Number 1,84,39,45
2020-05-10,2,Bed Number 2,100,89,11
2020-05-10,3,Bed Number 3,35,3,32
2020-05-11,1,Bed Number 1,33,4,29
2020-05-11,2,Bed Number 2,48,15,33
2020-05-11,3,Bed Number 3,37,27,10
2020-05-12,1,Bed Number 1,41,41,0
2020-05-12,2,Bed Number 2,50,5,45
2020-05-12,3,Bed Number 3,34,16,18
2020-05-13,1,Bed Number 1,91,33,58
2020-05-13,2,Bed Number 2,62,26,36
2020-05-13,3,Bed Number 3,60,17,43
2020-05-14,1,Bed Number 1,98,84,14
2020-05-14,2,Bed Number 2,61,48,13
2020-05-14,3,Bed Number 3,47,41,6
2020-05-15,1,Bed Number 1,79,43,36
2020-05-15,2,Bed Number 2,43,36,7
2020-05-15,3,Bed Number 3,11,9,2
2020-05-16,1,Bed Number 1,43,39,4
2020-05-16,2,Bed Number 2,81,62,19
2020-05-16,3,Bed Number 3,57,1,56
2020-05-17,1,Bed Number 1,30,9,21
2020-05-17,2,Bed Number 2,46,18,28
2020-05-17,3,Bed Number 3,87,31,56
2020-05-18,1,Bed Number 1,67,57,10
2020-05-18,2,Bed Number 2,79,3,76
2020-05-18,3,Bed Number 3,12,12,0
2020-05-19,1,Bed Number 1,70,65,5
2020-05-19,2,Bed Number 2,53,7,46
2020-05-19,3,Bed Number 3,45,29,16
2020-05-20,1,Bed Number 1,70,5,65
2020-05-20,2,Bed Number 2,67,10,57
2020-05-20,3,Bed Number 3,37,35,2
2020-05-21,1,Bed Number 1,58,51,7
2020-05-21,2,Bed Number 2,15,11,4
2020-05-21,3,Bed Number 3,56,11,45
2020-05-22,1,Bed Number 1,54,43,11
2020-05-22,2,Bed Number 2,31,7,24
2020-05-22,3,Bed Number 3,18,11,7
2020-05-23,1,Bed Number 1,78,19,59
2020-05-23,2,Bed Number 2,72,25,47
2020-05-23,3,Bed Number 3,67,46,21
2020-05-24,1,Bed Number 1,23,21,2
2020-05-24,2,Bed Number 2,93,80,13
2020-05-24,3,Bed Number 3,45,41,4
2020-05-25,1,Bed Number 1,32,27,5
2020-05-25,2,Bed Number 2,94,89,5
2020-05-25,3,Bed Number 3,58,20,38
2020-05-26,1,Bed Number 1,80,12,68
2020-05-26,2,Bed Number 2,43,42,1
2020-05-26,3,Bed Number 3,42,17,25
2020-05-27,1,Bed Number 1,69,68,1
2020-05-27,2,Bed Number 2,25,24,1
2020-05-27,3,Bed Number 3,51,13,38
2020-05-28,1,Bed Number 1,38,30,8
2020-05-28,2,Bed Number 2,76,16,60
2020-05-28,3,Bed Number 3,53,9,44
2020-05-29,1,Bed Number 1,10,5,5
2020-05-29,2,Bed Number 2,78,76,2
2020-05-29,3,Bed Number 3,80,70,10
2020-05-30,1,Bed Number 1,17,1,16
2020-05-30,2,Bed Number 2,31,0,31
2020-05-30,3,Bed Number 3,25,2,23
2020-05-31,1,Bed Number 1,57,39,18
2020-05-31,2,Bed Number 2,53,53,0
2020-05-31,3,Bed Number 3,69,54,15
2020-06-01,1,Bed Number 1,96,91,5
2020-06-01,2,Bed Number 2,46,2,44
2020-06-01,3,Bed Number 3,78,36,42
2020-06-02,1,Bed Number 1,28,6,22
2020-06-02,2,Bed Number 2,90,41,49
2020-06-02,3,Bed Number 3,39,22,17
2020-06-03,1,Bed Number 1,51,36,15
2020-06-03,2,Bed Number 2,26,14,12
2020-06-03,3,Bed Number 3,73,49,24
2020-06-04,1,Bed Number 1,31,1,30
2020-06-04,2,Bed Number 2,40,30,10
2020-06-04,3,Bed Number 3,20,17,3
2020-06-05,1,Bed Number 1,75,43,32
2020-06-05,2,Bed Number 2,67,17,50
2020-06-05,3,Bed Number 3,38,27,11
2020-06-06,1,Bed Number 1,77,34,43
2020-06-06,2,Bed Number 2,43,13,30
2020-06-06,3,Bed Number 3,74,74,0
2020-06-07,1,Bed Number 1,88,55,33
2020-06-07,2,Bed Number 2,87,37,50
2020-06-07,3,Bed Number 3,26,25,1
2020-06-08,1,Bed Number 1,22,16,6
2020-06-08,2,Bed Number 2,54,22,32
2020-06-08,3,Bed Number 3,56,35,21
2020-06-09,1,Bed Number 1,53,14,39
2020-06-09,2,Bed Number 2,97,45,52
2020-06-09,3,Bed Number 3,80,68,12
2020-06-10,1,Bed Number 1,46,17,29
2020-06-10,2,Bed Number 2,96,44,52
2020-06-10,3,Bed Number 3,10,2,8
2020-06-11,1,Bed Number 1,79,13,66
2020-06-11,2,Bed Number 2,76,37,39
2020-06-11,3,Bed Number 3,96,92,4
2020-06-12,1,Bed Number 1,71,10,61
2020-06-12,2,Bed Number 2,23,6,17
2020-06-12,3,Bed Number 3,38,16,22
2020-06-13,1,Bed Number 1,36,26,10
2020-06-13,2,Bed Number 2,70,50,20
2020-06-13,3,Bed Number 3,38,9,29
2020-06-14,1,Bed Number 1,54,11,43
2020-06-14,2,Bed Number 2,71,30,41
2020-06-14,3,Bed Number 3,83,7,76
2020-06-15,1,Bed Number 1,89,59,30
2020-06-15,2,Bed Number 2,48,2,46
2020-06-15,3,Bed Number 3,13,3,10
2020-06-16,1,Bed Number 1,57,44,13
2020-06-16,2,Bed Number 2,30,15,15
2020-06-16,3,Bed Number 3,14,8,6
2020-06-17,1,Bed Number 1,62,46,16
2020-06-17,2,Bed Number 2,40,18,22
2020-06-17,3,Bed Number 3,73,35,38
2020-06-18,1,Bed Number 1,66,29,37
2020-06-18,2,Bed Number 2,55,44,11
2020-06-18,3,Bed Number 3,54,36,18
2020-06-19,1,Bed Number 1,95,33,62
2020-06-19,2,Bed Number 2,17,11,6
2020-06-19,3,Bed Number 3,23,13,10
2020-06-20,1,Bed Number 1,29,24,5
2020-06-20,2,Bed Number 2,88,19,69
2020-06-20,3,Bed Number 3,33,7,26
2020-06-21,1,Bed Number 1,86,3,83
2020-06-21,2,Bed Number 2,12,10,2
2020-06-21,3,Bed Number 3,53,30,23
2020-06-22,1,Bed Number 1,91,36,55
2020-06-22,2,Bed Number 2,52,8,44
2020-06-22,3,Bed Number 3,47,11,36
2020-06-23,1,Bed Number 1,20,2,18
2020-06-23,2,Bed Number 2,40,35,5
2020-06-23,3,Bed Number 3,37,21,16
2020-06-24,1,Bed Number 1,51,13,38
2020-06-24,2,Bed Number 2,53,7,46
2020-06-24,3,Bed Number 3,54,53,1
2020-06-25,1,Bed Number 1,95,20,75
2020-06-25,2,Bed Number 2,22,4,18
2020-06-25,3,Bed Number 3,80,20,60
2020-06-26,1,Bed Number 1,82,21,61
2020-06-26,2,Bed Number 2,57,19,38
2020-06-26,3,Bed Number 3,67,31,36
2020-06-27,1,Bed Number 1,28,14,14
2020-06-27,2,Bed Number 2,54,22,32
2020-06-27,3,Bed Number 3,22,20,2
2020-06-28,1,Bed Number 1,96,11,85
2020-06-28,2,Bed Number 2,22,16,6
2020-06-28,3,Bed Number 3,75,47,28
2020-06-29,1,Bed Number 1,35,26,9
2020-06-29,2,Bed Number 2,79,40,39
2020-06-29,3,Bed Number 3,93,81,12
2020-06-30,1,Bed Number 1,98,83,15
2020-06-30,2,Bed Number 2,32,14,18
2020-06-30,3,Bed Number 3,52,23,29
2020-07-01,1,Bed Number 1,71,31,40
2020-07-01,2,Bed Number 2,32,23,9
2020-07-01,3,Bed Number 3,91,27,64
2020-07-02,1,Bed Number 1,85,58,27
2020-07-02,2,Bed Number 2,67,8,59
2020-07-02,3,Bed Number 3,31,16,15
2020-07-03,1,Bed Number 1,56,25,31
2020-07-03,2,Bed Number 2,74,17,57
2020-07-03,3,Bed Number 3,41,4,37
2020-07-04,1,Bed Number 1,30,9,21
2020-07-04,2,Bed Number 2,79,27,52
2020-07-04,3,Bed Number 3,70,36,34
2020-07-05,1,Bed Number 1,54,33,21
2020-07-05,2,Bed Number 2,91,34,57
2020-07-05,3,Bed Number 3,47,40,7
2020-07-06,1,Bed Number 1,56,2,54
2020-07-06,2,Bed Number 2,44,22,22
2020-07-06,3,Bed Number 3,99,96,3
2020-07-07,1,Bed Number 1,57,45,12
2020-07-07,2,Bed Number 2,15,2,13
2020-07-07,3,Bed Number 3,98,85,13
2020-07-08,1,Bed Number 1,29,10,19
2020-07-08,2,Bed Number 2,92,12,80
2020-07-08,3,Bed Number 3,40,29,11
2020-07-09,1,Bed Number 1,18,12,6
2020-07-09,2,Bed Number 2,35,3,32
2020-07-09,3,Bed Number 3,64,28,36
2020-07-10,1,Bed Number 1,36,8,28
2020-07-10,2,Bed Number 2,32,27,5
2020-07-10,3,Bed Number 3,94,49,45
2020-07-11,1,Bed Number 1,95,32,63
2020-07-11,2,Bed Number 2,23,10,13
2020-07-11,3,Bed Number 3,78,33,45
2020-07-12,1,Bed Number 1,30,10,20
2020-07-12,2,Bed Number 2,35,34,1
2020-07-12,3,Bed Number 3,61,27,34
2020-07-13,1,Bed Number 1,13,5,8
2020-07-13,2,Bed Number 2,50,28,22
2020-07-13,3,Bed Number 3,95,91,4
2020-07-14,1,Bed Number 1,37,9,28
2020-07-14,2,Bed Number 2,44,24,20
2020-07-14,3,Bed Number 3,49,44,5
2020-07-15,1,Bed Number 1,28,4,24
2020-07-15,2,Bed Number 2,68,48,20
2020-07-15,3,Bed Number 3,95,22,73
2020-07-16,1,Bed Number 1,90,87,3
2020-07-16,2,Bed Number 2,25,17,8
2020-07-16,3,Bed Number 3,82,18,64
2020-07-17,1,Bed Number 1,21,3,18
2020-07-17,2,Bed Number 2,40,17,23
2020-07-17,3,Bed Number 3,85,24,61
2020-07-18,1,Bed Number 1,52,9,43
2020-07-18,2,Bed Number 2,78,46,32
2020-07-18,3,Bed Number 3,17,16,1
2020-07-19,1,Bed Number 1,40,19,21
2020-07-19,2,Bed Number 2,48,25,23
2020-07-19,3,Bed Number 3,64,50,14
2020-07-20,1,Bed Number 1,88,29,59
2020-07-20,2,Bed Number 2,25,0,25
2020-07-20,3,Bed Number 3,58,2,56
2020-07-21,1,Bed Number 1,80,59,21
2020-07-21,2,Bed Number 2,79,25,54
2020-07-21,3,Bed Number 3,39,25,14
2020-07-22,1,Bed Number 1,48,45,3
2020-07-22,2,Bed Number 2,17,6,11
2020-07-22,3,Bed Number 3,72,66,6
2020-07-23,1,Bed Number 1,79,12,67
2020-07-23,2,Bed Number 2,76,56,20
2020-07-23,3,Bed Number 3,16,5,11
2020-07-24,1,Bed Number 1,87,14,73
2020-07-24,2,Bed Number 2,28,12,16
2020-07-24,3,Bed Number 3,92,35,57
2020-07-25,1,Bed Number 1,27,21,6
2020-07-25,2,Bed Number 2,67,27,40
2020-07-25,3,Bed Number 3,20,19,1
2020-07-26,1,Bed Number 1,83,40,43
2020-07-26,2,Bed Number 2,82,65,17
2020-07-26,3,Bed Number 3,44,19,25
2020-07-27,1,Bed Number 1,36,13,23
2020-07-27,2,Bed Number 2,90,38,52
2020-07-27,3,Bed Number 3,25,5,20
2020-07-28,1,Bed Number 1,31,1,30
2020-07-28,2,Bed Number 2,42,41,1
2020-07-28,3,Bed Number 3,46,3,43
2020-07-29,1,Bed Number 1,13,6,7
2020-07-29,2,Bed Number 2,71,55,16
2020-07-29,3,Bed Number 3,78,17,61
2020-07-30,1,Bed Number 1,19,17,2
2020-07-30,2,Bed Number 2,11,3,8
2020-07-30,3,Bed Number 3,15,11,4
2020-07-31,1,Bed Number 1,98,91,7
2020-07-31,2,Bed Number 2,62,24,38
2020-07-31,3,Bed Number 3,78,43,35
2020-08-01,1,Bed Number 1,99,1,98
2020-08-01,2,Bed Number 2,14,4,10
2020-08-01,3,Bed Number 3,26,10,16
2020-08-02,1,Bed Number 1,88,6,82
2020-08-02,2,Bed Number 2,22,20,2
2020-08-02,3,Bed Number 3,51,5,46
2020-08-03,1,Bed Number 1,65,32,33
2020-08-03,2,Bed Number 2,66,48,18
2020-08-03,3,Bed Number 3,82,45,37
2020-08-04,1,Bed Number 1,20,3,17
2020-08-04,2,Bed Number 2,67,2,65
2020-08-04,3,Bed Number 3,29,2,27
2020-08-05,1,Bed Number 1,11,2,9
2020-08-05,2,Bed Number 2,21,12,9
2020-08-05,3,Bed Number 3,77,25,52
2020-08-06,1,Bed Number 1,74,50,24
2020-08-06,2,Bed Number 2,75,35,40
2020-08-06,3,Bed Number 3,49,35,14
2020-08-07,1,Bed Number 1,36,20,16
2020-08-07,2,Bed Number 2,20,0,20
2020-08-07,3,Bed Number 3,55,31,24
2020-08-08,1,Bed Number 1,68,11,57
2020-08-08,2,Bed Number 2,69,4,65
2020-08-08,3,Bed Number 3,84,15,69
2020-08-09,1,Bed Number 1,91,71,20
2020-08-09,2,Bed Number 2,93,69,24
2020-08-09,3,Bed Number 3,72,63,9
2020-08-10,1,Bed Number 1,18,8,10
2020-08-10,2,Bed Number 2,57,55,2
2020-08-10,3,Bed Number 3,73,70,3
2020-08-11,1,Bed Number 1,29,4,25
2020-08-11,2,Bed Number 2,28,24,4
2020-08-11,3,Bed Number 3,72,29,43
2020-08-12,1,Bed Number 1,31,20,11
2020-08-12,2,Bed Number 2,83,29,54
2020-08-12,3,Bed Number 3,52,31,21
2020-08-13,1,Bed Number 1,39,34,5
2020-08-13,2,Bed Number 2,39,4,35
2020-08-13,3,Bed Number 3,87,78,9
2020-08-14,1,Bed Number 1,48,41,7
2020-08-14,2,Bed Number 2,26,4,22
2020-08-14,3,Bed Number 3,42,21,21
2020-08-15,1,Bed Number 1,19,5,14
2020-08-15,2,Bed Number 2,29,0,29
2020-08-15,3,Bed Number 3,21,2,19
2020-08-16,1,Bed Number 1,34,18,16
2020-08-16,2,Bed Number 2,23,22,1
2020-08-16,3,Bed Number 3,43,24,19
2020-08-17,1,Bed Number 1,42,3,39
2020-08-17,2,Bed Number 2,42,10,32
2020-08-17,3,Bed Number 3,54,45,9
2020-08-18,1,Bed Number 1,28,16,12
2020-08-18,2,Bed Number 2,50,50,0
2020-08-18,3,Bed Number 3,91,47,44
2020-08-19,1,Bed Number 1,52,5,47
2020-08-19,2,Bed Number 2,34,26,8
2020-08-19,3,Bed Number 3,87,15,72
2020-08-20,1,Bed Number 1,44,29,15
2020-08-20,2,Bed Number 2,66,48,18
2020-08-20,3,Bed Number 3,76,70,6
2020-08-21,1,Bed Number 1,74,69,5
2020-08-21,2,Bed Number 2,20,4,16
2020-08-21,3,Bed Number 3,80,19,61
2020-08-22,1,Bed Number 1,74,14,60
2020-08-22,2,Bed Number 2,63,46,17
2020-08-22,3,Bed Number 3,86,10,76
2020-08-23,1,Bed Number 1,38,5,33
2020-08-23,2,Bed Number 2,29,3,26
2020-08-23,3,Bed Number 3,38,33,5
2020-08-24,1,Bed Number 1,77,38,39
2020-08-24,2,Bed Number 2,66,0,66
2020-08-24,3,Bed Number 3,83,58,25
2020-08-25,1,Bed Number 1,16,8,8
2020-08-25,2,Bed Number 2,59,41,18
2020-08-25,3,Bed Number 3,24,3,21
2020-08-26,1,Bed Number 1,39,0,39
2020-08-26,2,Bed Number 2,37,1,36
2020-08-26,3,Bed Number 3,76,74,2
2020-08-27,1,Bed Number 1,94,12,82
2020-08-27,2,Bed Number 2,69,6,63
2020-08-27,3,Bed Number 3,44,37,7
2020-08-28,1,Bed Number 1,28,12,16
2020-08-28,2,Bed Number 2,41,2,39
2020-08-28,3,Bed Number 3,100,4,96
2020-08-29,1,Bed Number 1,52,12,40
2020-08-29,2,Bed Number 2,94,12,82
2020-08-29,3,Bed Number 3,78,63,15
2020-08-30,1,Bed Number 1,91,6,85
2020-08-30,2,Bed Number 2,80,35,45
2020-08-30,3,Bed Number 3,31,7,24
2020-08-31,1,Bed Number 1,17,17,0
2020-08-31,2,Bed Number 2,52,48,4
2020-08-31,3,Bed Number 3,25,0,25
2020-09-01,1,Bed Number 1,33,32,1
2020-09-01,2,Bed Number 2,82,66,16
2020-09-01,3,Bed Number 3,68,59,9
2020-09-02,1,Bed Number 1,18,7,11
2020-09-02,2,Bed Number 2,62,19,43
2020-09-02,3,Bed Number 3,52,39,13
2020-09-03,1,Bed Number 1,87,60,27
2020-09-03,2,Bed Number 2,25,14,11
2020-09-03,3,Bed Number 3,24,4,20
2020-09-04,1,Bed Number 1,46,42,4
2020-09-04,2,Bed Number 2,94,56,38
2020-09-04,3,Bed Number 3,84,61,23
2020-09-05,1,Bed Number 1,15,15,0
2020-09-05,2,Bed Number 2,26,3,23
2020-09-05,3,Bed Number 3,70,12,58
2020-09-06,1,Bed Number 1,26,16,10
2020-09-06,2,Bed Number 2,19,1,18
2020-09-06,3,Bed Number 3,35,1,34
2020-09-07,1,Bed Number 1,88,1,87
2020-09-07,2,Bed Number 2,71,17,54
2020-09-07,3,Bed Number 3,29,8,21
2020-09-08,1,Bed Number 1,43,15,28
2020-09-08,2,Bed Number 2,72,38,34
2020-09-08,3,Bed Number 3,44,22,22
2020-09-09,1,Bed Number 1,76,55,21
2020-09-09,2,Bed Number 2,81,18,63
2020-09-09,3,Bed Number 3,62,36,26
2020-09-10,1,Bed Number 1,16,8,8
2020-09-10,2,Bed Number 2,89,57,32
2020-09-10,3,Bed Number 3,65,52,13
2020-09-11,1,Bed Number 1,63,57,6
2020-09-11,2,Bed Number 2,59,3,56
2020-09-11,3,Bed Number 3,85,1,84
2020-09-12,1,Bed Number 1,73,67,6
2020-09-12,2,Bed Number 2,47,42,5
2020-09-12,3,Bed Number 3,30,6,24
2020-09-13,1,Bed Number 1,68,3,65
2020-09-13,2,Bed Number 2,55,34,21
2020-09-13,3,Bed Number 3,18,18,0
2020-09-14,1,Bed Number 1,69,56,13
2020-09-14,2,Bed Number 2,48,23,25
2020-09-14,3,Bed Number 3,99,47,52
2020-09-15,1,Bed Number 1,22,19,3
2020-09-15,2,Bed Number 2,38,4,34
2020-09-15,3,Bed Number 3,63,61,2
2020-09-16,1,Bed Number 1,39,35,4
2020-09-16,2,Bed Number 2,89,47,42
2020-09-16,3,Bed Number 3,34,11,23
2020-09-17,1,Bed Number 1,56,18,38
2020-09-17,2,Bed Number 2,92,39,53
2020-09-17,3,Bed Number 3,91,42,49
2020-09-18,1,Bed Number 1,10,3,7
2020-09-18,2,Bed Number 2,78,28,50
2020-09-18,3,Bed Number 3,45,19,26
2020-09-19,1,Bed Number 1,14,10,4
2020-09-19,2,Bed Number 2,13,10,3
2020-09-19,3,Bed Number 3,57,46,11
2020-09-20,1,Bed Number 1,62,48,14
2020-09-20,2,Bed Number 2,33,19,14
2020-09-20,3,Bed Number 3,12,1,11
2020-09-21,1,Bed Number 1,74,67,7
2020-09-21,2,Bed Number 2,20,2,18
2020-09-21,3,Bed Number 3,41,9,32
2020-09-22,1,Bed Number 1,58,30,28
2020-09-22,2,Bed Number 2,81,12,69
2020-09-22,3,Bed Number 3,35,19,16
2020-09-23,1,Bed Number 1,14,10,4
2020-09-23,2,Bed Number 2,11,7,4
2020-09-23,3,Bed Number 3,17,9,8
2020-09-24,1,Bed Number 1,84,22,62
2020-09-24,2,Bed Number 2,30,14,16
2020-09-24,3,Bed Number 3,52,30,22
2020-09-25,1,Bed Number 1,84,82,2
2020-09-25,2,Bed Number 2,52,44,8
2020-09-25,3,Bed Number 3,93,64,29
2020-09-26,1,Bed Number 1,65,23,42
2020-09-26,2,Bed Number 2,84,28,56
2020-09-26,3,Bed Number 3,56,49,7
2020-09-27,1,Bed Number 1,64,27,37
2020-09-27,2,Bed Number 2,44,43,1
2020-09-27,3,Bed Number 3,63,1,62
2020-09-28,1,Bed Number 1,63,53,10
2020-09-28,2,Bed Number 2,14,11,3
2020-09-28,3,Bed Number 3,74,26,48
2020-09-29,1,Bed Number 1,62,19,43
2020-09-29,2,Bed Number 2,21,1,20
2020-09-29,3,Bed Number 3,32,19,13
2020-09-30,1,Bed Number 1,44,1,43
2020-09-30,2,Bed Number 2,25,0,25
2020-09-30,3,Bed Number 3,15,2,13
2020-10-01,1,Bed Number 1,62,56,6
2020-10-01,2,Bed Number 2,81,34,47
2020-10-01,3,Bed Number 3,36,14,22
2020-10-02,1,Bed Number 1,18,2,16
2020-10-02,2,Bed Number 2,38,15,23
2020-10-02,3,Bed Number 3,51,31,20
2020-10-03,1,Bed Number 1,57,17,40
2020-10-03,2,Bed Number 2,62,16,46
2020-10-03,3,Bed Number 3,76,42,34
2020-10-04,1,Bed Number 1,86,44,42
2020-10-04,2,Bed Number 2,97,67,30
2020-10-04,3,Bed Number 3,98,86,12
2020-10-05,1,Bed Number 1,11,0,11
2020-10-05,2,Bed Number 2,25,9,16
2020-10-05,3,Bed Number 3,51,7,44
2020-10-06,1,Bed Number 1,15,1,14
2020-10-06,2,Bed Number 2,46,42,4
2020-10-06,3,Bed Number 3,29,21,8
2020-10-07,1,Bed Number 1,35,19,16
2020-10-07,2,Bed Number 2,18,7,11
2020-10-07,3,Bed Number 3,49,36,13
2020-10-08,1,Bed Number 1,40,31,9
2020-10-08,2,Bed Number 2,97,55,42
2020-10-08,3,Bed Number 3,62,43,19
2020-10-09,1,Bed Number 1,84,27,57
2020-10-09,2,Bed Number 2,32,11,21
2020-10-09,3,Bed Number 3,55,16,39
2020-10-10,1,Bed Number 1,22,5,17
2020-10-10,2,Bed Number 2,70,14,56
2020-10-10,3,Bed Number 3,13,5,8
2020-10-11,1,Bed Number 1,40,37,3
2020-10-11,2,Bed Number 2,100,21,79
2020-10-11,3,Bed Number 3,20,12,8
2020-10-12,1,Bed Number 1,52,45,7
2020-10-12,2,Bed Number 2,52,2,50
2020-10-12,3,Bed Number 3,51,28,23
2020-10-13,1,Bed Number 1,94,39,55
2020-10-13,2,Bed Number 2,16,2,14
2020-10-13,3,Bed Number 3,98,27,71
2020-10-14,1,Bed Number 1,14,13,1
2020-10-14,2,Bed Number 2,43,6,37
2020-10-14,3,Bed Number 3,63,0,63
2020-10-15,1,Bed Number 1,65,43,22
2020-10-15,2,Bed Number 2,70,64,6
2020-10-15,3,Bed Number 3,37,11,26
2020-10-16,1,Bed Number 1,17,9,8
2020-10-16,2,Bed Number 2,50,35,15
2020-10-16,3,Bed Number 3,15,0,15
2020-10-17,1,Bed Number 1,37,33,4
2020-10-17,2,Bed Number 2,75,70,5
2020-10-17,3,Bed Number 3,29,21,8
2020-10-18,1,Bed Number 1,62,29,33
2020-10-18,2,Bed Number 2,42,17,25
2020-10-18,3,Bed Number 3,32,7,25
2020-10-19,1,Bed Number 1,39,28,11
2020-10-19,2,Bed Number 2,46,13,33
2020-10-19,3,Bed Number 3,82,64,18
2020-10-20,1,Bed Number 1,90,87,3
2020-10-20,2,Bed Number 2,18,15,3
2020-10-20,3,Bed Number 3,19,11,8
2020-10-21,1,Bed Number 1,80,1,79
2020-10-21,2,Bed Number 2,12,3,9
2020-10-21,3,Bed Number 3,62,55,7
2020-10-22,1,Bed Number 1,18,12,6
2020-10-22,2,Bed Number 2,25,3,22
2020-10-22,3,Bed Number 3,51,41,10
2020-10-23,1,Bed Number 1,84,41,43
2020-10-23,2,Bed Number 2,31,2,29
2020-10-23,3,Bed Number 3,45,29,16
2020-10-24,1,Bed Number 1,29,0,29
2020-10-24,2,Bed Number 2,50,48,2
2020-10-24,3,Bed Number 3,50,8,42
2020-10-25,1,Bed Number 1,79,0,79
2020-10-25,2,Bed Number 2,58,22,36
2020-10-25,3,Bed Number 3,27,22,5
2020-10-26,1,Bed Number 1,59,9,50
2020-10-26,2,Bed Number 2,77,4,73
2020-10-26,3,Bed Number 3,46,6,40
2020-10-27,1,Bed Number 1,59,59,0
2020-10-27,2,Bed Number 2,59,39,20
2020-10-27,3,Bed Number 3,45,21,24
2020-10-28,1,Bed Number 1,44,19,25
2020-10-28,2,Bed Number 2,38,28,10
2020-10-28,3,Bed Number 3,47,7,40
2020-10-29,1,Bed Number 1,22,10,12
2020-10-29,2,Bed Number 2,60,18,42
2020-10-29,3,Bed Number 3,33,29,4
2020-10-30,1,Bed Number 1,27,19,8
2020-10-30,2,Bed Number 2,88,47,41
2020-10-30,3,Bed Number 3,85,76,9
2020-10-31,1,Bed Number 1,60,6,54
2020-10-31,2,Bed Number 2,84,73,11
2020-10-31,3,Bed Number 3,57,34,23
2020-11-01,1,Bed Number 1,100,52,48
2020-11-01,2,Bed Number 2,67,60,7
2020-11-01,3,Bed Number 3,98,63,35
2020-11-02,1,Bed Number 1,82,69,13
2020-11-02,2,Bed Number 2,13,1,12
2020-11-02,3,Bed Number 3,42,42,0
2020-11-03,1,Bed Number 1,39,20,19
2020-11-03,2,Bed Number 2,53,23,30
2020-11-03,3,Bed Number 3,75,15,60
2020-11-04,1,Bed Number 1,44,17,27
2020-11-04,2,Bed Number 2,16,6,10
2020-11-04,3,Bed Number 3,28,1,27
2020-11-05,1,Bed Number 1,52,34,18
2020-11-05,2,Bed Number 2,83,66,17
2020-11-05,3,Bed Number 3,61,37,24
2020-11-06,1,Bed Number 1,57,55,2
2020-11-06,2,Bed Number 2,93,83,10
2020-11-06,3,Bed Number 3,60,10,50
2020-11-07,1,Bed Number 1,25,15,10
2020-11-07,2,Bed Number 2,31,3,28
2020-11-07,3,Bed Number 3,39,13,26
2020-11-08,1,Bed Number 1,86,24,62
2020-11-08,2,Bed Number 2,47,13,34
2020-11-08,3,Bed Number 3,71,51,20
2020-11-09,1,Bed Number 1,51,30,21
2020-11-09,2,Bed Number 2,93,59,34
2020-11-09,3,Bed Number 3,81,57,24
2020-11-10,1,Bed Number 1,42,27,15
2020-11-10,2,Bed Number 2,86,20,66
2020-11-10,3,Bed Number 3,57,51,6
2020-11-11,1,Bed Number 1,16,15,1
2020-11-11,2,Bed Number 2,10,5,5
2020-11-11,3,Bed Number 3,70,58,12
2020-11-12,1,Bed Number 1,42,27,15
2020-11-12,2,Bed Number 2,72,42,30
2020-11-12,3,Bed Number 3,14,4,10
2020-11-13,1,Bed Number 1,18,1,17
2020-11-13,2,Bed Number 2,66,15,51
2020-11-13,3,Bed Number 3,52,48,4
2020-11-14,1,Bed Number 1,44,39,5
2020-11-14,2,Bed Number 2,35,14,21
2020-11-14,3,Bed Number 3,24,24,0
2020-11-15,1,Bed Number 1,71,5,66
2020-11-15,2,Bed Number 2,11,8,3
2020-11-15,3,Bed Number 3,52,41,11
2020-11-16,1,Bed Number 1,66,20,46
2020-11-16,2,Bed Number 2,84,39,45
2020-11-16,3,Bed Number 3,13,1,12
2020-11-17,1,Bed Number 1,79,25,54
2020-11-17,2,Bed Number 2,81,18,63
2020-11-17,3,Bed Number 3,14,1,13
2020-11-18,1,Bed Number 1,77,0,77
2020-11-18,2,Bed Number 2,17,7,10
2020-11-18,3,Bed Number 3,98,30,68
2020-11-19,1,Bed Number 1,90,30,60
2020-11-19,2,Bed Number 2,54,16,38
2020-11-19,3,Bed Number 3,43,14,29
2020-11-20,1,Bed Number 1,96,31,65
2020-11-20,2,Bed Number 2,100,45,55
2020-11-20,3,Bed Number 3,18,5,13
2020-11-21,1,Bed Number 1,45,2,43
2020-11-21,2,Bed Number 2,38,32,6
2020-11-21,3,Bed Number 3,51,34,17
2020-11-22,1,Bed Number 1,56,8,48
2020-11-22,2,Bed Number 2,22,5,17
2020-11-22,3,Bed Number 3,79,42,37
2020-11-23,1,Bed Number 1,82,38,44
2020-11-23,2,Bed Number 2,66,24,42
2020-11-23,3,Bed Number 3,75,46,29
2020-11-24,1,Bed Number 1,16,11,5
2020-11-24,2,Bed Number 2,14,13,1
2020-11-24,3,Bed Number 3,98,46,52
2020-11-25,1,Bed Number 1,59,36,23
2020-11-25,2,Bed Number 2,87,71,16
2020-11-25,3,Bed Number 3,57,32,25
2020-11-26,1,Bed Number 1,30,11,19
2020-11-26,2,Bed Number 2,16,9,7
2020-11-26,3,Bed Number 3,59,50,9
2020-11-27,1,Bed Number 1,61,33,28
2020-11-27,2,Bed Number 2,71,1,70
2020-11-27,3,Bed Number 3,28,2,26
2020-11-28,1,Bed Number 1,76,31,45
2020-11-28,2,Bed Number 2,68,27,41
2020-11-28,3,Bed Number 3,62,9,53
2020-11-29,1,Bed Number 1,73,9,64
2020-11-29,2,Bed Number 2,92,68,24
2020-11-29,3,Bed Number 3,79,15,64
2020-11-30,1,Bed Number 1,45,10,35
2020-11-30,2,Bed Number 2,77,68,9
2020-11-30,3,Bed Number 3,43,28,15
2020-12-01,1,Bed Number 1,27,13,14
2020-12-01,2,Bed Number 2,59,51,8
2020-12-01,3,Bed Number 3,99,99,0
2020-12-02,1,Bed Number 1,19,19,0
2020-12-02,2,Bed Number 2,76,25,51
2020-12-02,3,Bed Number 3,39,23,16
2020-12-03,1,Bed Number 1,12,5,7
2020-12-03,2,Bed Number 2,38,3,35
2020-12-03,3,Bed Number 3,46,23,23
2020-12-04,1,Bed Number 1,82,42,40
2020-12-04,2,Bed Number 2,23,2,21
2020-12-04,3,Bed Number 3,84,18,66
2020-12-05,1,Bed Number 1,79,29,50
2020-12-05,2,Bed Number 2,88,25,63
2020-12-05,3,Bed Number 3,82,14,68
2020-12-06,1,Bed Number 1,41,10,31
2020-12-06,2,Bed Number 2,42,3,39
2020-12-06,3,Bed Number 3,86,71,15
2020-12-07,1,Bed Number 1,57,15,42
2020-12-07,2,Bed Number 2,27,24,3
2020-12-07,3,Bed Number 3,60,60,0
2020-12-08,1,Bed Number 1,49,45,4
2020-12-08,2,Bed Number 2,50,17,33
2020-12-08,3,Bed Number 3,37,4,33
2020-12-09,1,Bed Number 1,41,16,25
2020-12-09,2,Bed Number 2,68,17,51
2020-12-09,3,Bed Number 3,15,8,7
2020-12-10,1,Bed Number 1,41,16,25
2020-12-10,2,Bed Number 2,95,66,29
2020-12-10,3,Bed Number 3,32,8,24
2020-12-11,1,Bed Number 1,11,11,0
2020-12-11,2,Bed Number 2,43,16,27
2020-12-11,3,Bed Number 3,23,18,5
2020-12-12,1,Bed Number 1,80,43,37
2020-12-12,2,Bed Number 2,44,43,1
2020-12-12,3,Bed Number 3,65,0,65
2020-12-13,1,Bed Number 1,54,11,43
2020-12-13,2,Bed Number 2,86,10,76
2020-12-13,3,Bed Number 3,83,36,47
2020-12-14,1,Bed Number 1,42,32,10
2020-12-14,2,Bed Number 2,89,46,43
2020-12-14,3,Bed Number 3,59,23,36
2020-12-15,1,Bed Number 1,74,58,16
2020-12-15,2,Bed Number 2,21,8,13
2020-12-15,3,Bed Number 3,10,7,3
2020-12-16,1,Bed Number 1,54,41,13
2020-12-16,2,Bed Number 2,27,25,2
2020-12-16,3,Bed Number 3,55,33,22
2020-12-17,1,Bed Number 1,29,3,26
2020-12-17,2,Bed Number 2,80,64,16
2020-12-17,3,Bed Number 3,74,30,44
2020-12-18,1,Bed Number 1,37,31,6
2020-12-18,2,Bed Number 2,90,3,87
2020-12-18,3,Bed Number 3,68,4,64
2020-12-19,1,Bed Number 1,31,26,5
2020-12-19,2,Bed Number 2,20,13,7
2020-12-19,3,Bed Number 3,68,56,12
2020-12-20,1,Bed Number 1,51,9,42
2020-12-20,2,Bed Number 2,69,27,42
2020-12-20,3,Bed Number 3,29,20,9
2020-12-21,1,Bed Number 1,43,16,27
2020-12-21,2,Bed Number 2,93,51,42
2020-12-21,3,Bed Number 3,26,3,23
2020-12-22,1,Bed Number 1,64,20,44
2020-12-22,2,Bed Number 2,73,9,64
2020-12-22,3,Bed Number 3,59,57,2
2020-12-23,1,Bed Number 1,88,65,23
2020-12-23,2,Bed Number 2,26,18,8
2020-12-23,3,Bed Number 3,50,37,13
2020-12-24,1,Bed Number 1,67,66,1
2020-12-24,2,Bed Number 2,97,18,79
2020-12-24,3,Bed Number 3,92,45,47
2020-12-25,1,Bed Number 1,98,62,36
2020-12-25,2,Bed Number 2,47,43,4
2020-12-25,3,Bed Number 3,57,36,21
2020-12-26,1,Bed Number 1,38,26,12
2020-12-26,2,Bed Number 2,52,25,27
2020-12-26,3,Bed Number 3,44,7,37
2020-12-27,1,Bed Number 1,14,3,11
2020-12-27,2,Bed Number 2,37,14,23
2020-12-27,3,Bed Number 3,74,24,50
2020-12-28,1,Bed Number 1,37,6,31
2020-12-28,2,Bed Number 2,37,10,27
2020-12-28,3,Bed Number 3,10,0,10
2020-12-29,1,Bed Number 1,70,17,53
2020-12-29,2,Bed Number 2,36,10,26
2020-12-29,3,Bed Number 3,97,64,33
2020-12-30,1,Bed Number 1,15,15,0
2020-12-30,2,Bed Number 2,90,42,48
2020-12-30,3,Bed Number 3,39,6,33
2020-12-31,1,Bed Number 1,77,16,61
2020-12-31,2,Bed Number 2,41,16,25
2020-12-31,3,Bed Number 3,100,44,56
2021-01-01,1,Bed Number 1,52,49,3
2021-01-01,2,Bed Number 2,89,29,60
2021-01-01,3,Bed Number 3,53,53,0
2021-01-02,1,Bed Number 1,68,57,11
2021-01-02,2,Bed Number 2,63,4,59
2021-01-02,3,Bed Number 3,10,1,9
2021-01-03,1,Bed Number 1,52,41,11
2021-01-03,2,Bed Number 2,35,31,4
2021-01-03,3,Bed Number 3,18,17,1
2021-01-04,1,Bed Number 1,19,3,16
2021-01-04,2,Bed Number 2,18,3,15
2021-01-04,3,Bed Number 3,70,66,4
2021-01-05,1,Bed Number 1,28,26,2
2021-01-05,2,Bed Number 2,59,37,22
2021-01-05,3,Bed Number 3,61,11,50
2021-01-06,1,Bed Number 1,65,28,37
2021-01-06,2,Bed Number 2,20,14,6
2021-01-06,3,Bed Number 3,85,11,74
2021-01-07,1,Bed Number 1,62,33,29
2021-01-07,2,Bed Number 2,74,45,29
2021-01-07,3,Bed Number 3,65,63,2
2021-01-08,1,Bed Number 1,95,25,70
2021-01-08,2,Bed Number 2,81,27,54
2021-01-08,3,Bed Number 3,88,37,51
2021-01-09,1,Bed Number 1,11,0,11
2021-01-09,2,Bed Number 2,71,21,50
2021-01-09,3,Bed Number 3,47,26,21
2021-01-10,1,Bed Number 1,83,58,25
2021-01-10,2,Bed Number 2,28,22,6
2021-01-10,3,Bed Number 3,49,0,49
2021-01-11,1,Bed Number 1,93,55,38
2021-01-11,2,Bed Number 2,12,7,5
2021-01-11,3,Bed Number 3,36,35,1
2021-01-12,1,Bed Number 1,87,30,57
2021-01-12,2,Bed Number 2,15,2,13
2021-01-12,3,Bed Number 3,79,44,35
2021-01-13,1,Bed Number 1,40,1,39
2021-01-13,2,Bed Number 2,12,10,2
2021-01-13,3,Bed Number 3,95,28,67
2021-01-14,1,Bed Number 1,20,1,19
2021-01-14,2,Bed Number 2,40,10,30
2021-01-14,3,Bed Number 3,20,18,2
2021-01-15,1,Bed Number 1,46,24,22
2021-01-15,2,Bed Number 2,87,43,44
2021-01-15,3,Bed Number 3,75,40,35
2021-01-16,1,Bed Number 1,91,41,50
2021-01-16,2,Bed Number 2,40,28,12
2021-01-16,3,Bed Number 3,91,91,0
2021-01-17,1,Bed Number 1,87,54,33
2021-01-17,2,Bed Number 2,16,14,2
2021-01-17,3,Bed Number 3,63,44,19
2021-01-18,1,Bed Number 1,79,59,20
2021-01-18,2,Bed Number 2,89,53,36
2021-01-18,3,Bed Number 3,90,60,30
2021-01-19,1,Bed Number 1,54,15,39
2021-01-19,2,Bed Number 2,56,55,1
2021-01-19,3,Bed Number 3,32,17,15
2021-01-20,1,Bed Number 1,63,47,16
2021-01-20,2,Bed Number 2,10,8,2
2021-01-20,3,Bed Number 3,63,26,37
2021-01-21,1,Bed Number 1,15,10,5
2021-01-21,2,Bed Number 2,41,37,4
2021-01-21,3,Bed Number 3,100,98,2
2021-01-22,1,Bed Number 1,67,24,43
2021-01-22,2,Bed Number 2,48,17,31
2021-01-22,3,Bed Number 3,11,9,2
2021-01-23,1,Bed Number 1,58,53,5
2021-01-23,2,Bed Number 2,97,39,58
2021-01-23,3,Bed Number 3,78,12,66
2021-01-24,1,Bed Number 1,84,43,41
2021-01-24,2,Bed Number 2,71,54,17
2021-01-24,3,Bed Number 3,18,3,15
2021-01-25,1,Bed Number 1,93,10,83
2021-01-25,2,Bed Number 2,79,10,69
2021-01-25,3,Bed Number 3,49,34,15
2021-01-26,1,Bed Number 1,55,13,42
2021-01-26,2,Bed Number 2,10,6,4
2021-01-26,3,Bed Number 3,41,21,20
2021-01-27,1,Bed Number 1,88,42,46
2021-01-27,2,Bed Number 2,85,49,36
2021-01-27,3,Bed Number 3,21,7,14
2021-01-28,1,Bed Number 1,18,15,3
2021-01-28,2,Bed Number 2,34,22,12
2021-01-28,3,Bed Number 3,87,32,55
2021-01-29,1,Bed Number 1,22,2,20
2021-01-29,2,Bed Number 2,99,93,6
2021-01-29,3,Bed Number 3,14,2,12
2021-01-30,1,Bed Number 1,58,1,57
2021-01-30,2,Bed Number 2,10,8,2
2021-01-30,3,Bed Number 3,14,14,0
2021-01-31,1,Bed Number 1,73,45,28
2021-01-31,2,Bed Number 2,38,9,29
2021-01-31,3,Bed Number 3,100,19,81
2021-02-01,1,Bed Number 1,89,28,61
2021-02-01,2,Bed Number 2,10,7,3
2021-02-01,3,Bed Number 3,63,9,54
2021-02-02,1,Bed Number 1,34,9,25
2021-02-02,2,Bed Number 2,88,49,39
2021-02-02,3,Bed Number 3,51,43,8
2021-02-03,1,Bed Number 1,45,38,7
2021-02-03,2,Bed Number 2,80,19,61
2021-02-03,3,Bed Number 3,10,9,1
2021-02-04,1,Bed Number 1,76,15,61
2021-02-04,2,Bed Number 2,48,33,15
2021-02-04,3,Bed Number 3,76,25,51
2021-02-05,1,Bed Number 1,34,27,7
2021-02-05,2,Bed Number 2,62,23,39
2021-02-05,3,Bed Number 3,82,38,44
2021-02-06,1,Bed Number 1,82,62,20
2021-02-06,2,Bed Number 2,27,0,27
2021-02-06,3,Bed Number 3,91,74,17
2021-02-07,1,Bed Number 1,31,0,31
2021-02-07,2,Bed Number 2,76,58,18
2021-02-07,3,Bed Number 3,34,33,1
2021-02-08,1,Bed Number 1,46,11,35
2021-02-08,2,Bed Number 2,26,20,6
2021-02-08,3,Bed Number 3,32,18,14
2021-02-09,1,Bed Number 1,80,47,33
2021-02-09,2,Bed Number 2,22,2,20
2021-02-09,3,Bed Number 3,41,2,39
2021-02-10,1,Bed Number 1,100,89,11
2021-02-10,2,Bed Number 2,94,42,52
2021-02-10,3,Bed Number 3,59,27,32
2021-02-11,1,Bed Number 1,23,16,7
2021-02-11,2,Bed Number 2,49,43,6
2021-02-11,3,Bed Number 3,50,37,13
2021-02-12,1,Bed Number 1,51,3,48
2021-02-12,2,Bed Number 2,70,42,28
2021-02-12,3,Bed Number 3,73,60,13
2021-02-13,1,Bed Number 1,47,4,43
2021-02-13,2,Bed Number 2,93,17,76
2021-02-13,3,Bed Number 3,82,16,66
2021-02-14,1,Bed Number 1,88,33,55
2021-02-14,2,Bed Number 2,46,42,4
2021-02-14,3,Bed Number 3,67,61,6
2021-02-15,1,Bed Number 1,60,34,26
2021-02-15,2,Bed Number 2,50,19,31
2021-02-15,3,Bed Number 3,77,58,19
2021-02-16,1,Bed Number 1,87,87,0
2021-02-16,2,Bed Number 2,15,8,7
2021-02-16,3,Bed Number 3,41,15,26
2021-02-17,1,Bed Number 1,17,13,4
2021-02-17,2,Bed Number 2,76,35,41
2021-02-17,3,Bed Number 3,67,33,34
2021-02-18,1,Bed Number 1,35,4,31
2021-02-18,2,Bed Number 2,65,49,16
2021-02-18,3,Bed Number 3,73,69,4
2021-02-19,1,Bed Number 1,20,5,15
2021-02-19,2,Bed Number 2,37,31,6
2021-02-19,3,Bed Number 3,59,20,39
2021-02-20,1,Bed Number 1,33,2,31
2021-02-20,2,Bed Number 2,71,65,6
2021-02-20,3,Bed Number 3,59,39,20
2021-02-21,1,Bed Number 1,55,54,1
2021-02-21,2,Bed Number 2,59,40,19
2021-02-21,3,Bed Number 3,71,50,21
2021-02-22,1,Bed Number 1,96,4,92
2021-02-22,2,Bed Number 2,14,12,2
2021-02-22,3,Bed Number 3,79,21,58
2021-02-23,1,Bed Number 1,26,2,24
2021-02-23,2,Bed Number 2,81,14,67
2021-02-23,3,Bed Number 3,91,15,76
2021-02-24,1,Bed Number 1,56,32,24
2021-02-24,2,Bed Number 2,41,3,38
2021-02-24,3,Bed Number 3,69,31,38
2021-02-25,1,Bed Number 1,64,16,48
2021-02-25,2,Bed Number 2,80,39,41
2021-02-25,3,Bed Number 3,15,10,5
2021-02-26,1,Bed Number 1,94,46,48
2021-02-26,2,Bed Number 2,25,15,10
2021-02-26,3,Bed Number 3,13,12,1
2021-02-27,1,Bed Number 1,60,5,55
2021-02-27,2,Bed Number 2,95,2,93
2021-02-27,3,Bed Number 3,29,12,17
2021-02-28,1,Bed Number 1,43,15,28
2021-02-28,2,Bed Number 2,83,23,60
2021-02-28,3,Bed Number 3,92,58,34
2021-03-01,1,Bed Number 1,74,16,58
2021-03-01,2,Bed Number 2,62,30,32
2021-03-01,3,Bed Number 3,97,17,80
2021-03-02,1,Bed Number 1,46,41,5
2021-03-02,2,Bed Number 2,79,75,4
2021-03-02,3,Bed Number 3,77,21,56
2021-03-03,1,Bed Number 1,19,14,5
2021-03-03,2,Bed Number 2,100,21,79
2021-03-03,3,Bed Number 3,41,15,26
2021-03-04,1,Bed Number 1,33,16,17
2021-03-04,2,Bed Number 2,14,4,10
2021-03-04,3,Bed Number 3,81,52,29
2021-03-05,1,Bed Number 1,17,6,11
2021-03-05,2,Bed Number 2,44,10,34
2021-03-05,3,Bed Number 3,81,5,76
2021-03-06,1,Bed Number 1,19,12,7
2021-03-06,2,Bed Number 2,41,16,25
2021-03-06,3,Bed Number 3,10,2,8
2021-03-07,1,Bed Number 1,41,6,35
2021-03-07,2,Bed Number 2,66,34,32
2021-03-07,3,Bed Number 3,33,15,18
2021-03-08,1,Bed Number 1,87,3,84
2021-03-08,2,Bed Number 2,58,23,35
2021-03-08,3,Bed Number 3,69,48,21
2021-03-09,1,Bed Number 1,42,8,34
2021-03-09,2,Bed Number 2,94,29,65
2021-03-09,3,Bed Number 3,90,24,66
2021-03-10,1,Bed Number 1,84,33,51
2021-03-10,2,Bed Number 2,90,13,77
2021-03-10,3,Bed Number 3,23,12,11
2021-03-11,1,Bed Number 1,97,36,61
2021-03-11,2,Bed Number 2,43,5,38
2021-03-11,3,Bed Number 3,12,1,11
2021-03-12,1,Bed Number 1,79,23,56
2021-03-12,2,Bed Number 2,100,78,22
2021-03-12,3,Bed Number 3,85,7,78
2021-03-13,1,Bed Number 1,68,6,62
2021-03-13,2,Bed Number 2,43,40,3
2021-03-13,3,Bed Number 3,17,12,5
2021-03-14,1,Bed Number 1,11,1,10
2021-03-14,2,Bed Number 2,76,41,35
2021-03-14,3,Bed Number 3,92,52,40
2021-03-15,1,Bed Number 1,39,35,4
2021-03-15,2,Bed Number 2,76,4,72
2021-03-15,3,Bed Number 3,55,7,48
2021-03-16,1,Bed Number 1,39,37,2
2021-03-16,2,Bed Number 2,42,42,0
2021-03-16,3,Bed Number 3,82,59,23
2021-03-17,1,Bed Number 1,80,37,43
2021-03-17,2,Bed Number 2,49,10,39
2021-03-17,3,Bed Number 3,53,8,45
2021-03-18,1,Bed Number 1,82,5,77
2021-03-18,2,Bed Number 2,25,11,14
2021-03-18,3,Bed Number 3,67,6,61
2021-03-19,1,Bed Number 1,53,10,43
2021-03-19,2,Bed Number 2,32,23,9
2021-03-19,3,Bed Number 3,74,27,47
2021-03-20,1,Bed Number 1,37,35,2
2021-03-20,2,Bed Number 2,36,8,28
2021-03-20,3,Bed Number 3,14,9,5
2021-03-21,1,Bed Number 1,76,58,18
2021-03-21,2,Bed Number 2,18,4,14
2021-03-21,3,Bed Number 3,48,24,24
2021-03-22,1,Bed Number 1,34,8,26
2021-03-22,2,Bed Number 2,28,22,6
2021-03-22,3,Bed Number 3,52,14,38
2021-03-23,1,Bed Number 1,68,14,54
2021-03-23,2,Bed Number 2,14,5,9
2021-03-23,3,Bed Number 3,53,17,36
2021-03-24,1,Bed Number 1,15,14,1
2021-03-24,2,Bed Number 2,89,79,10
2021-03-24,3,Bed Number 3,39,10,29
2021-03-25,1,Bed Number 1,32,13,19
2021-03-25,2,Bed Number 2,73,28,45
2021-03-25,3,Bed Number 3,38,11,27
2021-03-26,1,Bed Number 1,44,2,42
2021-03-26,2,Bed Number 2,42,20,22
2021-03-26,3,Bed Number 3,28,27,1
2021-03-27,1,Bed Number 1,47,46,1
2021-03-27,2,Bed Number 2,54,37,17
2021-03-27,3,Bed Number 3,82,51,31
2021-03-28,1,Bed Number 1,91,18,73
2021-03-28,2,Bed Number 2,76,73,3
2021-03-28,3,Bed Number 3,33,12,21
2021-03-29,1,Bed Number 1,32,21,11
2021-03-29,2,Bed Number 2,54,13,41
2021-03-29,3,Bed Number 3,93,33,60
2021-03-30,1,Bed Number 1,40,0,40
2021-03-30,2,Bed Number 2,93,3,90
2021-03-30,3,Bed Number 3,75,42,33
2021-03-31,1,Bed Number 1,40,19,21
2021-03-31,2,Bed Number 2,23,8,15
2021-03-31,3,Bed Number 3,91,75,16
2021-04-01,1,Bed Number 1,66,5,61
2021-04-01,2,Bed Number 2,44,15,29
2021-04-01,3,Bed Number 3,19,1,18
2021-04-02,1,Bed Number 1,82,19,63
2021-04-02,2,Bed Number 2,16,14,2
2021-04-02,3,Bed Number 3,97,9,88
2021-04-03,1,Bed Number 1,92,69,23
2021-04-03,2,Bed Number 2,14,3,11
2021-04-03,3,Bed Number 3,28,20,8
2021-04-04,1,Bed Number 1,43,24,19
2021-04-04,2,Bed Number 2,31,8,23
2021-04-04,3,Bed Number 3,74,44,30
2021-04-05,1,Bed Number 1,80,35,45
2021-04-05,2,Bed Number 2,36,33,3
2021-04-05,3,Bed Number 3,23,3,20
2021-04-06,1,Bed Number 1,91,47,44
2021-04-06,2,Bed Number 2,21,16,5
2021-04-06,3,Bed Number 3,95,0,95
2021-04-07,1,Bed Number 1,64,19,45
2021-04-07,2,Bed Number 2,46,15,31
2021-04-07,3,Bed Number 3,14,12,2
2021-04-08,1,Bed Number 1,100,67,33
2021-04-08,2,Bed Number 2,28,3,25
2021-04-08,3,Bed Number 3,22,18,4
2021-04-09,1,Bed Number 1,20,10,10
2021-04-09,2,Bed Number 2,34,32,2
2021-04-09,3,Bed Number 3,38,37,1
2021-04-10,1,Bed Number 1,98,39,59
2021-04-10,2,Bed Number 2,82,80,2
2021-04-10,3,Bed Number 3,66,32,34
2021-04-11,1,Bed Number 1,57,44,13
2021-04-11,2,Bed Number 2,52,32,20
2021-04-11,3,Bed Number 3,22,16,6
2021-04-12,1,Bed Number 1,14,9,5
2021-04-12,2,Bed Number 2,82,46,36
2021-04-12,3,Bed Number 3,71,58,13
2021-04-13,1,Bed Number 1,11,11,0
2021-04-13,2,Bed Number 2,42,28,14
2021-04-13,3,Bed Number 3,78,51,27
2021-04-14,1,Bed Number 1,14,12,2
2021-04-14,2,Bed Number 2,61,4,57
2021-04-14,3,Bed Number 3,41,27,14
2021-04-15,1,Bed Number 1,64,39,25
2021-04-15,2,Bed Number 2,53,13,40
2021-04-15,3,Bed Number 3,40,33,7
2021-04-16,1,Bed Number 1,62,45,17
2021-04-16,2,Bed Number 2,24,10,14
2021-04-16,3,Bed Number 3,25,7,18
2021-04-17,1,Bed Number 1,86,69,17
2021-04-17,2,Bed Number 2,78,52,26
2021-04-17,3,Bed Number 3,74,5,69
2021-04-18,1,Bed Number 1,43,32,11
2021-04-18,2,Bed Number 2,20,13,7
2021-04-18,3,Bed Number 3,62,30,32
2021-04-19,1,Bed Number 1,91,41,50
2021-04-19,2,Bed Number 2,22,0,22
2021-04-19,3,Bed Number 3,17,4,13
2021-04-20,1,Bed Number 1,19,3,16
2021-04-20,2,Bed Number 2,12,2,10
2021-04-20,3,Bed Number 3,93,59,34
2021-04-21,1,Bed Number 1,88,67,21
2021-04-21,2,Bed Number 2,51,22,29
2021-04-21,3,Bed Number 3,53,33,20
2021-04-22,1,Bed Number 1,25,14,11
2021-04-22,2,Bed Number 2,90,36,54
2021-04-22,3,Bed Number 3,23,12,11
2021-04-23,1,Bed Number 1,92,92,0
2021-04-23,2,Bed Number 2,71,37,34
2021-04-23,3,Bed Number 3,29,29,0
2021-04-24,1,Bed Number 1,94,46,48
2021-04-24,2,Bed Number 2,41,17,24
2021-04-24,3,Bed Number 3,99,74,25
2021-04-25,1,Bed Number 1,40,20,20
2021-04-25,2,Bed Number 2,100,52,48
2021-04-25,3,Bed Number 3,30,28,2
2021-04-26,1,Bed Number 1,82,13,69
2021-04-26,2,Bed Number 2,42,38,4
2021-04-26,3,Bed Number 3,100,28,72
2021-04-27,1,Bed Number 1,68,55,13
2021-04-27,2,Bed Number 2,81,12,69
2021-04-27,3,Bed Number 3,81,74,7
2021-04-28,1,Bed Number 1,36,35,1
2021-04-28,2,Bed Number 2,14,0,14
2021-04-28,3,Bed Number 3,12,5,7
2021-04-29,1,Bed Number 1,66,12,54
2021-04-29,2,Bed Number 2,34,18,16
2021-04-29,3,Bed Number 3,37,7,30
2021-04-30,1,Bed Number 1,29,18,11
2021-04-30,2,Bed Number 2,25,22,3
2021-04-30,3,Bed Number 3,46,34,12
2021-05-01,1,Bed Number 1,59,11,48
2021-05-01,2,Bed Number 2,69,46,23
2021-05-01,3,Bed Number 3,29,28,1
2021-05-02,1,Bed Number 1,19,16,3
2021-05-02,2,Bed Number 2,31,30,1
2021-05-02,3,Bed Number 3,32,17,15
2021-05-03,1,Bed Number 1,90,11,79
2021-05-03,2,Bed Number 2,10,7,3
2021-05-03,3,Bed Number 3,11,11,0
2021-05-04,1,Bed Number 1,53,26,27
2021-05-04,2,Bed Number 2,10,7,3
2021-05-04,3,Bed Number 3,59,18,41
2021-05-05,1,Bed Number 1,50,9,41
2021-05-05,2,Bed Number 2,69,55,14
2021-05-05,3,Bed Number 3,40,5,35
2021-05-06,1,Bed Number 1,74,61,13
2021-05-06,2,Bed Number 2,59,48,11
2021-05-06,3,Bed Number 3,68,18,50
2021-05-07,1,Bed Number 1,83,79,4
2021-05-07,2,Bed Number 2,18,13,5
2021-05-07,3,Bed Number 3,10,0,10
2021-05-08,1,Bed Number 1,95,66,29
2021-05-08,2,Bed Number 2,25,12,13
2021-05-08,3,Bed Number 3,51,32,19
2021-05-09,1,Bed Number 1,40,16,24
2021-05-09,2,Bed Number 2,84,40,44
2021-05-09,3,Bed Number 3,59,51,8
2021-05-10,1,Bed Number 1,87,56,31
2021-05-10,2,Bed Number 2,63,10,53
2021-05-10,3,Bed Number 3,81,43,38
2021-05-11,1,Bed Number 1,42,13,29
2021-05-11,2,Bed Number 2,39,12,27
2021-05-11,3,Bed Number 3,97,10,87
2021-05-12,1,Bed Number 1,34,13,21
2021-05-12,2,Bed Number 2,53,35,18
2021-05-12,3,Bed Number 3,41,7,34
2021-05-13,1,Bed Number 1,16,10,6
2021-05-13,2,Bed Number 2,16,16,0
2021-05-13,3,Bed Number 3,77,3,74
2021-05-14,1,Bed Number 1,56,7,49
2021-05-14,2,Bed Number 2,82,13,69
2021-05-14,3,Bed Number 3,38,8,30
2021-05-15,1,Bed Number 1,17,6,11
2021-05-15,2,Bed Number 2,67,22,45
2021-05-15,3,Bed Number 3,43,32,11
2021-05-16,1,Bed Number 1,72,45,27
2021-05-16,2,Bed Number 2,55,52,3
2021-05-16,3,Bed Number 3,64,44,20
2021-05-17,1,Bed Number 1,19,5,14
2021-05-17,2,Bed Number 2,84,43,41
2021-05-17,3,Bed Number 3,29,4,25
2021-05-18,1,Bed Number 1,68,13,55
2021-05-18,2,Bed Number 2,56,56,0
2021-05-18,3,Bed Number 3,99,21,78
2021-05-19,1,Bed Number 1,92,58,34
2021-05-19,2,Bed Number 2,34,1,33
2021-05-19,3,Bed Number 3,17,9,8
2021-05-20,1,Bed Number 1,97,91,6
2021-05-20,2,Bed Number 2,54,17,37
2021-05-20,3,Bed Number 3,16,13,3
2021-05-21,1,Bed Number 1,28,5,23
2021-05-21,2,Bed Number 2,74,18,56
2021-05-21,3,Bed Number 3,69,36,33
2021-05-22,1,Bed Number 1,45,24,21
2021-05-22,2,Bed Number 2,61,5,56
2021-05-22,3,Bed Number 3,81,74,7
2021-05-23,1,Bed Number 1,76,22,54
2021-05-23,2,Bed Number 2,48,22,26
2021-05-23,3,Bed Number 3,28,4,24
2021-05-24,1,Bed Number 1,23,3,20
2021-05-24,2,Bed Number 2,59,42,17
2021-05-24,3,Bed Number 3,100,89,11
2021-05-25,1,Bed Number 1,50,1,49
2021-05-25,2,Bed Number 2,98,18,80
2021-05-25,3,Bed Number 3,38,30,8
2021-05-26,1,Bed Number 1,67,14,53
2021-05-26,2,Bed Number 2,93,64,29
2021-05-26,3,Bed Number 3,95,12,83
2021-05-27,1,Bed Number 1,76,21,55
2021-05-27,2,Bed Number 2,80,10,70
2021-05-27,3,Bed Number 3,76,55,21
2021-05-28,1,Bed Number 1,72,31,41
2021-05-28,2,Bed Number 2,76,52,24
2021-05-28,3,Bed Number 3,10,7,3
2021-05-29,1,Bed Number 1,38,11,27
2021-05-29,2,Bed Number 2,90,18,72
2021-05-29,3,Bed Number 3,18,13,5
2021-05-30,1,Bed Number 1,52,41,11
2021-05-30,2,Bed Number 2,83,76,7
2021-05-30,3,Bed Number 3,18,9,9
2021-05-31,1,Bed Number 1,35,7,28
2021-05-31,2,Bed Number 2,32,14,18
2021-05-31,3,Bed Number 3,37,4,33
2021-06-01,1,Bed Number 1,40,4,36
2021-06-01,2,Bed Number 2,41,21,20
2021-06-01,3,Bed Number 3,27,23,4
2021-06-02,1,Bed Number 1,79,73,6
2021-06-02,2,Bed Number 2,64,11,53
2021-06-02,3,Bed Number 3,83,9,74
2021-06-03,1,Bed Number 1,63,62,1
2021-06-03,2,Bed Number 2,97,27,70
2021-06-03,3,Bed Number 3,79,73,6
2021-06-04,1,Bed Number 1,26,10,16
2021-06-04,2,Bed Number 2,41,32,9
2021-06-04,3,Bed Number 3,82,74,8
2021-06-05,1,Bed Number 1,97,48,49
2021-06-05,2,Bed Number 2,81,14,67
2021-06-05,3,Bed Number 3,77,60,17
2021-06-06,1,Bed Number 1,52,6,46
2021-06-06,2,Bed Number 2,28,25,3
2021-06-06,3,Bed Number 3,81,56,25
2021-06-07,1,Bed Number 1,16,7,9
2021-06-07,2,Bed Number 2,93,3,90
2021-06-07,3,Bed Number 3,81,7,74
2021-06-08,1,Bed Number 1,13,8,5
2021-06-08,2,Bed Number 2,79,28,51
2021-06-08,3,Bed Number 3,26,21,5
2021-06-09,1,Bed Number 1,13,2,11
2021-06-09,2,Bed Number 2,59,49,10
2021-06-09,3,Bed Number 3,52,39,13
2021-06-10,1,Bed Number 1,37,28,9
2021-06-10,2,Bed Number 2,54,23,31
2021-06-10,3,Bed Number 3,57,33,24
2021-06-11,1,Bed Number 1,83,17,66
2021-06-11,2,Bed Number 2,11,11,0
2021-06-11,3,Bed Number 3,39,31,8
2021-06-12,1,Bed Number 1,41,26,15
2021-06-12,2,Bed Number 2,18,5,13
2021-06-12,3,Bed Number 3,72,28,44
2021-06-13,1,Bed Number 1,75,43,32
2021-06-13,2,Bed Number 2,11,11,0
2021-06-13,3,Bed Number 3,85,67,18
2021-06-14,1,Bed Number 1,38,8,30
2021-06-14,2,Bed Number 2,57,56,1
2021-06-14,3,Bed Number 3,29,6,23
2021-06-15,1,Bed Number 1,97,26,71
2021-06-15,2,Bed Number 2,95,80,15
2021-06-15,3,Bed Number 3,79,77,2
2021-06-16,1,Bed Number 1,52,44,8
2021-06-16,2,Bed Number 2,33,30,3
2021-06-16,3,Bed Number 3,13,5,8
2021-06-17,1,Bed Number 1,22,5,17
2021-06-17,2,Bed Number 2,48,38,10
2021-06-17,3,Bed Number 3,85,18,67
2021-06-18,1,Bed Number 1,27,23,4
2021-06-18,2,Bed Number 2,34,29,5
2021-06-18,3,Bed Number 3,32,26,6
2021-06-19,1,Bed Number 1,39,12,27
2021-06-19,2,Bed Number 2,24,19,5
2021-06-19,3,Bed Number 3,97,80,17
2021-06-20,1,Bed Number 1,82,62,20
2021-06-20,2,Bed Number 2,12,8,4
2021-06-20,3,Bed Number 3,82,18,64
2021-06-21,1,Bed Number 1,74,53,21
2021-06-21,2,Bed Number 2,24,21,3
2021-06-21,3,Bed Number 3,65,23,42
2021-06-22,1,Bed Number 1,64,37,27
2021-06-22,2,Bed Number 2,29,23,6
2021-06-22,3,Bed Number 3,64,41,23
2021-06-23,1,Bed Number 1,53,42,11
2021-06-23,2,Bed Number 2,75,43,32
2021-06-23,3,Bed Number 3,84,50,34
2021-06-24,1,Bed Number 1,88,23,65
2021-06-24,2,Bed Number 2,39,28,11
2021-06-24,3,Bed Number 3,67,29,38
2021-06-25,1,Bed Number 1,41,4,37
2021-06-25,2,Bed Number 2,57,29,28
2021-06-25,3,Bed Number 3,10,0,10
2021-06-26,1,Bed Number 1,77,12,65
2021-06-26,2,Bed Number 2,57,36,21
2021-06-26,3,Bed Number 3,76,29,47
2021-06-27,1,Bed Number 1,99,38,61
2021-06-27,2,Bed Number 2,18,6,12
2021-06-27,3,Bed Number 3,11,6,5
2021-06-28,1,Bed Number 1,30,22,8
2021-06-28,2,Bed Number 2,63,56,7
2021-06-28,3,Bed Number 3,54,24,30
2021-06-29,1,Bed Number 1,27,24,3
2021-06-29,2,Bed Number 2,16,10,6
2021-06-29,3,Bed Number 3,99,96,3
2021-06-30,1,Bed Number 1,43,4,39
2021-06-30,2,Bed Number 2,13,7,6
2021-06-30,3,Bed Number 3,51,2,49
2021-07-01,1,Bed Number 1,33,2,31
2021-07-01,2,Bed Number 2,29,11,18
2021-07-01,3,Bed Number 3,97,46,51
2021-07-02,1,Bed Number 1,85,51,34
2021-07-02,2,Bed Number 2,13,5,8
2021-07-02,3,Bed Number 3,47,35,12
2021-07-03,1,Bed Number 1,58,9,49
2021-07-03,2,Bed Number 2,44,27,17
2021-07-03,3,Bed Number 3,48,38,10
2021-07-04,1,Bed Number 1,91,58,33
2021-07-04,2,Bed Number 2,80,72,8
2021-07-04,3,Bed Number 3,34,15,19
2021-07-05,1,Bed Number 1,52,7,45
2021-07-05,2,Bed Number 2,43,20,23
2021-07-05,3,Bed Number 3,42,40,2
2021-07-06,1,Bed Number 1,47,7,40
2021-07-06,2,Bed Number 2,81,17,64
2021-07-06,3,Bed Number 3,61,53,8
2021-07-07,1,Bed Number 1,83,40,43
2021-07-07,2,Bed Number 2,63,26,37
2021-07-07,3,Bed Number 3,76,51,25
2021-07-08,1,Bed Number 1,95,61,34
2021-07-08,2,Bed Number 2,45,41,4
2021-07-08,3,Bed Number 3,96,37,59
2021-07-09,1,Bed Number 1,59,34,25
2021-07-09,2,Bed Number 2,46,12,34
2021-07-09,3,Bed Number 3,39,19,20
2021-07-10,1,Bed Number 1,46,23,23
2021-07-10,2,Bed Number 2,80,43,37
2021-07-10,3,Bed Number 3,91,35,56
2021-07-11,1,Bed Number 1,43,40,3
2021-07-11,2,Bed Number 2,30,6,24
2021-07-11,3,Bed Number 3,96,79,17
2021-07-12,1,Bed Number 1,97,80,17
2021-07-12,2,Bed Number 2,54,17,37
2021-07-12,3,Bed Number 3,25,18,7
2021-07-13,1,Bed Number 1,71,2,69
2021-07-13,2,Bed Number 2,23,2,21
2021-07-13,3,Bed Number 3,40,36,4
2021-07-14,1,Bed Number 1,77,65,12
2021-07-14,2,Bed Number 2,27,2,25
2021-07-14,3,Bed Number 3,14,4,10
2021-07-15,1,Bed Number 1,96,40,56
2021-07-15,2,Bed Number 2,35,0,35
2021-07-15,3,Bed Number 3,43,32,11
2021-07-16,1,Bed Number 1,42,36,6
2021-07-16,2,Bed Number 2,94,6,88
2021-07-16,3,Bed Number 3,71,25,46
2021-07-17,1,Bed Number 1,46,43,3
2021-07-17,2,Bed Number 2,35,33,2
2021-07-17,3,Bed Number 3,22,22,0
2021-07-18,1,Bed Number 1,27,19,8
2021-07-18,2,Bed Number 2,39,22,17
2021-07-18,3,Bed Number 3,19,17,2
2021-07-19,1,Bed Number 1,24,18,6
2021-07-19,2,Bed Number 2,31,27,4
2021-07-19,3,Bed Number 3,39,31,8
2021-07-20,1,Bed Number 1,87,34,53
2021-07-20,2,Bed Number 2,51,8,43
2021-07-20,3,Bed Number 3,40,6,34
2021-07-21,1,Bed Number 1,81,81,0
2021-07-21,2,Bed Number 2,21,21,0
2021-07-21,3,Bed Number 3,93,4,89
2021-07-22,1,Bed Number 1,38,29,9
2021-07-22,2,Bed Number 2,54,31,23
2021-07-22,3,Bed Number 3,12,7,5
2021-07-23,1,Bed Number 1,49,19,30
2021-07-23,2,Bed Number 2,10,8,2
2021-07-23,3,Bed Number 3,13,8,5
2021-07-24,1,Bed Number 1,76,32,44
2021-07-24,2,Bed Number 2,16,4,12
2021-07-24,3,Bed Number 3,19,6,13
2021-07-25,1,Bed Number 1,60,50,10
2021-07-25,2,Bed Number 2,21,14,7
2021-07-25,3,Bed Number 3,91,88,3
2021-07-26,1,Bed Number 1,86,46,40
2021-07-26,2,Bed Number 2,71,4,67
2021-07-26,3,Bed Number 3,68,31,37
2021-07-27,1,Bed Number 1,12,10,2
2021-07-27,2,Bed Number 2,83,59,24
2021-07-27,3,Bed Number 3,97,15,82
2021-07-28,1,Bed Number 1,56,51,5
2021-07-28,2,Bed Number 2,19,2,17
2021-07-28,3,Bed Number 3,63,36,27
2021-07-29,1,Bed Number 1,50,14,36
2021-07-29,2,Bed Number 2,14,14,0
2021-07-29,3,Bed Number 3,43,16,27
2021-07-30,1,Bed Number 1,38,3,35
2021-07-30,2,Bed Number 2,56,38,18
2021-07-30,3,Bed Number 3,71,62,9
2021-07-31,1,Bed Number 1,17,7,10
2021-07-31,2,Bed Number 2,20,0,20
2021-07-31,3,Bed Number 3,43,35,8
2021-08-01,1,Bed Number 1,37,23,14
2021-08-01,2,Bed Number 2,76,3,73
2021-08-01,3,Bed Number 3,14,7,7
2021-08-02,1,Bed Number 1,48,17,31
2021-08-02,2,Bed Number 2,57,14,43
2021-08-02,3,Bed Number 3,69,13,56
2021-08-03,1,Bed Number 1,39,31,8
2021-08-03,2,Bed Number 2,16,15,1
2021-08-03,3,Bed Number 3,86,15,71
2021-08-04,1,Bed Number 1,40,11,29
2021-08-04,2,Bed Number 2,19,4,15
2021-08-04,3,Bed Number 3,90,19,71
2021-08-05,1,Bed Number 1,10,4,6
2021-08-05,2,Bed Number 2,33,15,18
2021-08-05,3,Bed Number 3,30,29,1
2021-08-06,1,Bed Number 1,94,79,15
2021-08-06,2,Bed Number 2,45,41,4
2021-08-06,3,Bed Number 3,23,12,11
2021-08-07,1,Bed Number 1,24,18,6
2021-08-07,2,Bed Number 2,33,3,30
2021-08-07,3,Bed Number 3,50,21,29
2021-08-08,1,Bed Number 1,19,18,1
2021-08-08,2,Bed Number 2,23,3,20
2021-08-08,3,Bed Number 3,62,14,48
2021-08-09,1,Bed Number 1,51,29,22
2021-08-09,2,Bed Number 2,47,42,5
2021-08-09,3,Bed Number 3,40,34,6
2021-08-10,1,Bed Number 1,16,1,15
2021-08-10,2,Bed Number 2,79,12,67
2021-08-10,3,Bed Number 3,39,33,6
2021-08-11,1,Bed Number 1,19,7,12
2021-08-11,2,Bed Number 2,70,53,17
2021-08-11,3,Bed Number 3,27,12,15
2021-08-12,1,Bed Number 1,37,16,21
2021-08-12,2,Bed Number 2,33,30,3
2021-08-12,3,Bed Number 3,65,50,15
2021-08-13,1,Bed Number 1,29,24,5
2021-08-13,2,Bed Number 2,98,56,42
2021-08-13,3,Bed Number 3,93,16,77
2021-08-14,1,Bed Number 1,83,63,20
2021-08-14,2,Bed Number 2,49,16,33
2021-08-14,3,Bed Number 3,39,22,17
2021-08-15,1,Bed Number 1,84,84,0
2021-08-15,2,Bed Number 2,51,20,31
2021-08-15,3,Bed Number 3,14,3,11
2021-08-16,1,Bed Number 1,100,83,17
2021-08-16,2,Bed Number 2,76,66,10
2021-08-16,3,Bed Number 3,77,57,20
2021-08-17,1,Bed Number 1,49,37,12
2021-08-17,2,Bed Number 2,34,18,16
2021-08-17,3,Bed Number 3,96,37,59
2021-08-18,1,Bed Number 1,38,7,31
2021-08-18,2,Bed Number 2,75,34,41
2021-08-18,3,Bed Number 3,56,29,27
2021-08-19,1,Bed Number 1,86,78,8
2021-08-19,2,Bed Number 2,78,47,31
2021-08-19,3,Bed Number 3,29,27,2
2021-08-20,1,Bed Number 1,16,15,1
2021-08-20,2,Bed Number 2,55,35,20
2021-08-20,3,Bed Number 3,98,6,92
2021-08-21,1,Bed Number 1,100,70,30
2021-08-21,2,Bed Number 2,60,14,46
2021-08-21,3,Bed Number 3,28,11,17
2021-08-22,1,Bed Number 1,26,23,3
2021-08-22,2,Bed Number 2,17,12,5
2021-08-22,3,Bed Number 3,46,21,25
2021-08-23,1,Bed Number 1,37,36,1
2021-08-23,2,Bed Number 2,72,61,11
2021-08-23,3,Bed Number 3,40,16,24
2021-08-24,1,Bed Number 1,58,23,35
2021-08-24,2,Bed Number 2,18,0,18
2021-08-24,3,Bed Number 3,65,39,26
2021-08-25,1,Bed Number 1,49,37,12
2021-08-25,2,Bed Number 2,20,8,12
2021-08-25,3,Bed Number 3,45,3,42
2021-08-26,1,Bed Number 1,95,78,17
2021-08-26,2,Bed Number 2,50,35,15
2021-08-26,3,Bed Number 3,30,11,19
2021-08-27,1,Bed Number 1,11,10,1
2021-08-27,2,Bed Number 2,73,34,39
2021-08-27,3,Bed Number 3,18,15,3
2021-08-28,1,Bed Number 1,28,28,0
2021-08-28,2,Bed Number 2,15,9,6
2021-08-28,3,Bed Number 3,45,21,24
2021-08-29,1,Bed Number 1,64,15,49
2021-08-29,2,Bed Number 2,47,29,18
2021-08-29,3,Bed Number 3,57,4,53
2021-08-30,1,Bed Number 1,13,6,7
2021-08-30,2,Bed Number 2,91,33,58
2021-08-30,3,Bed Number 3,92,45,47
2021-08-31,1,Bed Number 1,71,33,38
2021-08-31,2,Bed Number 2,91,34,57
2021-08-31,3,Bed Number 3,54,13,41
2021-09-01,1,Bed Number 1,43,17,26
2021-09-01,2,Bed Number 2,61,37,24
2021-09-01,3,Bed Number 3,52,3,49
2021-09-02,1,Bed Number 1,75,45,30
2021-09-02,2,Bed Number 2,41,27,14
2021-09-02,3,Bed Number 3,35,1,34
2021-09-03,1,Bed Number 1,86,76,10
2021-09-03,2,Bed Number 2,60,33,27
2021-09-03,3,Bed Number 3,36,17,19
2021-09-04,1,Bed Number 1,34,9,25
2021-09-04,2,Bed Number 2,12,1,11
2021-09-04,3,Bed Number 3,18,15,3
2021-09-05,1,Bed Number 1,49,18,31
2021-09-05,2,Bed Number 2,94,81,13
2021-09-05,3,Bed Number 3,32,1,31
2021-09-06,1,Bed Number 1,52,48,4
2021-09-06,2,Bed Number 2,74,14,60
2021-09-06,3,Bed Number 3,58,17,41
2021-09-07,1,Bed Number 1,68,18,50
2021-09-07,2,Bed Number 2,57,13,44
2021-09-07,3,Bed Number 3,24,10,14
2021-09-08,1,Bed Number 1,46,25,21
2021-09-08,2,Bed Number 2,77,39,38
2021-09-08,3,Bed Number 3,47,27,20
2021-09-09,1,Bed Number 1,82,54,28
2021-09-09,2,Bed Number 2,25,1,24
2021-09-09,3,Bed Number 3,61,37,24
2021-09-10,1,Bed Number 1,81,73,8
2021-09-10,2,Bed Number 2,96,9,87
2021-09-10,3,Bed Number 3,70,51,19
2021-09-11,1,Bed Number 1,61,30,31
2021-09-11,2,Bed Number 2,41,37,4
2021-09-11,3,Bed Number 3,59,14,45
2021-09-12,1,Bed Number 1,59,17,42
2021-09-12,2,Bed Number 2,96,53,43
2021-09-12,3,Bed Number 3,31,24,7
2021-09-13,1,Bed Number 1,51,51,0
2021-09-13,2,Bed Number 2,25,25,0
2021-09-13,3,Bed Number 3,43,29,14
2021-09-14,1,Bed Number 1,65,18,47
2021-09-14,2,Bed Number 2,90,39,51
2021-09-14,3,Bed Number 3,83,15,68
2021-09-15,1,Bed Number 1,33,5,28
2021-09-15,2,Bed Number 2,45,44,1
2021-09-15,3,Bed Number 3,22,21,1
2021-09-16,1,Bed Number 1,18,6,12
2021-09-16,2,Bed Number 2,42,16,26
2021-09-16,3,Bed Number 3,38,33,5
2021-09-17,1,Bed Number 1,10,9,1
2021-09-17,2,Bed Number 2,62,33,29
2021-09-17,3,Bed Number 3,96,91,5
2021-09-18,1,Bed Number 1,41,26,15
2021-09-18,2,Bed Number 2,25,0,25
2021-09-18,3,Bed Number 3,17,1,16
2021-09-19,1,Bed Number 1,39,28,11
2021-09-19,2,Bed Number 2,48,34,14
2021-09-19,3,Bed Number 3,83,50,33
2021-09-20,1,Bed Number 1,48,18,30
2021-09-20,2,Bed Number 2,31,0,31
2021-09-20,3,Bed Number 3,91,4,87
2021-09-21,1,Bed Number 1,40,7,33
2021-09-21,2,Bed Number 2,73,69,4
2021-09-21,3,Bed Number 3,72,48,24
2021-09-22,1,Bed Number 1,96,23,73
2021-09-22,2,Bed Number 2,44,38,6
2021-09-22,3,Bed Number 3,97,74,23
2021-09-23,1,Bed Number 1,88,25,63
2021-09-23,2,Bed Number 2,21,15,6
2021-09-23,3,Bed Number 3,90,29,61
2021-09-24,1,Bed Number 1,35,1,34
2021-09-24,2,Bed Number 2,32,5,27
2021-09-24,3,Bed Number 3,69,31,38
2021-09-25,1,Bed Number 1,27,9,18
2021-09-25,2,Bed Number 2,66,52,14
2021-09-25,3,Bed Number 3,32,13,19
2021-09-26,1,Bed Number 1,79,62,17
2021-09-26,2,Bed Number 2,41,8,33
2021-09-26,3,Bed Number 3,25,20,5
2021-09-27,1,Bed Number 1,46,31,15
2021-09-27,2,Bed Number 2,84,12,72
2021-09-27,3,Bed Number 3,94,76,18
2021-09-28,1,Bed Number 1,58,36,22
2021-09-28,2,Bed Number 2,74,23,51
2021-09-28,3,Bed Number 3,93,1,92
2021-09-29,1,Bed Number 1,40,19,21
2021-09-29,2,Bed Number 2,91,71,20
2021-09-29,3,Bed Number 3,12,4,8
2021-09-30,1,Bed Number 1,82,66,16
2021-09-30,2,Bed Number 2,67,17,50
2021-09-30,3,Bed Number 3,32,32,0
2021-10-01,1,Bed Number 1,66,7,59
2021-10-01,2,Bed Number 2,17,0,17
2021-10-01,3,Bed Number 3,79,66,13
2021-10-02,1,Bed Number 1,53,15,38
2021-10-02,2,Bed Number 2,50,28,22
2021-10-02,3,Bed Number 3,22,18,4
2021-10-03,1,Bed Number 1,45,31,14
2021-10-03,2,Bed Number 2,27,9,18
2021-10-03,3,Bed Number 3,46,41,5
2021-10-04,1,Bed Number 1,54,5,49
2021-10-04,2,Bed Number 2,75,31,44
2021-10-04,3,Bed Number 3,49,4,45
2021-10-05,1,Bed Number 1,16,8,8
2021-10-05,2,Bed Number 2,87,35,52
2021-10-05,3,Bed Number 3,29,19,10
2021-10-06,1,Bed Number 1,66,11,55
2021-10-06,2,Bed Number 2,76,52,24
2021-10-06,3,Bed Number 3,55,3,52
2021-10-07,1,Bed Number 1,83,6,77
2021-10-07,2,Bed Number 2,24,18,6
2021-10-07,3,Bed Number 3,42,8,34
2021-10-08,1,Bed Number 1,65,47,18
2021-10-08,2,Bed Number 2,51,24,27
2021-10-08,3,Bed Number 3,12,7,5
2021-10-09,1,Bed Number 1,24,7,17
2021-10-09,2,Bed Number 2,50,34,16
2021-10-09,3,Bed Number 3,11,5,6
2021-10-10,1,Bed Number 1,15,0,15
2021-10-10,2,Bed Number 2,28,17,11
2021-10-10,3,Bed Number 3,54,54,0
2021-10-11,1,Bed Number 1,30,17,13
2021-10-11,2,Bed Number 2,39,17,22
2021-10-11,3,Bed Number 3,87,10,77
2021-10-12,1,Bed Number 1,83,67,16
2021-10-12,2,Bed Number 2,37,19,18
2021-10-12,3,Bed Number 3,83,53,30
2021-10-13,1,Bed Number 1,13,3,10
2021-10-13,2,Bed Number 2,53,8,45
2021-10-13,3,Bed Number 3,59,53,6
2021-10-14,1,Bed Number 1,15,1,14
2021-10-14,2,Bed Number 2,53,7,46
2021-10-14,3,Bed Number 3,26,4,22
2021-10-15,1,Bed Number 1,12,8,4
2021-10-15,2,Bed Number 2,86,11,75
2021-10-15,3,Bed Number 3,32,18,14
2021-10-16,1,Bed Number 1,32,10,22
2021-10-16,2,Bed Number 2,11,5,6
2021-10-16,3,Bed Number 3,30,25,5
2021-10-17,1,Bed Number 1,41,9,32
2021-10-17,2,Bed Number 2,96,85,11
2021-10-17,3,Bed Number 3,58,44,14
2021-10-18,1,Bed Number 1,53,44,9
2021-10-18,2,Bed Number 2,23,12,11
2021-10-18,3,Bed Number 3,78,1,77
2021-10-19,1,Bed Number 1,47,41,6
2021-10-19,2,Bed Number 2,91,76,15
2021-10-19,3,Bed Number 3,38,36,2
2021-10-20,1,Bed Number 1,46,3,43
2021-10-20,2,Bed Number 2,84,72,12
2021-10-20,3,Bed Number 3,48,23,25
2021-10-21,1,Bed Number 1,24,22,2
2021-10-21,2,Bed Number 2,92,54,38
2021-10-21,3,Bed Number 3,32,13,19
2021-10-22,1,Bed Number 1,25,13,12
2021-10-22,2,Bed Number 2,35,2,33
2021-10-22,3,Bed Number 3,39,5,34
2021-10-23,1,Bed Number 1,86,32,54
2021-10-23,2,Bed Number 2,34,26,8
2021-10-23,3,Bed Number 3,12,4,8
2021-10-24,1,Bed Number 1,24,9,15
2021-10-24,2,Bed Number 2,81,35,46
2021-10-24,3,Bed Number 3,28,18,10
2021-10-25,1,Bed Number 1,69,52,17
2021-10-25,2,Bed Number 2,49,18,31
2021-10-25,3,Bed Number 3,69,8,61
2021-10-26,1,Bed Number 1,51,27,24
2021-10-26,2,Bed Number 2,72,13,59
2021-10-26,3,Bed Number 3,39,4,35
2021-10-27,1,Bed Number 1,61,16,45
2021-10-27,2,Bed Number 2,26,17,9
2021-10-27,3,Bed Number 3,12,5,7
2021-10-28,1,Bed Number 1,79,52,27
2021-10-28,2,Bed Number 2,87,12,75
2021-10-28,3,Bed Number 3,43,6,37
2021-10-29,1,Bed Number 1,71,0,71
2021-10-29,2,Bed Number 2,72,25,47
2021-10-29,3,Bed Number 3,25,7,18
2021-10-30,1,Bed Number 1,35,13,22
2021-10-30,2,Bed Number 2,40,12,28
2021-10-30,3,Bed Number 3,13,8,5
2021-10-31,1,Bed Number 1,12,8,4
2021-10-31,2,Bed Number 2,18,12,6
2021-10-31,3,Bed Number 3,70,0,70
2021-11-01,1,Bed Number 1,20,14,6
2021-11-01,2,Bed Number 2,100,43,57
2021-11-01,3,Bed Number 3,29,29,0
2021-11-02,1,Bed Number 1,69,8,61
2021-11-02,2,Bed Number 2,70,58,12
2021-11-02,3,Bed Number 3,52,28,24
2021-11-03,1,Bed Number 1,53,17,36
2021-11-03,2,Bed Number 2,91,3,88
2021-11-03,3,Bed Number 3,48,22,26
2021-11-04,1,Bed Number 1,28,8,20
2021-11-04,2,Bed Number 2,46,26,20
2021-11-04,3,Bed Number 3,20,5,15
2021-11-05,1,Bed Number 1,61,29,32
2021-11-05,2,Bed Number 2,42,32,10
2021-11-05,3,Bed Number 3,54,26,28
2021-11-06,1,Bed Number 1,91,69,22
2021-11-06,2,Bed Number 2,52,25,27
2021-11-06,3,Bed Number 3,89,69,20
2021-11-07,1,Bed Number 1,30,20,10
2021-11-07,2,Bed Number 2,13,7,6
2021-11-07,3,Bed Number 3,33,24,9
2021-11-08,1,Bed Number 1,54,22,32
2021-11-08,2,Bed Number 2,31,27,4
2021-11-08,3,Bed Number 3,28,23,5
2021-11-09,1,Bed Number 1,27,1,26
2021-11-09,2,Bed Number 2,55,12,43
2021-11-09,3,Bed Number 3,74,63,11
2021-11-10,1,Bed Number 1,57,51,6
2021-11-10,2,Bed Number 2,83,10,73
2021-11-10,3,Bed Number 3,10,3,7
2021-11-11,1,Bed Number 1,99,76,23
2021-11-11,2,Bed Number 2,45,42,3
2021-11-11,3,Bed Number 3,49,46,3
2021-11-12,1,Bed Number 1,50,19,31
2021-11-12,2,Bed Number 2,22,5,17
2021-11-12,3,Bed Number 3,76,33,43
2021-11-13,1,Bed Number 1,52,49,3
2021-11-13,2,Bed Number 2,69,10,59
2021-11-13,3,Bed Number 3,22,16,6
2021-11-14,1,Bed Number 1,28,23,5
2021-11-14,2,Bed Number 2,95,34,61
2021-11-14,3,Bed Number 3,68,56,12
2021-11-15,1,Bed Number 1,96,51,45
2021-11-15,2,Bed Number 2,91,41,50
2021-11-15,3,Bed Number 3,83,35,48
2021-11-16,1,Bed Number 1,22,16,6
2021-11-16,2,Bed Number 2,23,21,2
2021-11-16,3,Bed Number 3,72,18,54
2021-11-17,1,Bed Number 1,55,22,33
2021-11-17,2,Bed Number 2,62,34,28
2021-11-17,3,Bed Number 3,88,67,21
2021-11-18,1,Bed Number 1,25,6,19
2021-11-18,2,Bed Number 2,73,59,14
2021-11-18,3,Bed Number 3,81,28,53
2021-11-19,1,Bed Number 1,62,19,43
2021-11-19,2,Bed Number 2,80,26,54
2021-11-19,3,Bed Number 3,62,57,5
2021-11-20,1,Bed Number 1,86,84,2
2021-11-20,2,Bed Number 2,48,29,19
2021-11-20,3,Bed Number 3,69,7,62
2021-11-21,1,Bed Number 1,86,33,53
2021-11-21,2,Bed Number 2,77,55,22
2021-11-21,3,Bed Number 3,70,6,64
2021-11-22,1,Bed Number 1,100,71,29
2021-11-22,2,Bed Number 2,11,9,2
2021-11-22,3,Bed Number 3,66,48,18
2021-11-23,1,Bed Number 1,61,18,43
2021-11-23,2,Bed Number 2,47,19,28
2021-11-23,3,Bed Number 3,19,17,2
2021-11-24,1,Bed Number 1,49,10,39
2021-11-24,2,Bed Number 2,18,7,11
2021-11-24,3,Bed Number 3,29,2,27
2021-11-25,1,Bed Number 1,86,55,31
2021-11-25,2,Bed Number 2,54,42,12
2021-11-25,3,Bed Number 3,48,28,20
2021-11-26,1,Bed Number 1,49,47,2
2021-11-26,2,Bed Number 2,93,23,70
2021-11-26,3,Bed Number 3,33,12,21
2021-11-27,1,Bed Number 1,66,12,54
2021-11-27,2,Bed Number 2,16,7,9
2021-11-27,3,Bed Number 3,96,15,81
2021-11-28,1,Bed Number 1,47,10,37
2021-11-28,2,Bed Number 2,45,31,14
2021-11-28,3,Bed Number 3,52,38,14
2021-11-29,1,Bed Number 1,74,4,70
2021-11-29,2,Bed Number 2,50,32,18
2021-11-29,3,Bed Number 3,66,32,34
2021-11-30,1,Bed Number 1,56,0,56
2021-11-30,2,Bed Number 2,14,9,5
2021-11-30,3,Bed Number 3,79,29,50
2021-12-01,1,Bed Number 1,39,7,32
2021-12-01,2,Bed Number 2,34,12,22
2021-12-01,3,Bed Number 3,79,20,59
2021-12-02,1,Bed Number 1,40,24,16
2021-12-02,2,Bed Number 2,85,19,66
2021-12-02,3,Bed Number 3,58,56,2
2021-12-03,1,Bed Number 1,38,32,6
2021-12-03,2,Bed Number 2,62,38,24
2021-12-03,3,Bed Number 3,39,20,19
2021-12-04,1,Bed Number 1,79,77,2
2021-12-04,2,Bed Number 2,41,1,40
2021-12-04,3,Bed Number 3,31,22,9
2021-12-05,1,Bed Number 1,20,5,15
2021-12-05,2,Bed Number 2,30,11,19
2021-12-05,3,Bed Number 3,19,0,19
2021-12-06,1,Bed Number 1,68,41,27
2021-12-06,2,Bed Number 2,48,33,15
2021-12-06,3,Bed Number 3,57,18,39
2021-12-07,1,Bed Number 1,68,28,40
2021-12-07,2,Bed Number 2,51,39,12
2021-12-07,3,Bed Number 3,100,71,29
2021-12-08,1,Bed Number 1,11,8,3
2021-12-08,2,Bed Number 2,26,16,10
2021-12-08,3,Bed Number 3,60,0,60
2021-12-09,1,Bed Number 1,60,13,47
2021-12-09,2,Bed Number 2,28,10,18
2021-12-09,3,Bed Number 3,73,49,24
2021-12-10,1,Bed Number 1,88,76,12
2021-12-10,2,Bed Number 2,34,11,23
2021-12-10,3,Bed Number 3,84,69,15
2021-12-11,1,Bed Number 1,83,19,64
2021-12-11,2,Bed Number 2,88,28,60
2021-12-11,3,Bed Number 3,76,26,50
2021-12-12,1,Bed Number 1,67,1,66
2021-12-12,2,Bed Number 2,35,4,31
2021-12-12,3,Bed Number 3,33,9,24
2021-12-13,1,Bed Number 1,45,9,36
2021-12-13,2,Bed Number 2,79,25,54
2021-12-13,3,Bed Number 3,74,59,15
2021-12-14,1,Bed Number 1,18,6,12
2021-12-14,2,Bed Number 2,14,13,1
2021-12-14,3,Bed Number 3,97,81,16
2021-12-15,1,Bed Number 1,49,9,40
2021-12-15,2,Bed Number 2,83,42,41
2021-12-15,3,Bed Number 3,59,23,36
2021-12-16,1,Bed Number 1,41,41,0
2021-12-16,2,Bed Number 2,33,16,17
2021-12-16,3,Bed Number 3,15,10,5
2021-12-17,1,Bed Number 1,22,6,16
2021-12-17,2,Bed Number 2,69,57,12
2021-12-17,3,Bed Number 3,69,29,40
2021-12-18,1,Bed Number 1,50,19,31
2021-12-18,2,Bed Number 2,51,12,39
2021-12-18,3,Bed Number 3,58,47,11
2021-12-19,1,Bed Number 1,16,5,11
2021-12-19,2,Bed Number 2,24,4,20
2021-12-19,3,Bed Number 3,21,3,18
2021-12-20,1,Bed Number 1,64,0,64
2021-12-20,2,Bed Number 2,53,21,32
2021-12-20,3,Bed Number 3,12,6,6
2021-12-21,1,Bed Number 1,55,3,52
2021-12-21,2,Bed Number 2,37,16,21
2021-12-21,3,Bed Number 3,33,20,13
2021-12-22,1,Bed Number 1,62,15,47
2021-12-22,2,Bed Number 2,45,19,26
2021-12-22,3,Bed Number 3,32,29,3
2021-12-23,1,Bed Number 1,93,18,75
2021-12-23,2,Bed Number 2,16,2,14
2021-12-23,3,Bed Number 3,24,8,16
2021-12-24,1,Bed Number 1,47,0,47
2021-12-24,2,Bed Number 2,28,27,1
2021-12-24,3,Bed Number 3,74,6,68
2021-12-25,1,Bed Number 1,48,46,2
2021-12-25,2,Bed Number 2,84,81,3
2021-12-25,3,Bed Number 3,27,6,21
2021-12-26,1,Bed Number 1,14,4,10
2021-12-26,2,Bed Number 2,41,16,25
2021-12-26,3,Bed Number 3,23,19,4
2021-12-27,1,Bed Number 1,66,38,28
2021-12-27,2,Bed Number 2,39,23,16
2021-12-27,3,Bed Number 3,26,17,9
2021-12-28,1,Bed Number 1,91,13,78
2021-12-28,2,Bed Number 2,83,54,29
2021-12-28,3,Bed Number 3,41,14,27
2021-12-29,1,Bed Number 1,77,63,14
2021-12-29,2,Bed Number 2,68,2,66
2021-12-29,3,Bed Number 3,57,41,16
2021-12-30,1,Bed Number 1,73,21,52
2021-12-30,2,Bed Number 2,50,34,16
2021-12-30,3,Bed Number 3,66,22,44
2021-12-31,1,Bed Number 1,38,3,35
2021-12-31,2,Bed Number 2,62,9,53
2021-12-31,3,Bed Number 3,10,6,4
2022-01-01,1,Bed Number 1,57,14,43
2022-01-01,2,Bed Number 2,59,36,23
2022-01-01,3,Bed Number 3,12,5,7
2022-01-02,1,Bed Number 1,39,12,27
2022-01-02,2,Bed Number 2,64,33,31
2022-01-02,3,Bed Number 3,93,36,57
2022-01-03,1,Bed Number 1,29,11,18
2022-01-03,2,Bed Number 2,17,10,7
2022-01-03,3,Bed Number 3,70,19,51
2022-01-04,1,Bed Number 1,63,13,50
2022-01-04,2,Bed Number 2,54,20,34
2022-01-04,3,Bed Number 3,98,1,97
2022-01-05,1,Bed Number 1,84,60,24
2022-01-05,2,Bed Number 2,77,56,21
2022-01-05,3,Bed Number 3,69,49,20
2022-01-06,1,Bed Number 1,63,50,13
2022-01-06,2,Bed Number 2,72,13,59
2022-01-06,3,Bed Number 3,36,20,16
2022-01-07,1,Bed Number 1,74,25,49
2022-01-07,2,Bed Number 2,36,13,23
2022-01-07,3,Bed Number 3,18,10,8
2022-01-08,1,Bed Number 1,56,54,2
2022-01-08,2,Bed Number 2,93,57,36
2022-01-08,3,Bed Number 3,56,2,54
2022-01-09,1,Bed Number 1,34,27,7
2022-01-09,2,Bed Number 2,93,4,89
2022-01-09,3,Bed Number 3,19,2,17
2022-01-10,1,Bed Number 1,19,9,10
2022-01-10,2,Bed Number 2,59,10,49
2022-01-10,3,Bed Number 3,61,49,12
2022-01-11,1,Bed Number 1,84,30,54
2022-01-11,2,Bed Number 2,83,71,12
2022-01-11,3,Bed Number 3,84,56,28
2022-01-12,1,Bed Number 1,93,80,13
2022-01-12,2,Bed Number 2,94,33,61
2022-01-12,3,Bed Number 3,48,38,10
2022-01-13,1,Bed Number 1,39,10,29
2022-01-13,2,Bed Number 2,60,24,36
2022-01-13,3,Bed Number 3,94,77,17
2022-01-14,1,Bed Number 1,30,20,10
2022-01-14,2,Bed Number 2,10,7,3
2022-01-14,3,Bed Number 3,11,8,3
2022-01-15,1,Bed Number 1,10,5,5
2022-01-15,2,Bed Number 2,14,9,5
2022-01-15,3,Bed Number 3,32,16,16
2022-01-16,1,Bed Number 1,77,71,6
2022-01-16,2,Bed Number 2,43,42,1
2022-01-16,3,Bed Number 3,94,27,67
2022-01-17,1,Bed Number 1,34,13,21
2022-01-17,2,Bed Number 2,78,78,0
2022-01-17,3,Bed Number 3,73,40,33
2022-01-18,1,Bed Number 1,85,25,60
2022-01-18,2,Bed Number 2,70,41,29
2022-01-18,3,Bed Number 3,53,31,22
2022-01-19,1,Bed Number 1,94,53,41
2022-01-19,2,Bed Number 2,90,2,88
2022-01-19,3,Bed Number 3,35,19,16
2022-01-20,1,Bed Number 1,72,68,4
2022-01-20,2,Bed Number 2,46,11,35
2022-01-20,3,Bed Number 3,26,3,23
2022-01-21,1,Bed Number 1,89,88,1
2022-01-21,2,Bed Number 2,72,72,0
2022-01-21,3,Bed Number 3,54,5,49
2022-01-22,1,Bed Number 1,15,11,4
2022-01-22,2,Bed Number 2,90,34,56
2022-01-22,3,Bed Number 3,97,40,57
2022-01-23,1,Bed Number 1,11,6,5
2022-01-23,2,Bed Number 2,31,2,29
2022-01-23,3,Bed Number 3,37,24,13
2022-01-24,1,Bed Number 1,52,19,33
2022-01-24,2,Bed Number 2,58,57,1
2022-01-24,3,Bed Number 3,85,7,78
2022-01-25,1,Bed Number 1,25,17,8
2022-01-25,2,Bed Number 2,54,49,5
2022-01-25,3,Bed Number 3,75,41,34
2022-01-26,1,Bed Number 1,31,2,29
2022-01-26,2,Bed Number 2,92,19,73
2022-01-26,3,Bed Number 3,47,45,2
2022-01-27,1,Bed Number 1,17,4,13
2022-01-27,2,Bed Number 2,86,55,31
2022-01-27,3,Bed Number 3,66,63,3
2022-01-28,1,Bed Number 1,56,33,23
2022-01-28,2,Bed Number 2,88,46,42
2022-01-28,3,Bed Number 3,39,0,39
2022-01-29,1,Bed Number 1,95,32,63
2022-01-29,2,Bed Number 2,88,55,33
2022-01-29,3,Bed Number 3,21,7,14
2022-01-30,1,Bed Number 1,74,23,51
2022-01-30,2,Bed Number 2,42,9,33
2022-01-30,3,Bed Number 3,83,53,30
2022-01-31,1,Bed Number 1,57,21,36
2022-01-31,2,Bed Number 2,82,24,58
2022-01-31,3,Bed Number 3,39,0,39
2022-02-01,1,Bed Number 1,66,5,61
2022-02-01,2,Bed Number 2,20,4,16
2022-02-01,3,Bed Number 3,14,13,1
2022-02-02,1,Bed Number 1,38,6,32
2022-02-02,2,Bed Number 2,16,3,13
2022-02-02,3,Bed Number 3,51,35,16
2022-02-03,1,Bed Number 1,23,9,14
2022-02-03,2,Bed Number 2,69,41,28
2022-02-03,3,Bed Number 3,89,84,5
2022-02-04,1,Bed Number 1,28,4,24
2022-02-04,2,Bed Number 2,66,12,54
2022-02-04,3,Bed Number 3,24,22,2
2022-02-05,1,Bed Number 1,92,41,51
2022-02-05,2,Bed Number 2,11,3,8
2022-02-05,3,Bed Number 3,84,17,67
2022-02-06,1,Bed Number 1,88,13,75
2022-02-06,2,Bed Number 2,55,16,39
2022-02-06,3,Bed Number 3,15,14,1
2022-02-07,1,Bed Number 1,38,4,34
2022-02-07,2,Bed Number 2,10,1,9
2022-02-07,3,Bed Number 3,76,22,54
2022-02-08,1,Bed Number 1,71,31,40
2022-02-08,2,Bed Number 2,77,48,29
2022-02-08,3,Bed Number 3,13,5,8
2022-02-09,1,Bed Number 1,13,7,6
2022-02-09,2,Bed Number 2,86,69,17
2022-02-09,3,Bed Number 3,99,8,91
2022-02-10,1,Bed Number 1,75,29,46
2022-02-10,2,Bed Number 2,80,58,22
2022-02-10,3,Bed Number 3,62,18,44
2022-02-11,1,Bed Number 1,69,26,43
2022-02-11,2,Bed Number 2,66,30,36
2022-02-11,3,Bed Number 3,78,21,57
2022-02-12,1,Bed Number 1,57,21,36
2022-02-12,2,Bed Number 2,15,2,13
2022-02-12,3,Bed Number 3,31,19,12
2022-02-13,1,Bed Number 1,18,11,7
2022-02-13,2,Bed Number 2,56,15,41
2022-02-13,3,Bed Number 3,10,1,9
2022-02-14,1,Bed Number 1,18,13,5
2022-02-14,2,Bed Number 2,88,18,70
2022-02-14,3,Bed Number 3,72,54,18
2022-02-15,1,Bed Number 1,55,41,14
2022-02-15,2,Bed Number 2,65,31,34
2022-02-15,3,Bed Number 3,47,33,14
2022-02-16,1,Bed Number 1,90,74,16
2022-02-16,2,Bed Number 2,83,66,17
2022-02-16,3,Bed Number 3,39,8,31
2022-02-17,1,Bed Number 1,56,4,52
2022-02-17,2,Bed Number 2,86,58,28
2022-02-17,3,Bed Number 3,69,36,33
2022-02-18,1,Bed Number 1,81,47,34
2022-02-18,2,Bed Number 2,21,2,19
2022-02-18,3,Bed Number 3,74,21,53
2022-02-19,1,Bed Number 1,26,2,24
2022-02-19,2,Bed Number 2,36,34,2
2022-02-19,3,Bed Number 3,47,4,43
2022-02-20,1,Bed Number 1,66,52,14
2022-02-20,2,Bed Number 2,79,4,75
2022-02-20,3,Bed Number 3,62,25,37
2022-02-21,1,Bed Number 1,27,21,6
2022-02-21,2,Bed Number 2,19,15,4
2022-02-21,3,Bed Number 3,22,22,0
2022-02-22,1,Bed Number 1,24,6,18
2022-02-22,2,Bed Number 2,67,43,24
2022-02-22,3,Bed Number 3,19,16,3
2022-02-23,1,Bed Number 1,100,68,32
2022-02-23,2,Bed Number 2,10,1,9
2022-02-23,3,Bed Number 3,93,40,53
2022-02-24,1,Bed Number 1,16,11,5
2022-02-24,2,Bed Number 2,84,53,31
2022-02-24,3,Bed Number 3,41,3,38
2022-02-25,1,Bed Number 1,14,2,12
2022-02-25,2,Bed Number 2,21,2,19
2022-02-25,3,Bed Number 3,53,41,12
2022-02-26,1,Bed Number 1,62,19,43
2022-02-26,2,Bed Number 2,34,16,18
2022-02-26,3,Bed Number 3,35,27,8
2022-02-27,1,Bed Number 1,53,1,52
2022-02-27,2,Bed Number 2,65,35,30
2022-02-27,3,Bed Number 3,44,29,15
2022-02-28,1,Bed Number 1,77,48,29
2022-02-28,2,Bed Number 2,17,15,2
2022-02-28,3,Bed Number 3,10,10,0
2022-03-01,1,Bed Number 1,70,29,41
2022-03-01,2,Bed Number 2,25,21,4
2022-03-01,3,Bed Number 3,50,16,34
2022-03-02,1,Bed Number 1,63,47,16
2022-03-02,2,Bed Number 2,92,31,61
2022-03-02,3,Bed Number 3,92,88,4
2022-03-03,1,Bed Number 1,82,69,13
2022-03-03,2,Bed Number 2,96,24,72
2022-03-03,3,Bed Number 3,48,24,24
2022-03-04,1,Bed Number 1,25,17,8
2022-03-04,2,Bed Number 2,62,46,16
2022-03-04,3,Bed Number 3,94,43,51
2022-03-05,1,Bed Number 1,12,5,7
2022-03-05,2,Bed Number 2,95,55,40
2022-03-05,3,Bed Number 3,15,2,13
2022-03-06,1,Bed Number 1,100,97,3
2022-03-06,2,Bed Number 2,59,44,15
2022-03-06,3,Bed Number 3,38,36,2
2022-03-07,1,Bed Number 1,79,53,26
2022-03-07,2,Bed Number 2,88,18,70
2022-03-07,3,Bed Number 3,48,28,20
2022-03-08,1,Bed Number 1,35,29,6
2022-03-08,2,Bed Number 2,53,1,52
2022-03-08,3,Bed Number 3,86,69,17
2022-03-09,1,Bed Number 1,70,31,39
2022-03-09,2,Bed Number 2,89,18,71
2022-03-09,3,Bed Number 3,79,10,69
2022-03-10,1,Bed Number 1,99,91,8
2022-03-10,2,Bed Number 2,37,26,11
2022-03-10,3,Bed Number 3,36,30,6
2022-03-11,1,Bed Number 1,82,61,21
2022-03-11,2,Bed Number 2,32,30,2
2022-03-11,3,Bed Number 3,89,51,38
2022-03-12,1,Bed Number 1,87,85,2
2022-03-12,2,Bed Number 2,77,4,73
2022-03-12,3,Bed Number 3,74,23,51
2022-03-13,1,Bed Number 1,79,19,60
2022-03-13,2,Bed Number 2,20,5,15
2022-03-13,3,Bed Number 3,72,8,64
2022-03-14,1,Bed Number 1,25,17,8
2022-03-14,2,Bed Number 2,39,3,36
2022-03-14,3,Bed Number 3,64,52,12
2022-03-15,1,Bed Number 1,25,19,6
2022-03-15,2,Bed Number 2,92,18,74
2022-03-15,3,Bed Number 3,44,21,23
2022-03-16,1,Bed Number 1,65,27,38
2022-03-16,2,Bed Number 2,58,7,51
2022-03-16,3,Bed Number 3,45,27,18
2022-03-17,1,Bed Number 1,40,13,27
2022-03-17,2,Bed Number 2,41,10,31
2022-03-17,3,Bed Number 3,49,48,1
2022-03-18,1,Bed Number 1,40,19,21
2022-03-18,2,Bed Number 2,88,50,38
2022-03-18,3,Bed Number 3,21,14,7
2022-03-19,1,Bed Number 1,46,42,4
2022-03-19,2,Bed Number 2,14,3,11
2022-03-19,3,Bed Number 3,77,63,14
2022-03-20,1,Bed Number 1,31,7,24
2022-03-20,2,Bed Number 2,19,10,9
2022-03-20,3,Bed Number 3,73,14,59
2022-03-21,1,Bed Number 1,36,11,25
2022-03-21,2,Bed Number 2,87,30,57
2022-03-21,3,Bed Number 3,68,10,58
2022-03-22,1,Bed Number 1,100,35,65
2022-03-22,2,Bed Number 2,68,61,7
2022-03-22,3,Bed Number 3,53,14,39
2022-03-23,1,Bed Number 1,68,59,9
2022-03-23,2,Bed Number 2,99,56,43
2022-03-23,3,Bed Number 3,53,24,29
2022-03-24,1,Bed Number 1,70,46,24
2022-03-24,2,Bed Number 2,100,80,20
2022-03-24,3,Bed Number 3,19,1,18
2022-03-25,1,Bed Number 1,91,78,13
2022-03-25,2,Bed Number 2,31,11,20
2022-03-25,3,Bed Number 3,16,9,7
2022-03-26,1,Bed Number 1,48,45,3
2022-03-26,2,Bed Number 2,57,57,0
2022-03-26,3,Bed Number 3,18,17,1
2022-03-27,1,Bed Number 1,67,26,41
2022-03-27,2,Bed Number 2,94,28,66
2022-03-27,3,Bed Number 3,35,4,31
2022-03-28,1,Bed Number 1,66,35,31
2022-03-28,2,Bed Number 2,30,8,22
2022-03-28,3,Bed Number 3,19,10,9
2022-03-29,1,Bed Number 1,27,26,1
2022-03-29,2,Bed Number 2,25,9,16
2022-03-29,3,Bed Number 3,39,22,17
2022-03-30,1,Bed Number 1,43,17,26
2022-03-30,2,Bed Number 2,71,62,9
2022-03-30,3,Bed Number 3,83,52,31
2022-03-31,1,Bed Number 1,87,44,43
2022-03-31,2,Bed Number 2,46,10,36
2022-03-31,3,Bed Number 3,83,70,13
2022-04-01,1,Bed Number 1,50,30,20
2022-04-01,2,Bed Number 2,49,8,41
2022-04-01,3,Bed Number 3,18,3,15
2022-04-02,1,Bed Number 1,22,1,21
2022-04-02,2,Bed Number 2,82,73,9
2022-04-02,3,Bed Number 3,58,41,17
2022-04-03,1,Bed Number 1,54,20,34
2022-04-03,2,Bed Number 2,74,25,49
2022-04-03,3,Bed Number 3,99,62,37
2022-04-04,1,Bed Number 1,41,17,24
2022-04-04,2,Bed Number 2,16,10,6
2022-04-04,3,Bed Number 3,32,6,26
2022-04-05,1,Bed Number 1,55,48,7
2022-04-05,2,Bed Number 2,19,12,7
2022-04-05,3,Bed Number 3,63,60,3
2022-04-06,1,Bed Number 1,48,17,31
2022-04-06,2,Bed Number 2,86,40,46
2022-04-06,3,Bed Number 3,35,20,15
2022-04-07,1,Bed Number 1,53,38,15
2022-04-07,2,Bed Number 2,39,24,15
2022-04-07,3,Bed Number 3,93,73,20
2022-04-08,1,Bed Number 1,25,16,9
2022-04-08,2,Bed Number 2,76,64,12
2022-04-08,3,Bed Number 3,22,8,14
2022-04-09,1,Bed Number 1,36,8,28
2022-04-09,2,Bed Number 2,19,17,2
2022-04-09,3,Bed Number 3,36,26,10
2022-04-10,1,Bed Number 1,59,26,33
2022-04-10,2,Bed Number 2,43,27,16
2022-04-10,3,Bed Number 3,72,56,16
2022-04-11,1,Bed Number 1,93,7,86
2022-04-11,2,Bed Number 2,63,7,56
2022-04-11,3,Bed Number 3,80,58,22
2022-04-12,1,Bed Number 1,22,2,20
2022-04-12,2,Bed Number 2,12,2,10
2022-04-12,3,Bed Number 3,44,29,15
2022-04-13,1,Bed Number 1,75,42,33
2022-04-13,2,Bed Number 2,27,19,8
2022-04-13,3,Bed Number 3,77,47,30
2022-04-14,1,Bed Number 1,82,26,56
2022-04-14,2,Bed Number 2,91,57,34
2022-04-14,3,Bed Number 3,61,31,30
2022-04-15,1,Bed Number 1,64,47,17
2022-04-15,2,Bed Number 2,34,8,26
2022-04-15,3,Bed Number 3,83,47,36
2022-04-16,1,Bed Number 1,86,23,63
2022-04-16,2,Bed Number 2,97,56,41
2022-04-16,3,Bed Number 3,37,26,11
2022-04-17,1,Bed Number 1,84,17,67
2022-04-17,2,Bed Number 2,86,51,35
2022-04-17,3,Bed Number 3,33,30,3
2022-04-18,1,Bed Number 1,69,61,8
2022-04-18,2,Bed Number 2,28,4,24
2022-04-18,3,Bed Number 3,64,48,16
2022-04-19,1,Bed Number 1,69,55,14
2022-04-19,2,Bed Number 2,81,20,61
2022-04-19,3,Bed Number 3,19,17,2
2022-04-20,1,Bed Number 1,34,10,24
2022-04-20,2,Bed Number 2,57,34,23
2022-04-20,3,Bed Number 3,73,2,71
2022-04-21,1,Bed Number 1,84,1,83
2022-04-21,2,Bed Number 2,86,5,81
2022-04-21,3,Bed Number 3,19,8,11
2022-04-22,1,Bed Number 1,25,20,5
2022-04-22,2,Bed Number 2,85,2,83
2022-04-22,3,Bed Number 3,70,34,36
2022-04-23,1,Bed Number 1,24,17,7
2022-04-23,2,Bed Number 2,41,24,17
2022-04-23,3,Bed Number 3,38,10,28
2022-04-24,1,Bed Number 1,49,0,49
2022-04-24,2,Bed Number 2,93,20,73
2022-04-24,3,Bed Number 3,88,82,6
2022-04-25,1,Bed Number 1,83,16,67
2022-04-25,2,Bed Number 2,65,40,25
2022-04-25,3,Bed Number 3,29,29,0
2022-04-26,1,Bed Number 1,94,36,58
2022-04-26,2,Bed Number 2,41,0,41
2022-04-26,3,Bed Number 3,40,15,25
2022-04-27,1,Bed Number 1,29,24,5
2022-04-27,2,Bed Number 2,88,74,14
2022-04-27,3,Bed Number 3,45,28,17
2022-04-28,1,Bed Number 1,93,62,31
2022-04-28,2,Bed Number 2,68,61,7
2022-04-28,3,Bed Number 3,78,14,64
2022-04-29,1,Bed Number 1,32,30,2
2022-04-29,2,Bed Number 2,48,22,26
2022-04-29,3,Bed Number 3,95,74,21
2022-04-30,1,Bed Number 1,100,46,54
2022-04-30,2,Bed Number 2,76,69,7
2022-04-30,3,Bed Number 3,13,8,5
2022-05-01,1,Bed Number 1,87,31,56
2022-05-01,2,Bed Number 2,63,35,28
2022-05-01,3,Bed Number 3,45,5,40
2022-05-02,1,Bed Number 1,29,10,19
2022-05-02,2,Bed Number 2,55,54,1
2022-05-02,3,Bed Number 3,50,13,37
2022-05-03,1,Bed Number 1,67,15,52
2022-05-03,2,Bed Number 2,49,10,39
2022-05-03,3,Bed Number 3,98,19,79
2022-05-04,1,Bed Number 1,39,30,9
2022-05-04,2,Bed Number 2,48,35,13
2022-05-04,3,Bed Number 3,92,73,19
2022-05-05,1,Bed Number 1,20,11,9
2022-05-05,2,Bed Number 2,44,42,2
2022-05-05,3,Bed Number 3,58,12,46
2022-05-06,1,Bed Number 1,93,73,20
2022-05-06,2,Bed Number 2,76,55,21
2022-05-06,3,Bed Number 3,56,36,20
2022-05-07,1,Bed Number 1,14,3,11
2022-05-07,2,Bed Number 2,55,12,43
2022-05-07,3,Bed Number 3,62,22,40
2022-05-08,1,Bed Number 1,31,13,18
2022-05-08,2,Bed Number 2,34,19,15
2022-05-08,3,Bed Number 3,74,48,26
2022-05-09,1,Bed Number 1,13,2,11
2022-05-09,2,Bed Number 2,37,32,5
2022-05-09,3,Bed Number 3,34,6,28
2022-05-10,1,Bed Number 1,25,8,17
2022-05-10,2,Bed Number 2,81,58,23
2022-05-10,3,Bed Number 3,76,49,27
2022-05-11,1,Bed Number 1,95,66,29
2022-05-11,2,Bed Number 2,76,51,25
2022-05-11,3,Bed Number 3,93,35,58
2022-05-12,1,Bed Number 1,60,40,20
2022-05-12,2,Bed Number 2,85,29,56
2022-05-12,3,Bed Number 3,88,67,21
2022-05-13,1,Bed Number 1,41,32,9
2022-05-13,2,Bed Number 2,17,8,9
2022-05-13,3,Bed Number 3,25,14,11
2022-05-14,1,Bed Number 1,90,27,63
2022-05-14,2,Bed Number 2,16,14,2
2022-05-14,3,Bed Number 3,15,7,8
2022-05-15,1,Bed Number 1,75,74,1
2022-05-15,2,Bed Number 2,62,21,41
2022-05-15,3,Bed Number 3,94,50,44
2022-05-16,1,Bed Number 1,37,22,15
2022-05-16,2,Bed Number 2,31,31,0
2022-05-16,3,Bed Number 3,81,1,80
2022-05-17,1,Bed Number 1,94,1,93
2022-05-17,2,Bed Number 2,17,7,10
2022-05-17,3,Bed Number 3,18,5,13
2022-05-18,1,Bed Number 1,96,46,50
2022-05-18,2,Bed Number 2,91,29,62
2022-05-18,3,Bed Number 3,65,42,23
2022-05-19,1,Bed Number 1,39,0,39
2022-05-19,2,Bed Number 2,95,27,68
2022-05-19,3,Bed Number 3,81,8,73
2022-05-20,1,Bed Number 1,19,6,13
2022-05-20,2,Bed Number 2,88,59,29
2022-05-20,3,Bed Number 3,42,7,35
2022-05-21,1,Bed Number 1,31,27,4
2022-05-21,2,Bed Number 2,75,0,75
2022-05-21,3,Bed Number 3,33,3,30
2022-05-22,1,Bed Number 1,99,79,20
2022-05-22,2,Bed Number 2,89,35,54
2022-05-22,3,Bed Number 3,72,54,18
2022-05-23,1,Bed Number 1,96,49,47
2022-05-23,2,Bed Number 2,13,6,7
2022-05-23,3,Bed Number 3,52,43,9
2022-05-24,1,Bed Number 1,58,31,27
2022-05-24,2,Bed Number 2,40,37,3
2022-05-24,3,Bed Number 3,21,6,15
2022-05-25,1,Bed Number 1,41,38,3
2022-05-25,2,Bed Number 2,64,1,63
2022-05-25,3,Bed Number 3,10,6,4
2022-05-26,1,Bed Number 1,83,71,12
2022-05-26,2,Bed Number 2,17,7,10
2022-05-26,3,Bed Number 3,99,30,69
2022-05-27,1,Bed Number 1,66,1,65
2022-05-27,2,Bed Number 2,94,93,1
2022-05-27,3,Bed Number 3,21,12,9
2022-05-28,1,Bed Number 1,23,18,5
2022-05-28,2,Bed Number 2,29,18,11
2022-05-28,3,Bed Number 3,30,14,16
2022-05-29,1,Bed Number 1,15,10,5
2022-05-29,2,Bed Number 2,24,6,18
2022-05-29,3,Bed Number 3,44,30,14
2022-05-30,1,Bed Number 1,93,68,25
2022-05-30,2,Bed Number 2,83,72,11
2022-05-30,3,Bed Number 3,25,21,4
2022-05-31,1,Bed Number 1,53,6,47
2022-05-31,2,Bed Number 2,34,23,11
2022-05-31,3,Bed Number 3,63,27,36
2022-06-01,1,Bed Number 1,59,23,36
2022-06-01,2,Bed Number 2,65,53,12
2022-06-01,3,Bed Number 3,18,14,4
2022-06-02,1,Bed Number 1,54,20,34
2022-06-02,2,Bed Number 2,74,42,32
2022-06-02,3,Bed Number 3,99,50,49
2022-06-03,1,Bed Number 1,74,55,19
2022-06-03,2,Bed Number 2,50,20,30
2022-06-03,3,Bed Number 3,78,63,15
2022-06-04,1,Bed Number 1,68,29,39
2022-06-04,2,Bed Number 2,42,1,41
2022-06-04,3,Bed Number 3,92,17,75
2022-06-05,1,Bed Number 1,67,53,14
2022-06-05,2,Bed Number 2,46,1,45
2022-06-05,3,Bed Number 3,32,3,29
2022-06-06,1,Bed Number 1,62,59,3
2022-06-06,2,Bed Number 2,82,78,4
2022-06-06,3,Bed Number 3,23,23,0
2022-06-07,1,Bed Number 1,85,25,60
2022-06-07,2,Bed Number 2,80,22,58
2022-06-07,3,Bed Number 3,12,6,6
2022-06-08,1,Bed Number 1,38,24,14
2022-06-08,2,Bed Number 2,54,1,53
2022-06-08,3,Bed Number 3,15,5,10
2022-06-09,1,Bed Number 1,58,50,8
2022-06-09,2,Bed Number 2,89,16,73
2022-06-09,3,Bed Number 3,97,51,46
2022-06-10,1,Bed Number 1,76,75,1
2022-06-10,2,Bed Number 2,29,20,9
2022-06-10,3,Bed Number 3,27,26,1
2022-06-11,1,Bed Number 1,82,60,22
2022-06-11,2,Bed Number 2,18,9,9
2022-06-11,3,Bed Number 3,85,7,78
2022-06-12,1,Bed Number 1,60,48,12
2022-06-12,2,Bed Number 2,20,2,18
2022-06-12,3,Bed Number 3,76,35,41
2022-06-13,1,Bed Number 1,49,31,18
2022-06-13,2,Bed Number 2,31,15,16
2022-06-13,3,Bed Number 3,36,4,32
2022-06-14,1,Bed Number 1,43,37,6
2022-06-14,2,Bed Number 2,63,4,59
2022-06-14,3,Bed Number 3,83,23,60
2022-06-15,1,Bed Number 1,64,53,11
2022-06-15,2,Bed Number 2,89,60,29
2022-06-15,3,Bed Number 3,34,9,25
2022-06-16,1,Bed Number 1,17,0,17
2022-06-16,2,Bed Number 2,20,19,1
2022-06-16,3,Bed Number 3,83,29,54
2022-06-17,1,Bed Number 1,15,4,11
2022-06-17,2,Bed Number 2,46,22,24
2022-06-17,3,Bed Number 3,47,24,23
2022-06-18,1,Bed Number 1,14,9,5
2022-06-18,2,Bed Number 2,15,13,2
2022-06-18,3,Bed Number 3,57,26,31
2022-06-19,1,Bed Number 1,19,13,6
2022-06-19,2,Bed Number 2,38,12,26
2022-06-19,3,Bed Number 3,67,36,31
2022-06-20,1,Bed Number 1,87,55,32
2022-06-20,2,Bed Number 2,21,10,11
2022-06-20,3,Bed Number 3,81,39,42
2022-06-21,1,Bed Number 1,23,17,6
2022-06-21,2,Bed Number 2,69,63,6
2022-06-21,3,Bed Number 3,32,27,5
2022-06-22,1,Bed Number 1,54,53,1
2022-06-22,2,Bed Number 2,97,34,63
2022-06-22,3,Bed Number 3,12,10,2
2022-06-23,1,Bed Number 1,45,38,7
2022-06-23,2,Bed Number 2,10,8,2
2022-06-23,3,Bed Number 3,50,8,42
2022-06-24,1,Bed Number 1,100,32,68
2022-06-24,2,Bed Number 2,87,20,67
2022-06-24,3,Bed Number 3,63,43,20
2022-06-25,1,Bed Number 1,41,24,17
2022-06-25,2,Bed Number 2,49,16,33
2022-06-25,3,Bed Number 3,45,11,34
2022-06-26,1,Bed Number 1,81,3,78
2022-06-26,2,Bed Number 2,46,45,1
2022-06-26,3,Bed Number 3,17,9,8
2022-06-27,1,Bed Number 1,79,29,50
2022-06-27,2,Bed Number 2,64,60,4
2022-06-27,3,Bed Number 3,92,91,1
2022-06-28,1,Bed Number 1,70,27,43
2022-06-28,2,Bed Number 2,90,14,76
2022-06-28,3,Bed Number 3,90,33,57
2022-06-29,1,Bed Number 1,54,10,44
2022-06-29,2,Bed Number 2,21,19,2
2022-06-29,3,Bed Number 3,91,43,48
2022-06-30,1,Bed Number 1,59,15,44
2022-06-30,2,Bed Number 2,30,5,25
2022-06-30,3,Bed Number 3,97,69,28
2022-07-01,1,Bed Number 1,91,30,61
2022-07-01,2,Bed Number 2,95,75,20
2022-07-01,3,Bed Number 3,19,16,3
2022-07-02,1,Bed Number 1,100,81,19
2022-07-02,2,Bed Number 2,19,4,15
2022-07-02,3,Bed Number 3,71,66,5
2022-07-03,1,Bed Number 1,100,88,12
2022-07-03,2,Bed Number 2,72,24,48
2022-07-03,3,Bed Number 3,66,30,36
2022-07-04,1,Bed Number 1,14,2,12
2022-07-04,2,Bed Number 2,52,24,28
2022-07-04,3,Bed Number 3,18,2,16
2022-07-05,1,Bed Number 1,16,12,4
2022-07-05,2,Bed Number 2,27,11,16
2022-07-05,3,Bed Number 3,94,16,78
2022-07-06,1,Bed Number 1,83,35,48
2022-07-06,2,Bed Number 2,27,27,0
2022-07-06,3,Bed Number 3,81,62,19
2022-07-07,1,Bed Number 1,69,27,42
2022-07-07,2,Bed Number 2,13,5,8
2022-07-07,3,Bed Number 3,38,25,13
2022-07-08,1,Bed Number 1,62,40,22
2022-07-08,2,Bed Number 2,99,81,18
2022-07-08,3,Bed Number 3,16,9,7
2022-07-09,1,Bed Number 1,65,33,32
2022-07-09,2,Bed Number 2,76,13,63
2022-07-09,3,Bed Number 3,84,71,13
2022-07-10,1,Bed Number 1,50,47,3
2022-07-10,2,Bed Number 2,61,49,12
2022-07-10,3,Bed Number 3,25,14,11
2022-07-11,1,Bed Number 1,49,22,27
2022-07-11,2,Bed Number 2,81,28,53
2022-07-11,3,Bed Number 3,22,11,11
2022-07-12,1,Bed Number 1,95,25,70
2022-07-12,2,Bed Number 2,13,9,4
2022-07-12,3,Bed Number 3,97,75,22
2022-07-13,1,Bed Number 1,35,11,24
2022-07-13,2,Bed Number 2,39,33,6
2022-07-13,3,Bed Number 3,68,39,29
2022-07-14,1,Bed Number 1,49,29,20
2022-07-14,2,Bed Number 2,91,47,44
2022-07-14,3,Bed Number 3,38,15,23
2022-07-15,1,Bed Number 1,90,59,31
2022-07-15,2,Bed Number 2,83,63,20
2022-07-15,3,Bed Number 3,88,86,2
2022-07-16,1,Bed Number 1,52,6,46
2022-07-16,2,Bed Number 2,77,27,50
2022-07-16,3,Bed Number 3,66,42,24
2022-07-17,1,Bed Number 1,53,47,6
2022-07-17,2,Bed Number 2,61,21,40
2022-07-17,3,Bed Number 3,30,0,30
2022-07-18,1,Bed Number 1,25,22,3
2022-07-18,2,Bed Number 2,97,82,15
2022-07-18,3,Bed Number 3,81,62,19
2022-07-19,1,Bed Number 1,50,2,48
2022-07-19,2,Bed Number 2,75,45,30
2022-07-19,3,Bed Number 3,77,30,47
2022-07-20,1,Bed Number 1,24,9,15
2022-07-20,2,Bed Number 2,46,7,39
2022-07-20,3,Bed Number 3,92,13,79
2022-07-21,1,Bed Number 1,43,22,21
2022-07-21,2,Bed Number 2,92,27,65
2022-07-21,3,Bed Number 3,84,77,7
2022-07-22,1,Bed Number 1,75,9,66
2022-07-22,2,Bed Number 2,92,78,14
2022-07-22,3,Bed Number 3,43,9,34
2022-07-23,1,Bed Number 1,89,9,80
2022-07-23,2,Bed Number 2,22,0,22
2022-07-23,3,Bed Number 3,34,25,9
2022-07-24,1,Bed Number 1,13,13,0
2022-07-24,2,Bed Number 2,34,28,6
2022-07-24,3,Bed Number 3,76,56,20
2022-07-25,1,Bed Number 1,62,9,53
2022-07-25,2,Bed Number 2,85,85,0
2022-07-25,3,Bed Number 3,20,4,16
2022-07-26,1,Bed Number 1,66,46,20
2022-07-26,2,Bed Number 2,10,7,3
2022-07-26,3,Bed Number 3,63,46,17
2022-07-27,1,Bed Number 1,38,35,3
2022-07-27,2,Bed Number 2,11,3,8
2022-07-27,3,Bed Number 3,76,49,27
2022-07-28,1,Bed Number 1,80,53,27
2022-07-28,2,Bed Number 2,67,38,29
2022-07-28,3,Bed Number 3,93,66,27
2022-07-29,1,Bed Number 1,65,37,28
2022-07-29,2,Bed Number 2,46,12,34
2022-07-29,3,Bed Number 3,55,41,14
2022-07-30,1,Bed Number 1,93,41,52
2022-07-30,2,Bed Number 2,85,47,38
2022-07-30,3,Bed Number 3,30,5,25
2022-07-31,1,Bed Number 1,89,57,32
2022-07-31,2,Bed Number 2,33,6,27
2022-07-31,3,Bed Number 3,49,18,31
2022-08-01,1,Bed Number 1,13,12,1
2022-08-01,2,Bed Number 2,44,7,37
2022-08-01,3,Bed Number 3,79,42,37
2022-08-02,1,Bed Number 1,56,53,3
2022-08-02,2,Bed Number 2,96,64,32
2022-08-02,3,Bed Number 3,34,20,14
2022-08-03,1,Bed Number 1,89,79,10
2022-08-03,2,Bed Number 2,21,17,4
2022-08-03,3,Bed Number 3,23,9,14
2022-08-04,1,Bed Number 1,77,42,35
2022-08-04,2,Bed Number 2,26,2,24
2022-08-04,3,Bed Number 3,48,14,34
2022-08-05,1,Bed Number 1,24,7,17
2022-08-05,2,Bed Number 2,36,18,18
2022-08-05,3,Bed Number 3,33,19,14
2022-08-06,1,Bed Number 1,13,11,2
2022-08-06,2,Bed Number 2,78,75,3
2022-08-06,3,Bed Number 3,53,37,16
2022-08-07,1,Bed Number 1,65,19,46
2022-08-07,2,Bed Number 2,68,64,4
2022-08-07,3,Bed Number 3,19,11,8
2022-08-08,1,Bed Number 1,56,30,26
2022-08-08,2,Bed Number 2,41,1,40
2022-08-08,3,Bed Number 3,36,30,6
2022-08-09,1,Bed Number 1,91,65,26
2022-08-09,2,Bed Number 2,82,48,34
2022-08-09,3,Bed Number 3,11,1,10
2022-08-10,1,Bed Number 1,75,53,22
2022-08-10,2,Bed Number 2,56,2,54
2022-08-10,3,Bed Number 3,41,32,9
2022-08-11,1,Bed Number 1,57,47,10
2022-08-11,2,Bed Number 2,10,0,10
2022-08-11,3,Bed Number 3,18,13,5
2022-08-12,1,Bed Number 1,24,16,8
2022-08-12,2,Bed Number 2,25,9,16
2022-08-12,3,Bed Number 3,15,10,5
2022-08-13,1,Bed Number 1,23,1,22
2022-08-13,2,Bed Number 2,20,17,3
2022-08-13,3,Bed Number 3,37,22,15
2022-08-14,1,Bed Number 1,31,20,11
2022-08-14,2,Bed Number 2,83,66,17
2022-08-14,3,Bed Number 3,12,10,2
2022-08-15,1,Bed Number 1,78,66,12
2022-08-15,2,Bed Number 2,60,33,27
2022-08-15,3,Bed Number 3,43,21,22
2022-08-16,1,Bed Number 1,95,91,4
2022-08-16,2,Bed Number 2,54,12,42
2022-08-16,3,Bed Number 3,49,49,0
2022-08-17,1,Bed Number 1,37,35,2
2022-08-17,2,Bed Number 2,13,10,3
2022-08-17,3,Bed Number 3,99,82,17
2022-08-18,1,Bed Number 1,66,13,53
2022-08-18,2,Bed Number 2,41,39,2
2022-08-18,3,Bed Number 3,28,2,26
2022-08-19,1,Bed Number 1,42,40,2
2022-08-19,2,Bed Number 2,45,10,35
2022-08-19,3,Bed Number 3,43,22,21
2022-08-20,1,Bed Number 1,45,18,27
2022-08-20,2,Bed Number 2,59,34,25
2022-08-20,3,Bed Number 3,17,16,1
2022-08-21,1,Bed Number 1,29,21,8
2022-08-21,2,Bed Number 2,69,4,65
2022-08-21,3,Bed Number 3,28,11,17
2022-08-22,1,Bed Number 1,22,3,19
2022-08-22,2,Bed Number 2,53,23,30
2022-08-22,3,Bed Number 3,54,50,4
2022-08-23,1,Bed Number 1,79,39,40
2022-08-23,2,Bed Number 2,98,61,37
2022-08-23,3,Bed Number 3,58,2,56
2022-08-24,1,Bed Number 1,91,2,89
2022-08-24,2,Bed Number 2,91,45,46
2022-08-24,3,Bed Number 3,69,36,33
2022-08-25,1,Bed Number 1,90,5,85
2022-08-25,2,Bed Number 2,64,23,41
2022-08-25,3,Bed Number 3,64,51,13
2022-08-26,1,Bed Number 1,50,25,25
2022-08-26,2,Bed Number 2,57,35,22
2022-08-26,3,Bed Number 3,68,16,52
2022-08-27,1,Bed Number 1,90,88,2
2022-08-27,2,Bed Number 2,79,39,40
2022-08-27,3,Bed Number 3,40,23,17
2022-08-28,1,Bed Number 1,90,35,55
2022-08-28,2,Bed Number 2,19,18,1
2022-08-28,3,Bed Number 3,55,0,55
2022-08-29,1,Bed Number 1,37,7,30
2022-08-29,2,Bed Number 2,47,44,3
2022-08-29,3,Bed Number 3,84,78,6
2022-08-30,1,Bed Number 1,25,11,14
2022-08-30,2,Bed Number 2,93,42,51
2022-08-30,3,Bed Number 3,94,74,20
2022-08-31,1,Bed Number 1,42,11,31
2022-08-31,2,Bed Number 2,82,73,9
2022-08-31,3,Bed Number 3,88,28,60
2022-09-01,1,Bed Number 1,38,31,7
2022-09-01,2,Bed Number 2,42,35,7
2022-09-01,3,Bed Number 3,70,53,17
2022-09-02,1,Bed Number 1,41,30,11
2022-09-02,2,Bed Number 2,57,19,38
2022-09-02,3,Bed Number 3,46,17,29
2022-09-03,1,Bed Number 1,63,26,37
2022-09-03,2,Bed Number 2,52,36,16
2022-09-03,3,Bed Number 3,35,23,12
2022-09-04,1,Bed Number 1,50,39,11
2022-09-04,2,Bed Number 2,49,47,2
2022-09-04,3,Bed Number 3,57,41,16
2022-09-05,1,Bed Number 1,79,11,68
2022-09-05,2,Bed Number 2,59,2,57
2022-09-05,3,Bed Number 3,20,12,8
2022-09-06,1,Bed Number 1,59,41,18
2022-09-06,2,Bed Number 2,82,44,38
2022-09-06,3,Bed Number 3,33,12,21
2022-09-07,1,Bed Number 1,42,23,19
2022-09-07,2,Bed Number 2,100,86,14
2022-09-07,3,Bed Number 3,95,66,29
2022-09-08,1,Bed Number 1,26,5,21
2022-09-08,2,Bed Number 2,13,0,13
2022-09-08,3,Bed Number 3,11,10,1
2022-09-09,1,Bed Number 1,85,74,11
2022-09-09,2,Bed Number 2,34,26,8
2022-09-09,3,Bed Number 3,96,43,53
2022-09-10,1,Bed Number 1,14,12,2
2022-09-10,2,Bed Number 2,84,20,64
2022-09-10,3,Bed Number 3,70,50,20
2022-09-11,1,Bed Number 1,57,10,47
2022-09-11,2,Bed Number 2,25,15,10
2022-09-11,3,Bed Number 3,94,75,19
2022-09-12,1,Bed Number 1,49,21,28
2022-09-12,2,Bed Number 2,40,31,9
2022-09-12,3,Bed Number 3,44,41,3
2022-09-13,1,Bed Number 1,62,55,7
2022-09-13,2,Bed Number 2,19,8,11
2022-09-13,3,Bed Number 3,54,34,20
2022-09-14,1,Bed Number 1,34,33,1
2022-09-14,2,Bed Number 2,36,17,19
2022-09-14,3,Bed Number 3,54,47,7
2022-09-15,1,Bed Number 1,57,25,32
2022-09-15,2,Bed Number 2,39,6,33
2022-09-15,3,Bed Number 3,30,8,22
2022-09-16,1,Bed Number 1,81,29,52
2022-09-16,2,Bed Number 2,64,36,28
2022-09-16,3,Bed Number 3,46,46,0
2022-09-17,1,Bed Number 1,39,10,29
2022-09-17,2,Bed Number 2,98,27,71
2022-09-17,3,Bed Number 3,44,32,12
2022-09-18,1,Bed Number 1,12,8,4
2022-09-18,2,Bed Number 2,28,20,8
2022-09-18,3,Bed Number 3,91,71,20
2022-09-19,1,Bed Number 1,33,11,22
2022-09-19,2,Bed Number 2,41,22,19
2022-09-19,3,Bed Number 3,56,10,46
2022-09-20,1,Bed Number 1,29,0,29
2022-09-20,2,Bed Number 2,91,29,62
2022-09-20,3,Bed Number 3,34,26,8
2022-09-21,1,Bed Number 1,85,18,67
2022-09-21,2,Bed Number 2,22,0,22
2022-09-21,3,Bed Number 3,25,23,2
2022-09-22,1,Bed Number 1,83,45,38
2022-09-22,2,Bed Number 2,82,63,19
2022-09-22,3,Bed Number 3,65,45,20
2022-09-23,1,Bed Number 1,90,85,5
2022-09-23,2,Bed Number 2,89,28,61
2022-09-23,3,Bed Number 3,31,7,24
2022-09-24,1,Bed Number 1,97,38,59
2022-09-24,2,Bed Number 2,98,66,32
2022-09-24,3,Bed Number 3,33,15,18
2022-09-25,1,Bed Number 1,37,32,5
2022-09-25,2,Bed Number 2,11,1,10
2022-09-25,3,Bed Number 3,88,15,73
2022-09-26,1,Bed Number 1,36,14,22
2022-09-26,2,Bed Number 2,100,62,38
2022-09-26,3,Bed Number 3,83,37,46
2022-09-27,1,Bed Number 1,75,52,23
2022-09-27,2,Bed Number 2,58,47,11
2022-09-27,3,Bed Number 3,53,40,13
2022-09-28,1,Bed Number 1,40,10,30
2022-09-28,2,Bed Number 2,27,15,12
2022-09-28,3,Bed Number 3,84,73,11
2022-09-29,1,Bed Number 1,84,63,21
2022-09-29,2,Bed Number 2,16,15,1
2022-09-29,3,Bed Number 3,31,14,17
2022-09-30,1,Bed Number 1,27,1,26
2022-09-30,2,Bed Number 2,23,18,5
2022-09-30,3,Bed Number 3,93,15,78
2022-10-01,1,Bed Number 1,25,24,1
2022-10-01,2,Bed Number 2,51,27,24
2022-10-01,3,Bed Number 3,29,13,16
2022-10-02,1,Bed Number 1,28,22,6
2022-10-02,2,Bed Number 2,81,51,30
2022-10-02,3,Bed Number 3,11,4,7
2022-10-03,1,Bed Number 1,93,39,54
2022-10-03,2,Bed Number 2,62,5,57
2022-10-03,3,Bed Number 3,87,3,84
2022-10-04,1,Bed Number 1,35,1,34
2022-10-04,2,Bed Number 2,94,24,70
2022-10-04,3,Bed Number 3,28,23,5
2022-10-05,1,Bed Number 1,55,49,6
2022-10-05,2,Bed Number 2,68,60,8
2022-10-05,3,Bed Number 3,36,14,22
2022-10-06,1,Bed Number 1,12,10,2
2022-10-06,2,Bed Number 2,16,14,2
2022-10-06,3,Bed Number 3,14,14,0
2022-10-07,1,Bed Number 1,46,32,14
2022-10-07,2,Bed Number 2,60,39,21
2022-10-07,3,Bed Number 3,88,54,34
2022-10-08,1,Bed Number 1,24,5,19
2022-10-08,2,Bed Number 2,26,0,26
2022-10-08,3,Bed Number 3,37,26,11
2022-10-09,1,Bed Number 1,90,68,22
2022-10-09,2,Bed Number 2,24,1,23
2022-10-09,3,Bed Number 3,80,79,1
2022-10-10,1,Bed Number 1,98,55,43
2022-10-10,2,Bed Number 2,25,15,10
2022-10-10,3,Bed Number 3,14,1,13
2022-10-11,1,Bed Number 1,44,6,38
2022-10-11,2,Bed Number 2,69,11,58
2022-10-11,3,Bed Number 3,91,55,36
2022-10-12,1,Bed Number 1,94,4,90
2022-10-12,2,Bed Number 2,45,9,36
2022-10-12,3,Bed Number 3,83,26,57
2022-10-13,1,Bed Number 1,26,1,25
2022-10-13,2,Bed Number 2,31,3,28
2022-10-13,3,Bed Number 3,54,16,38
2022-10-14,1,Bed Number 1,12,3,9
2022-10-14,2,Bed Number 2,96,9,87
2022-10-14,3,Bed Number 3,89,59,30
2022-10-15,1,Bed Number 1,82,26,56
2022-10-15,2,Bed Number 2,20,11,9
2022-10-15,3,Bed Number 3,70,7,63
2022-10-16,1,Bed Number 1,33,11,22
2022-10-16,2,Bed Number 2,57,34,23
2022-10-16,3,Bed Number 3,18,1,17
2022-10-17,1,Bed Number 1,28,9,19
2022-10-17,2,Bed Number 2,52,12,40
2022-10-17,3,Bed Number 3,58,38,20
2022-10-18,1,Bed Number 1,75,61,14
2022-10-18,2,Bed Number 2,79,61,18
2022-10-18,3,Bed Number 3,20,7,13
2022-10-19,1,Bed Number 1,97,78,19
2022-10-19,2,Bed Number 2,92,69,23
2022-10-19,3,Bed Number 3,18,0,18
2022-10-20,1,Bed Number 1,66,63,3
2022-10-20,2,Bed Number 2,65,50,15
2022-10-20,3,Bed Number 3,86,36,50
2022-10-21,1,Bed Number 1,15,13,2
2022-10-21,2,Bed Number 2,79,29,50
2022-10-21,3,Bed Number 3,81,67,14
2022-10-22,1,Bed Number 1,37,14,23
2022-10-22,2,Bed Number 2,84,81,3
2022-10-22,3,Bed Number 3,99,8,91
2022-10-23,1,Bed Number 1,75,4,71
2022-10-23,2,Bed Number 2,68,44,24
2022-10-23,3,Bed Number 3,79,60,19
2022-10-24,1,Bed Number 1,37,2,35
2022-10-24,2,Bed Number 2,71,40,31
2022-10-24,3,Bed Number 3,56,32,24
2022-10-25,1,Bed Number 1,23,13,10
2022-10-25,2,Bed Number 2,50,7,43
2022-10-25,3,Bed Number 3,55,9,46
2022-10-26,1,Bed Number 1,40,20,20
2022-10-26,2,Bed Number 2,70,5,65
2022-10-26,3,Bed Number 3,41,0,41
2022-10-27,1,Bed Number 1,70,66,4
2022-10-27,2,Bed Number 2,85,16,69
2022-10-27,3,Bed Number 3,22,15,7
2022-10-28,1,Bed Number 1,55,47,8
2022-10-28,2,Bed Number 2,49,2,47
2022-10-28,3,Bed Number 3,45,32,13
2022-10-29,1,Bed Number 1,73,69,4
2022-10-29,2,Bed Number 2,91,77,14
2022-10-29,3,Bed Number 3,77,75,2
2022-10-30,1,Bed Number 1,19,13,6
2022-10-30,2,Bed Number 2,57,42,15
2022-10-30,3,Bed Number 3,35,1,34
2022-10-31,1,Bed Number 1,49,28,21
2022-10-31,2,Bed Number 2,85,3,82
2022-10-31,3,Bed Number 3,45,45,0
2022-11-01,1,Bed Number 1,75,41,34
2022-11-01,2,Bed Number 2,48,45,3
2022-11-01,3,Bed Number 3,44,23,21
2022-11-02,1,Bed Number 1,32,9,23
2022-11-02,2,Bed Number 2,52,23,29
2022-11-02,3,Bed Number 3,95,2,93
2022-11-03,1,Bed Number 1,46,44,2
2022-11-03,2,Bed Number 2,15,8,7
2022-11-03,3,Bed Number 3,13,7,6
2022-11-04,1,Bed Number 1,54,30,24
2022-11-04,2,Bed Number 2,91,62,29
2022-11-04,3,Bed Number 3,10,9,1
2022-11-05,1,Bed Number 1,90,58,32
2022-11-05,2,Bed Number 2,51,17,34
2022-11-05,3,Bed Number 3,88,37,51
2022-11-06,1,Bed Number 1,19,13,6
2022-11-06,2,Bed Number 2,14,14,0
2022-11-06,3,Bed Number 3,87,40,47
2022-11-07,1,Bed Number 1,52,2,50
2022-11-07,2,Bed Number 2,28,13,15
2022-11-07,3,Bed Number 3,38,14,24
2022-11-08,1,Bed Number 1,39,28,11
2022-11-08,2,Bed Number 2,45,14,31
2022-11-08,3,Bed Number 3,61,58,3
2022-11-09,1,Bed Number 1,29,27,2
2022-11-09,2,Bed Number 2,71,53,18
2022-11-09,3,Bed Number 3,16,3,13
2022-11-10,1,Bed Number 1,85,75,10
2022-11-10,2,Bed Number 2,48,1,47
2022-11-10,3,Bed Number 3,68,34,34
2022-11-11,1,Bed Number 1,42,27,15
2022-11-11,2,Bed Number 2,93,18,75
2022-11-11,3,Bed Number 3,63,10,53
2022-11-12,1,Bed Number 1,71,42,29
2022-11-12,2,Bed Number 2,100,12,88
2022-11-12,3,Bed Number 3,19,18,1
2022-11-13,1,Bed Number 1,56,43,13
2022-11-13,2,Bed Number 2,50,12,38
2022-11-13,3,Bed Number 3,49,43,6
2022-11-14,1,Bed Number 1,73,12,61
2022-11-14,2,Bed Number 2,62,13,49
2022-11-14,3,Bed Number 3,86,4,82
2022-11-15,1,Bed Number 1,93,60,33
2022-11-15,2,Bed Number 2,87,84,3
2022-11-15,3,Bed Number 3,34,18,16
2022-11-16,1,Bed Number 1,34,0,34
2022-11-16,2,Bed Number 2,22,13,9
2022-11-16,3,Bed Number 3,78,64,14
2022-11-17,1,Bed Number 1,39,37,2
2022-11-17,2,Bed Number 2,44,42,2
2022-11-17,3,Bed Number 3,25,21,4
2022-11-18,1,Bed Number 1,29,19,10
2022-11-18,2,Bed Number 2,71,70,1
2022-11-18,3,Bed Number 3,61,57,4
2022-11-19,1,Bed Number 1,74,11,63
2022-11-19,2,Bed Number 2,15,3,12
2022-11-19,3,Bed Number 3,28,16,12
2022-11-20,1,Bed Number 1,34,23,11
2022-11-20,2,Bed Number 2,12,9,3
2022-11-20,3,Bed Number 3,84,32,52
2022-11-21,1,Bed Number 1,100,93,7
2022-11-21,2,Bed Number 2,70,14,56
2022-11-21,3,Bed Number 3,96,16,80
2022-11-22,1,Bed Number 1,19,13,6
2022-11-22,2,Bed Number 2,19,19,0
2022-11-22,3,Bed Number 3,66,28,38
2022-11-23,1,Bed Number 1,47,40,7
2022-11-23,2,Bed Number 2,73,67,6
2022-11-23,3,Bed Number 3,49,40,9
2022-11-24,1,Bed Number 1,16,12,4
2022-11-24,2,Bed Number 2,24,14,10
2022-11-24,3,Bed Number 3,34,17,17
2022-11-25,1,Bed Number 1,65,11,54
2022-11-25,2,Bed Number 2,49,37,12
2022-11-25,3,Bed Number 3,75,12,63
2022-11-26,1,Bed Number 1,34,2,32
2022-11-26,2,Bed Number 2,13,3,10
2022-11-26,3,Bed Number 3,24,0,24
2022-11-27,1,Bed Number 1,63,29,34
2022-11-27,2,Bed Number 2,92,67,25
2022-11-27,3,Bed Number 3,48,40,8
2022-11-28,1,Bed Number 1,75,5,70
2022-11-28,2,Bed Number 2,29,10,19
2022-11-28,3,Bed Number 3,96,48,48
2022-11-29,1,Bed Number 1,10,9,1
2022-11-29,2,Bed Number 2,28,4,24
2022-11-29,3,Bed Number 3,27,19,8
2022-11-30,1,Bed Number 1,55,2,53
2022-11-30,2,Bed Number 2,19,7,12
2022-11-30,3,Bed Number 3,29,18,11
2022-12-01,1,Bed Number 1,47,22,25
2022-12-01,2,Bed Number 2,10,1,9
2022-12-01,3,Bed Number 3,72,49,23
2022-12-02,1,Bed Number 1,78,27,51
2022-12-02,2,Bed Number 2,77,35,42
2022-12-02,3,Bed Number 3,43,26,17
2022-12-03,1,Bed Number 1,30,26,4
2022-12-03,2,Bed Number 2,43,25,18
2022-12-03,3,Bed Number 3,42,20,22
2022-12-04,1,Bed Number 1,45,38,7
2022-12-04,2,Bed Number 2,24,24,0
2022-12-04,3,Bed Number 3,12,8,4
2022-12-05,1,Bed Number 1,85,57,28
2022-12-05,2,Bed Number 2,47,2,45
2022-12-05,3,Bed Number 3,80,34,46
2022-12-06,1,Bed Number 1,97,63,34
2022-12-06,2,Bed Number 2,47,47,0
2022-12-06,3,Bed Number 3,86,36,50
2022-12-07,1,Bed Number 1,63,26,37
2022-12-07,2,Bed Number 2,63,51,12
2022-12-07,3,Bed Number 3,76,18,58
2022-12-08,1,Bed Number 1,82,45,37
2022-12-08,2,Bed Number 2,62,10,52
2022-12-08,3,Bed Number 3,98,4,94
2022-12-09,1,Bed Number 1,14,2,12
2022-12-09,2,Bed Number 2,69,22,47
2022-12-09,3,Bed Number 3,27,12,15
2022-12-10,1,Bed Number 1,47,35,12
2022-12-10,2,Bed Number 2,28,8,20
2022-12-10,3,Bed Number 3,78,64,14
2022-12-11,1,Bed Number 1,11,9,2
2022-12-11,2,Bed Number 2,48,24,24
2022-12-11,3,Bed Number 3,99,91,8
2022-12-12,1,Bed Number 1,86,2,84
2022-12-12,2,Bed Number 2,64,20,44
2022-12-12,3,Bed Number 3,62,43,19
2022-12-13,1,Bed Number 1,12,8,4
2022-12-13,2,Bed Number 2,47,4,43
2022-12-13,3,Bed Number 3,40,7,33
2022-12-14,1,Bed Number 1,59,33,26
2022-12-14,2,Bed Number 2,48,43,5
2022-12-14,3,Bed Number 3,36,14,22
2022-12-15,1,Bed Number 1,76,21,55
2022-12-15,2,Bed Number 2,43,39,4
2022-12-15,3,Bed Number 3,80,56,24
2022-12-16,1,Bed Number 1,38,16,22
2022-12-16,2,Bed Number 2,49,0,49
2022-12-16,3,Bed Number 3,42,34,8
2022-12-17,1,Bed Number 1,67,55,12
2022-12-17,2,Bed Number 2,96,82,14
2022-12-17,3,Bed Number 3,59,38,21
2022-12-18,1,Bed Number 1,35,17,18
2022-12-18,2,Bed Number 2,55,9,46
2022-12-18,3,Bed Number 3,79,20,59
2022-12-19,1,Bed Number 1,36,27,9
2022-12-19,2,Bed Number 2,57,35,22
2022-12-19,3,Bed Number 3,26,14,12
2022-12-20,1,Bed Number 1,28,19,9
2022-12-20,2,Bed Number 2,18,4,14
2022-12-20,3,Bed Number 3,97,84,13
2022-12-21,1,Bed Number 1,41,30,11
2022-12-21,2,Bed Number 2,72,47,25
2022-12-21,3,Bed Number 3,29,11,18
2022-12-22,1,Bed Number 1,87,58,29
2022-12-22,2,Bed Number 2,35,29,6
2022-12-22,3,Bed Number 3,71,21,50
2022-12-23,1,Bed Number 1,53,15,38
2022-12-23,2,Bed Number 2,58,7,51
2022-12-23,3,Bed Number 3,69,33,36
2022-12-24,1,Bed Number 1,86,67,19
2022-12-24,2,Bed Number 2,20,3,17
2022-12-24,3,Bed Number 3,95,14,81
2022-12-25,1,Bed Number 1,91,34,57
2022-12-25,2,Bed Number 2,35,14,21
2022-12-25,3,Bed Number 3,47,17,30
2022-12-26,1,Bed Number 1,73,57,16
2022-12-26,2,Bed Number 2,72,24,48
2022-12-26,3,Bed Number 3,82,25,57
2022-12-27,1,Bed Number 1,63,48,15
2022-12-27,2,Bed Number 2,72,42,30
2022-12-27,3,Bed Number 3,58,6,52
2022-12-28,1,Bed Number 1,56,38,18
2022-12-28,2,Bed Number 2,79,2,77
2022-12-28,3,Bed Number 3,47,40,7
2022-12-29,1,Bed Number 1,14,11,3
2022-12-29,2,Bed Number 2,74,30,44
2022-12-29,3,Bed Number 3,85,81,4
2022-12-30,1,Bed Number 1,40,35,5
2022-12-30,2,Bed Number 2,97,96,1
2022-12-30,3,Bed Number 3,52,10,42
2022-12-31,1,Bed Number 1,98,38,60
2022-12-31,2,Bed Number 2,84,61,23
2022-12-31,3,Bed Number 3,96,20,76
2023-01-01,1,Bed Number 1,70,58,12
2023-01-01,2,Bed Number 2,87,41,46
2023-01-01,3,Bed Number 3,27,4,23
2023-01-02,1,Bed Number 1,33,9,24
2023-01-02,2,Bed Number 2,47,31,16
2023-01-02,3,Bed Number 3,28,27,1
2023-01-03,1,Bed Number 1,96,88,8
2023-01-03,2,Bed Number 2,83,24,59
2023-01-03,3,Bed Number 3,44,13,31
2023-01-04,1,Bed Number 1,31,25,6
2023-01-04,2,Bed Number 2,13,9,4
2023-01-04,3,Bed Number 3,95,16,79
2023-01-05,1,Bed Number 1,26,22,4
2023-01-05,2,Bed Number 2,90,46,44
2023-01-05,3,Bed Number 3,81,62,19
2023-01-06,1,Bed Number 1,42,34,8
2023-01-06,2,Bed Number 2,21,10,11
2023-01-06,3,Bed Number 3,16,13,3
2023-01-07,1,Bed Number 1,14,1,13
2023-01-07,2,Bed Number 2,88,82,6
2023-01-07,3,Bed Number 3,65,17,48
2023-01-08,1,Bed Number 1,54,11,43
2023-01-08,2,Bed Number 2,74,28,46
2023-01-08,3,Bed Number 3,21,21,0
2023-01-09,1,Bed Number 1,83,32,51
2023-01-09,2,Bed Number 2,53,26,27
2023-01-09,3,Bed Number 3,55,55,0
2023-01-10,1,Bed Number 1,32,2,30
2023-01-10,2,Bed Number 2,63,0,63
2023-01-10,3,Bed Number 3,88,33,55
2023-01-11,1,Bed Number 1,98,26,72
2023-01-11,2,Bed Number 2,41,30,11
2023-01-11,3,Bed Number 3,63,26,37
2023-01-12,1,Bed Number 1,70,32,38
2023-01-12,2,Bed Number 2,76,61,15
2023-01-12,3,Bed Number 3,24,24,0
2023-01-13,1,Bed Number 1,60,38,22
2023-01-13,2,Bed Number 2,61,51,10
2023-01-13,3,Bed Number 3,96,46,50
2023-01-14,1,Bed Number 1,28,16,12
2023-01-14,2,Bed Number 2,29,17,12
2023-01-14,3,Bed Number 3,45,23,22
2023-01-15,1,Bed Number 1,58,1,57
2023-01-15,2,Bed Number 2,51,27,24
2023-01-15,3,Bed Number 3,56,53,3
2023-01-16,1,Bed Number 1,89,60,29
2023-01-16,2,Bed Number 2,33,23,10
2023-01-16,3,Bed Number 3,30,13,17
2023-01-17,1,Bed Number 1,45,30,15
2023-01-17,2,Bed Number 2,45,8,37
2023-01-17,3,Bed Number 3,32,5,27
2023-01-18,1,Bed Number 1,15,14,1
2023-01-18,2,Bed Number 2,84,40,44
2023-01-18,3,Bed Number 3,48,7,41
2023-01-19,1,Bed Number 1,43,42,1
2023-01-19,2,Bed Number 2,49,29,20
2023-01-19,3,Bed Number 3,40,35,5
2023-01-20,1,Bed Number 1,36,15,21
2023-01-20,2,Bed Number 2,19,10,9
2023-01-20,3,Bed Number 3,10,4,6
2023-01-21,1,Bed Number 1,13,8,5
2023-01-21,2,Bed Number 2,43,12,31
2023-01-21,3,Bed Number 3,55,11,44
2023-01-22,1,Bed Number 1,25,2,23
2023-01-22,2,Bed Number 2,36,9,27
2023-01-22,3,Bed Number 3,22,17,5
2023-01-23,1,Bed Number 1,57,57,0
2023-01-23,2,Bed Number 2,66,8,58
2023-01-23,3,Bed Number 3,46,24,22
2023-01-24,1,Bed Number 1,12,1,11
2023-01-24,2,Bed Number 2,16,5,11
2023-01-24,3,Bed Number 3,70,24,46
2023-01-25,1,Bed Number 1,10,7,3
2023-01-25,2,Bed Number 2,10,9,1
2023-01-25,3,Bed Number 3,42,29,13
2023-01-26,1,Bed Number 1,67,21,46
2023-01-26,2,Bed Number 2,16,4,12
2023-01-26,3,Bed Number 3,20,19,1
2023-01-27,1,Bed Number 1,50,37,13
2023-01-27,2,Bed Number 2,35,27,8
2023-01-27,3,Bed Number 3,22,11,11
2023-01-28,1,Bed Number 1,67,67,0
2023-01-28,2,Bed Number 2,32,25,7
2023-01-28,3,Bed Number 3,55,30,25
2023-01-29,1,Bed Number 1,54,12,42
2023-01-29,2,Bed Number 2,89,32,57
2023-01-29,3,Bed Number 3,60,52,8
2023-01-30,1,Bed Number 1,60,44,16
2023-01-30,2,Bed Number 2,74,38,36
2023-01-30,3,Bed Number 3,12,7,5
2023-01-31,1,Bed Number 1,60,16,44
2023-01-31,2,Bed Number 2,26,14,12
2023-01-31,3,Bed Number 3,97,16,81
2023-02-01,1,Bed Number 1,81,59,22
2023-02-01,2,Bed Number 2,82,32,50
2023-02-01,3,Bed Number 3,18,0,18
2023-02-02,1,Bed Number 1,17,5,12
2023-02-02,2,Bed Number 2,17,12,5
2023-02-02,3,Bed Number 3,43,26,17
2023-02-03,1,Bed Number 1,74,51,23
2023-02-03,2,Bed Number 2,23,4,19
2023-02-03,3,Bed Number 3,16,12,4
2023-02-04,1,Bed Number 1,11,9,2
2023-02-04,2,Bed Number 2,39,8,31
2023-02-04,3,Bed Number 3,91,75,16
2023-02-05,1,Bed Number 1,38,16,22
2023-02-05,2,Bed Number 2,64,0,64
2023-02-05,3,Bed Number 3,97,66,31
2023-02-06,1,Bed Number 1,46,15,31
2023-02-06,2,Bed Number 2,96,96,0
2023-02-06,3,Bed Number 3,53,45,8
2023-02-07,1,Bed Number 1,97,1,96
2023-02-07,2,Bed Number 2,67,13,54
2023-02-07,3,Bed Number 3,66,65,1
2023-02-08,1,Bed Number 1,66,1,65
2023-02-08,2,Bed Number 2,42,7,35
2023-02-08,3,Bed Number 3,51,49,2
2023-02-09,1,Bed Number 1,58,15,43
2023-02-09,2,Bed Number 2,56,34,22
2023-02-09,3,Bed Number 3,16,7,9
2023-02-10,1,Bed Number 1,67,50,17
2023-02-10,2,Bed Number 2,25,20,5
2023-02-10,3,Bed Number 3,93,59,34
2023-02-11,1,Bed Number 1,71,2,69
2023-02-11,2,Bed Number 2,31,0,31
2023-02-11,3,Bed Number 3,53,6,47
2023-02-12,1,Bed Number 1,11,3,8
2023-02-12,2,Bed Number 2,32,21,11
2023-02-12,3,Bed Number 3,33,6,27
2023-02-13,1,Bed Number 1,84,43,41
2023-02-13,2,Bed Number 2,96,23,73
2023-02-13,3,Bed Number 3,10,6,4
2023-02-14,1,Bed Number 1,24,6,18
2023-02-14,2,Bed Number 2,17,4,13
2023-02-14,3,Bed Number 3,51,19,32
2023-02-15,1,Bed Number 1,14,13,1
2023-02-15,2,Bed Number 2,71,24,47
2023-02-15,3,Bed Number 3,93,71,22
2023-02-16,1,Bed Number 1,94,23,71
2023-02-16,2,Bed Number 2,56,40,16
2023-02-16,3,Bed Number 3,64,13,51
2023-02-17,1,Bed Number 1,33,29,4
2023-02-17,2,Bed Number 2,97,71,26
2023-02-17,3,Bed Number 3,19,16,3
2023-02-18,1,Bed Number 1,12,7,5
2023-02-18,2,Bed Number 2,87,85,2
2023-02-18,3,Bed Number 3,85,4,81
2023-02-19,1,Bed Number 1,31,12,19
2023-02-19,2,Bed Number 2,69,18,51
2023-02-19,3,Bed Number 3,83,30,53
2023-02-20,1,Bed Number 1,27,9,18
2023-02-20,2,Bed Number 2,55,18,37
2023-02-20,3,Bed Number 3,71,10,61
2023-02-21,1,Bed Number 1,70,34,36
2023-02-21,2,Bed Number 2,28,16,12
2023-02-21,3,Bed Number 3,12,3,9
2023-02-22,1,Bed Number 1,94,38,56
2023-02-22,2,Bed Number 2,27,21,6
2023-02-22,3,Bed Number 3,37,34,3
2023-02-23,1,Bed Number 1,63,7,56
2023-02-23,2,Bed Number 2,73,1,72
2023-02-23,3,Bed Number 3,28,2,26
2023-02-24,1,Bed Number 1,17,2,15
2023-02-24,2,Bed Number 2,45,32,13
2023-02-24,3,Bed Number 3,30,15,15
2023-02-25,1,Bed Number 1,72,50,22
2023-02-25,2,Bed Number 2,56,5,51
2023-02-25,3,Bed Number 3,25,16,9
2023-02-26,1,Bed Number 1,94,87,7
2023-02-26,2,Bed Number 2,13,10,3
2023-02-26,3,Bed Number 3,33,33,0
2023-02-27,1,Bed Number 1,97,86,11
2023-02-27,2,Bed Number 2,29,6,23
2023-02-27,3,Bed Number 3,77,64,13
2023-02-28,1,Bed Number 1,81,55,26
2023-02-28,2,Bed Number 2,94,93,1
2023-02-28,3,Bed Number 3,63,21,42
2023-03-01,1,Bed Number 1,97,32,65
2023-03-01,2,Bed Number 2,44,12,32
2023-03-01,3,Bed Number 3,88,8,80
2023-03-02,1,Bed Number 1,35,21,14
2023-03-02,2,Bed Number 2,12,2,10
2023-03-02,3,Bed Number 3,78,48,30
2023-03-03,1,Bed Number 1,35,5,30
2023-03-03,2,Bed Number 2,30,15,15
2023-03-03,3,Bed Number 3,59,30,29
2023-03-04,1,Bed Number 1,83,81,2
2023-03-04,2,Bed Number 2,44,13,31
2023-03-04,3,Bed Number 3,57,0,57
2023-03-05,1,Bed Number 1,53,45,8
2023-03-05,2,Bed Number 2,18,12,6
2023-03-05,3,Bed Number 3,73,65,8
2023-03-06,1,Bed Number 1,94,46,48
2023-03-06,2,Bed Number 2,90,7,83
2023-03-06,3,Bed Number 3,99,49,50
2023-03-07,1,Bed Number 1,42,35,7
2023-03-07,2,Bed Number 2,81,4,77
2023-03-07,3,Bed Number 3,59,32,27
2023-03-08,1,Bed Number 1,51,48,3
2023-03-08,2,Bed Number 2,88,16,72
2023-03-08,3,Bed Number 3,84,82,2
2023-03-09,1,Bed Number 1,87,48,39
2023-03-09,2,Bed Number 2,16,2,14
2023-03-09,3,Bed Number 3,96,70,26
2023-03-10,1,Bed Number 1,76,48,28
2023-03-10,2,Bed Number 2,18,4,14
2023-03-10,3,Bed Number 3,60,24,36
2023-03-11,1,Bed Number 1,45,10,35
2023-03-11,2,Bed Number 2,42,34,8
2023-03-11,3,Bed Number 3,75,54,21
2023-03-12,1,Bed Number 1,56,27,29
2023-03-12,2,Bed Number 2,70,60,10
2023-03-12,3,Bed Number 3,16,11,5
2023-03-13,1,Bed Number 1,94,42,52
2023-03-13,2,Bed Number 2,33,26,7
2023-03-13,3,Bed Number 3,100,52,48
2023-03-14,1,Bed Number 1,80,73,7
2023-03-14,2,Bed Number 2,54,0,54
2023-03-14,3,Bed Number 3,15,1,14
2023-03-15,1,Bed Number 1,23,15,8
2023-03-15,2,Bed Number 2,96,92,4
2023-03-15,3,Bed Number 3,68,16,52
2023-03-16,1,Bed Number 1,44,20,24
2023-03-16,2,Bed Number 2,36,6,30
2023-03-16,3,Bed Number 3,68,37,31
2023-03-17,1,Bed Number 1,90,53,37
2023-03-17,2,Bed Number 2,90,89,1
2023-03-17,3,Bed Number 3,24,23,1
2023-03-18,1,Bed Number 1,86,20,66
2023-03-18,2,Bed Number 2,54,9,45
2023-03-18,3,Bed Number 3,46,37,9
2023-03-19,1,Bed Number 1,93,16,77
2023-03-19,2,Bed Number 2,52,27,25
2023-03-19,3,Bed Number 3,37,32,5
2023-03-20,1,Bed Number 1,99,48,51
2023-03-20,2,Bed Number 2,28,26,2
2023-03-20,3,Bed Number 3,29,7,22
2023-03-21,1,Bed Number 1,60,46,14
2023-03-21,2,Bed Number 2,48,10,38
2023-03-21,3,Bed Number 3,40,24,16
2023-03-22,1,Bed Number 1,42,20,22
2023-03-22,2,Bed Number 2,79,58,21
2023-03-22,3,Bed Number 3,76,36,40
2023-03-23,1,Bed Number 1,37,37,0
2023-03-23,2,Bed Number 2,87,15,72
2023-03-23,3,Bed Number 3,69,39,30
2023-03-24,1,Bed Number 1,31,18,13
2023-03-24,2,Bed Number 2,53,16,37
2023-03-24,3,Bed Number 3,93,14,79
2023-03-25,1,Bed Number 1,11,9,2
2023-03-25,2,Bed Number 2,94,41,53
2023-03-25,3,Bed Number 3,73,70,3
2023-03-26,1,Bed Number 1,71,32,39
2023-03-26,2,Bed Number 2,22,4,18
2023-03-26,3,Bed Number 3,24,21,3
2023-03-27,1,Bed Number 1,34,18,16
2023-03-27,2,Bed Number 2,77,15,62
2023-03-27,3,Bed Number 3,68,52,16
2023-03-28,1,Bed Number 1,32,11,21
2023-03-28,2,Bed Number 2,27,20,7
2023-03-28,3,Bed Number 3,32,22,10
2023-03-29,1,Bed Number 1,52,39,13
2023-03-29,2,Bed Number 2,22,13,9
2023-03-29,3,Bed Number 3,43,14,29
2023-03-30,1,Bed Number 1,29,16,13
2023-03-30,2,Bed Number 2,47,21,26
2023-03-30,3,Bed Number 3,19,15,4
2023-03-31,1,Bed Number 1,10,6,4
2023-03-31,2,Bed Number 2,71,45,26
2023-03-31,3,Bed Number 3,64,45,19
2023-04-01,1,Bed Number 1,92,43,49
2023-04-01,2,Bed Number 2,28,17,11
2023-04-01,3,Bed Number 3,10,8,2
2023-04-02,1,Bed Number 1,46,25,21
2023-04-02,2,Bed Number 2,22,14,8
2023-04-02,3,Bed Number 3,72,5,67
2023-04-03,1,Bed Number 1,46,22,24
2023-04-03,2,Bed Number 2,10,3,7
2023-04-03,3,Bed Number 3,91,90,1
2023-04-04,1,Bed Number 1,46,1,45
2023-04-04,2,Bed Number 2,83,12,71
2023-04-04,3,Bed Number 3,44,1,43
2023-04-05,1,Bed Number 1,33,20,13
2023-04-05,2,Bed Number 2,11,9,2
2023-04-05,3,Bed Number 3,86,60,26
2023-04-06,1,Bed Number 1,69,11,58
2023-04-06,2,Bed Number 2,39,33,6
2023-04-06,3,Bed Number 3,22,3,19
2023-04-07,1,Bed Number 1,44,40,4
2023-04-07,2,Bed Number 2,12,9,3
2023-04-07,3,Bed Number 3,21,7,14
2023-04-08,1,Bed Number 1,53,8,45
2023-04-08,2,Bed Number 2,52,48,4
2023-04-08,3,Bed Number 3,58,1,57
2023-04-09,1,Bed Number 1,79,17,62
2023-04-09,2,Bed Number 2,63,32,31
2023-04-09,3,Bed Number 3,69,40,29
2023-04-10,1,Bed Number 1,60,41,19
2023-04-10,2,Bed Number 2,46,36,10
2023-04-10,3,Bed Number 3,67,2,65
2023-04-11,1,Bed Number 1,65,15,50
2023-04-11,2,Bed Number 2,76,68,8
2023-04-11,3,Bed Number 3,48,8,40
2023-04-12,1,Bed Number 1,17,11,6
2023-04-12,2,Bed Number 2,14,14,0
2023-04-12,3,Bed Number 3,23,20,3
2023-04-13,1,Bed Number 1,46,2,44
2023-04-13,2,Bed Number 2,23,11,12
2023-04-13,3,Bed Number 3,85,80,5
2023-04-14,1,Bed Number 1,10,10,0
2023-04-14,2,Bed Number 2,27,26,1
2023-04-14,3,Bed Number 3,11,6,5
2023-04-15,1,Bed Number 1,77,69,8
2023-04-15,2,Bed Number 2,11,7,4
2023-04-15,3,Bed Number 3,22,22,0
2023-04-16,1,Bed Number 1,49,45,4
2023-04-16,2,Bed Number 2,52,27,25
2023-04-16,3,Bed Number 3,96,24,72
2023-04-17,1,Bed Number 1,16,2,14
2023-04-17,2,Bed Number 2,91,55,36
2023-04-17,3,Bed Number 3,53,36,17
2023-04-18,1,Bed Number 1,16,11,5
2023-04-18,2,Bed Number 2,38,17,21
2023-04-18,3,Bed Number 3,80,40,40
2023-04-19,1,Bed Number 1,33,10,23
2023-04-19,2,Bed Number 2,53,39,14
2023-04-19,3,Bed Number 3,75,52,23
2023-04-20,1,Bed Number 1,64,46,18
2023-04-20,2,Bed Number 2,20,4,16
2023-04-20,3,Bed Number 3,80,55,25
2023-04-21,1,Bed Number 1,86,35,51
2023-04-21,2,Bed Number 2,62,7,55
2023-04-21,3,Bed Number 3,93,89,4
2023-04-22,1,Bed Number 1,51,30,21
2023-04-22,2,Bed Number 2,43,21,22
2023-04-22,3,Bed Number 3,38,35,3
2023-04-23,1,Bed Number 1,39,16,23
2023-04-23,2,Bed Number 2,79,23,56
2023-04-23,3,Bed Number 3,37,10,27
2023-04-24,1,Bed Number 1,52,42,10
2023-04-24,2,Bed Number 2,84,61,23
2023-04-24,3,Bed Number 3,60,2,58
2023-04-25,1,Bed Number 1,54,7,47
2023-04-25,2,Bed Number 2,17,9,8
2023-04-25,3,Bed Number 3,77,76,1
2023-04-26,1,Bed Number 1,57,57,0
2023-04-26,2,Bed Number 2,17,8,9
2023-04-26,3,Bed Number 3,60,2,58
2023-04-27,1,Bed Number 1,36,24,12
2023-04-27,2,Bed Number 2,79,4,75
2023-04-27,3,Bed Number 3,34,24,10
2023-04-28,1,Bed Number 1,71,27,44
2023-04-28,2,Bed Number 2,83,61,22
2023-04-28,3,Bed Number 3,76,28,48
2023-04-29,1,Bed Number 1,89,60,29
2023-04-29,2,Bed Number 2,21,6,15
2023-04-29,3,Bed Number 3,76,2,74
2023-04-30,1,Bed Number 1,15,12,3
2023-04-30,2,Bed Number 2,38,2,36
2023-04-30,3,Bed Number 3,75,57,18
2023-05-01,1,Bed Number 1,99,80,19
2023-05-01,2,Bed Number 2,86,33,53
2023-05-01,3,Bed Number 3,30,14,16
2023-05-02,1,Bed Number 1,59,43,16
2023-05-02,2,Bed Number 2,16,9,7
2023-05-02,3,Bed Number 3,94,46,48
2023-05-03,1,Bed Number 1,31,25,6
2023-05-03,2,Bed Number 2,52,39,13
2023-05-03,3,Bed Number 3,78,49,29
2023-05-04,1,Bed Number 1,83,52,31
2023-05-04,2,Bed Number 2,18,13,5
2023-05-04,3,Bed Number 3,16,10,6
2023-05-05,1,Bed Number 1,39,30,9
2023-05-05,2,Bed Number 2,81,5,76
2023-05-05,3,Bed Number 3,26,7,19
2023-05-06,1,Bed Number 1,47,4,43
2023-05-06,2,Bed Number 2,38,15,23
2023-05-06,3,Bed Number 3,84,42,42
2023-05-07,1,Bed Number 1,65,28,37
2023-05-07,2,Bed Number 2,28,28,0
2023-05-07,3,Bed Number 3,29,28,1
2023-05-08,1,Bed Number 1,88,54,34
2023-05-08,2,Bed Number 2,57,21,36
2023-05-08,3,Bed Number 3,38,17,21
2023-05-09,1,Bed Number 1,55,12,43
2023-05-09,2,Bed Number 2,73,44,29
2023-05-09,3,Bed Number 3,16,9,7
2023-05-10,1,Bed Number 1,93,32,61
2023-05-10,2,Bed Number 2,73,15,58
2023-05-10,3,Bed Number 3,42,24,18
2023-05-11,1,Bed Number 1,73,11,62
2023-05-11,2,Bed Number 2,69,45,24
2023-05-11,3,Bed Number 3,57,11,46
2023-05-12,1,Bed Number 1,48,34,14
2023-05-12,2,Bed Number 2,84,83,1
2023-05-12,3,Bed Number 3,26,1,25
2023-05-13,1,Bed Number 1,99,1,98
2023-05-13,2,Bed Number 2,72,18,54
2023-05-13,3,Bed Number 3,51,8,43
2023-05-14,1,Bed Number 1,30,24,6
2023-05-14,2,Bed Number 2,88,53,35
2023-05-14,3,Bed Number 3,73,8,65
2023-05-15,1,Bed Number 1,58,6,52
2023-05-15,2,Bed Number 2,44,22,22
2023-05-15,3,Bed Number 3,33,15,18
2023-05-16,1,Bed Number 1,92,5,87
2023-05-16,2,Bed Number 2,15,3,12
2023-05-16,3,Bed Number 3,16,10,6
2023-05-17,1,Bed Number 1,89,14,75
2023-05-17,2,Bed Number 2,23,3,20
2023-05-17,3,Bed Number 3,46,30,16
2023-05-18,1,Bed Number 1,66,20,46
2023-05-18,2,Bed Number 2,37,15,22
2023-05-18,3,Bed Number 3,83,26,57
2023-05-19,1,Bed Number 1,90,67,23
2023-05-19,2,Bed Number 2,74,68,6
2023-05-19,3,Bed Number 3,67,45,22
2023-05-20,1,Bed Number 1,73,44,29
2023-05-20,2,Bed Number 2,54,39,15
2023-05-20,3,Bed Number 3,81,15,66
2023-05-21,1,Bed Number 1,52,47,5
2023-05-21,2,Bed Number 2,22,11,11
2023-05-21,3,Bed Number 3,86,82,4
2023-05-22,1,Bed Number 1,55,47,8
2023-05-22,2,Bed Number 2,19,13,6
2023-05-22,3,Bed Number 3,86,55,31
2023-05-23,1,Bed Number 1,78,73,5
2023-05-23,2,Bed Number 2,92,44,48
2023-05-23,3,Bed Number 3,53,15,38
2023-05-24,1,Bed Number 1,66,53,13
2023-05-24,2,Bed Number 2,11,8,3
2023-05-24,3,Bed Number 3,68,68,0
2023-05-25,1,Bed Number 1,77,44,33
2023-05-25,2,Bed Number 2,47,47,0
2023-05-25,3,Bed Number 3,88,7,81
2023-05-26,1,Bed Number 1,56,2,54
2023-05-26,2,Bed Number 2,12,5,7
2023-05-26,3,Bed Number 3,63,34,29
2023-05-27,1,Bed Number 1,24,21,3
2023-05-27,2,Bed Number 2,85,61,24
2023-05-27,3,Bed Number 3,42,37,5
2023-05-28,1,Bed Number 1,73,54,19
2023-05-28,2,Bed Number 2,55,49,6
2023-05-28,3,Bed Number 3,24,6,18
2023-05-29,1,Bed Number 1,34,26,8
2023-05-29,2,Bed Number 2,82,34,48
2023-05-29,3,Bed Number 3,45,39,6
2023-05-30,1,Bed Number 1,53,12,41
2023-05-30,2,Bed Number 2,52,15,37
2023-05-30,3,Bed Number 3,70,66,4
2023-05-31,1,Bed Number 1,64,17,47
2023-05-31,2,Bed Number 2,72,59,13
2023-05-31,3,Bed Number 3,58,0,58
2023-06-01,1,Bed Number 1,68,7,61
2023-06-01,2,Bed Number 2,58,26,32
2023-06-01,3,Bed Number 3,96,70,26
2023-06-02,1,Bed Number 1,62,7,55
2023-06-02,2,Bed Number 2,27,15,12
2023-06-02,3,Bed Number 3,98,12,86
2023-06-03,1,Bed Number 1,49,26,23
2023-06-03,2,Bed Number 2,51,44,7
2023-06-03,3,Bed Number 3,23,0,23
2023-06-04,1,Bed Number 1,99,91,8
2023-06-04,2,Bed Number 2,55,36,19
2023-06-04,3,Bed Number 3,11,11,0
2023-06-05,1,Bed Number 1,84,83,1
2023-06-05,2,Bed Number 2,41,5,36
2023-06-05,3,Bed Number 3,54,53,1
2023-06-06,1,Bed Number 1,83,43,40
2023-06-06,2,Bed Number 2,10,7,3
2023-06-06,3,Bed Number 3,63,55,8
2023-06-07,1,Bed Number 1,33,26,7
2023-06-07,2,Bed Number 2,73,16,57
2023-06-07,3,Bed Number 3,72,59,13
2023-06-08,1,Bed Number 1,25,10,15
2023-06-08,2,Bed Number 2,29,16,13
2023-06-08,3,Bed Number 3,68,35,33
2023-06-09,1,Bed Number 1,88,44,44
2023-06-09,2,Bed Number 2,92,3,89
2023-06-09,3,Bed Number 3,91,19,72
2023-06-10,1,Bed Number 1,97,72,25
2023-06-10,2,Bed Number 2,37,30,7
2023-06-10,3,Bed Number 3,97,47,50
2023-06-11,1,Bed Number 1,98,78,20
2023-06-11,2,Bed Number 2,30,5,25
2023-06-11,3,Bed Number 3,86,78,8
2023-06-12,1,Bed Number 1,92,42,50
2023-06-12,2,Bed Number 2,26,13,13
2023-06-12,3,Bed Number 3,82,51,31
2023-06-13,1,Bed Number 1,28,6,22
2023-06-13,2,Bed Number 2,90,32,58
2023-06-13,3,Bed Number 3,46,6,40
2023-06-14,1,Bed Number 1,34,32,2
2023-06-14,2,Bed Number 2,73,28,45
2023-06-14,3,Bed Number 3,100,97,3
2023-06-15,1,Bed Number 1,27,12,15
2023-06-15,2,Bed Number 2,99,52,47
2023-06-15,3,Bed Number 3,20,14,6
2023-06-16,1,Bed Number 1,76,11,65
2023-06-16,2,Bed Number 2,72,19,53
2023-06-16,3,Bed Number 3,46,28,18
2023-06-17,1,Bed Number 1,85,58,27
2023-06-17,2,Bed Number 2,49,36,13
2023-06-17,3,Bed Number 3,89,30,59
2023-06-18,1,Bed Number 1,51,0,51
2023-06-18,2,Bed Number 2,99,98,1
2023-06-18,3,Bed Number 3,91,85,6
2023-06-19,1,Bed Number 1,81,26,55
2023-06-19,2,Bed Number 2,63,60,3
2023-06-19,3,Bed Number 3,43,27,16
2023-06-20,1,Bed Number 1,69,9,60
2023-06-20,2,Bed Number 2,67,12,55
2023-06-20,3,Bed Number 3,83,31,52
2023-06-21,1,Bed Number 1,21,3,18
2023-06-21,2,Bed Number 2,36,3,33
2023-06-21,3,Bed Number 3,58,43,15
2023-06-22,1,Bed Number 1,22,7,15
2023-06-22,2,Bed Number 2,73,4,69
2023-06-22,3,Bed Number 3,38,32,6
2023-06-23,1,Bed Number 1,57,52,5
2023-06-23,2,Bed Number 2,98,19,79
2023-06-23,3,Bed Number 3,31,27,4
2023-06-24,1,Bed Number 1,37,11,26
2023-06-24,2,Bed Number 2,19,15,4
2023-06-24,3,Bed Number 3,32,18,14
2023-06-25,1,Bed Number 1,78,21,57
2023-06-25,2,Bed Number 2,75,2,73
2023-06-25,3,Bed Number 3,69,32,37
2023-06-26,1,Bed Number 1,76,61,15
2023-06-26,2,Bed Number 2,57,56,1
2023-06-26,3,Bed Number 3,95,12,83
2023-06-27,1,Bed Number 1,79,57,22
2023-06-27,2,Bed Number 2,35,22,13
2023-06-27,3,Bed Number 3,23,8,15
2023-06-28,1,Bed Number 1,70,43,27
2023-06-28,2,Bed Number 2,17,5,12
2023-06-28,3,Bed Number 3,73,14,59
2023-06-29,1,Bed Number 1,47,11,36
2023-06-29,2,Bed Number 2,93,43,50
2023-06-29,3,Bed Number 3,23,6,17
2023-06-30,1,Bed Number 1,33,1,32
2023-06-30,2,Bed Number 2,10,5,5
2023-06-30,3,Bed Number 3,64,64,0
2023-07-01,1,Bed Number 1,77,74,3
2023-07-01,2,Bed Number 2,45,34,11
2023-07-01,3,Bed Number 3,96,84,12
2023-07-02,1,Bed Number 1,99,58,41
2023-07-02,2,Bed Number 2,12,12,0
2023-07-02,3,Bed Number 3,10,0,10
2023-07-03,1,Bed Number 1,69,22,47
2023-07-03,2,Bed Number 2,29,5,24
2023-07-03,3,Bed Number 3,48,45,3
2023-07-04,1,Bed Number 1,32,22,10
2023-07-04,2,Bed Number 2,29,17,12
2023-07-04,3,Bed Number 3,45,21,24
2023-07-05,1,Bed Number 1,63,28,35
2023-07-05,2,Bed Number 2,72,15,57
2023-07-05,3,Bed Number 3,23,6,17
2023-07-06,1,Bed Number 1,22,8,14
2023-07-06,2,Bed Number 2,12,11,1
2023-07-06,3,Bed Number 3,42,32,10
2023-07-07,1,Bed Number 1,73,6,67
2023-07-07,2,Bed Number 2,79,79,0
2023-07-07,3,Bed Number 3,89,30,59
2023-07-08,1,Bed Number 1,45,5,40
2023-07-08,2,Bed Number 2,62,16,46
2023-07-08,3,Bed Number 3,24,1,23
2023-07-09,1,Bed Number 1,89,60,29
2023-07-09,2,Bed Number 2,57,40,17
2023-07-09,3,Bed Number 3,46,3,43
2023-07-10,1,Bed Number 1,51,46,5
2023-07-10,2,Bed Number 2,91,57,34
2023-07-10,3,Bed Number 3,78,33,45
2023-07-11,1,Bed Number 1,39,7,32
2023-07-11,2,Bed Number 2,73,6,67
2023-07-11,3,Bed Number 3,64,41,23
2023-07-12,1,Bed Number 1,77,53,24
2023-07-12,2,Bed Number 2,92,70,22
2023-07-12,3,Bed Number 3,10,10,0
2023-07-13,1,Bed Number 1,82,56,26
2023-07-13,2,Bed Number 2,51,19,32
2023-07-13,3,Bed Number 3,52,39,13
2023-07-14,1,Bed Number 1,80,11,69
2023-07-14,2,Bed Number 2,24,18,6
2023-07-14,3,Bed Number 3,55,42,13
2023-07-15,1,Bed Number 1,56,14,42
2023-07-15,2,Bed Number 2,72,10,62
2023-07-15,3,Bed Number 3,18,10,8
2023-07-16,1,Bed Number 1,32,1,31
2023-07-16,2,Bed Number 2,96,11,85
2023-07-16,3,Bed Number 3,18,16,2
2023-07-17,1,Bed Number 1,36,25,11
2023-07-17,2,Bed Number 2,40,38,2
2023-07-17,3,Bed Number 3,24,20,4
2023-07-18,1,Bed Number 1,40,20,20
2023-07-18,2,Bed Number 2,39,15,24
2023-07-18,3,Bed Number 3,62,16,46
2023-07-19,1,Bed Number 1,38,35,3
2023-07-19,2,Bed Number 2,36,23,13
2023-07-19,3,Bed Number 3,12,7,5
2023-07-20,1,Bed Number 1,87,83,4
2023-07-20,2,Bed Number 2,59,43,16
2023-07-20,3,Bed Number 3,22,16,6
2023-07-21,1,Bed Number 1,92,65,27
2023-07-21,2,Bed Number 2,16,12,4
2023-07-21,3,Bed Number 3,57,52,5
2023-07-22,1,Bed Number 1,23,10,13
2023-07-22,2,Bed Number 2,82,27,55
2023-07-22,3,Bed Number 3,67,28,39
2023-07-23,1,Bed Number 1,66,17,49
2023-07-23,2,Bed Number 2,13,6,7
2023-07-23,3,Bed Number 3,15,4,11
2023-07-24,1,Bed Number 1,87,28,59
2023-07-24,2,Bed Number 2,39,27,12
2023-07-24,3,Bed Number 3,60,13,47
2023-07-25,1,Bed Number 1,57,52,5
2023-07-25,2,Bed Number 2,72,51,21
2023-07-25,3,Bed Number 3,25,4,21
2023-07-26,1,Bed Number 1,51,37,14
2023-07-26,2,Bed Number 2,65,53,12
2023-07-26,3,Bed Number 3,62,12,50
2023-07-27,1,Bed Number 1,22,12,10
2023-07-27,2,Bed Number 2,12,1,11
2023-07-27,3,Bed Number 3,31,4,27
2023-07-28,1,Bed Number 1,87,13,74
2023-07-28,2,Bed Number 2,29,26,3
2023-07-28,3,Bed Number 3,100,34,66
2023-07-29,1,Bed Number 1,48,44,4
2023-07-29,2,Bed Number 2,62,24,38
2023-07-29,3,Bed Number 3,85,82,3
2023-07-30,1,Bed Number 1,91,90,1
2023-07-30,2,Bed Number 2,21,1,20
2023-07-30,3,Bed Number 3,21,10,11
2023-07-31,1,Bed Number 1,20,6,14
2023-07-31,2,Bed Number 2,39,11,28
2023-07-31,3,Bed Number 3,71,68,3
2023-08-01,1,Bed Number 1,83,34,49
2023-08-01,2,Bed Number 2,52,5,47
2023-08-01,3,Bed Number 3,66,5,61
2023-08-02,1,Bed Number 1,15,9,6
2023-08-02,2,Bed Number 2,70,68,2
2023-08-02,3,Bed Number 3,58,38,20
2023-08-03,1,Bed Number 1,79,38,41
2023-08-03,2,Bed Number 2,22,12,10
2023-08-03,3,Bed Number 3,68,30,38
2023-08-04,1,Bed Number 1,82,51,31
2023-08-04,2,Bed Number 2,56,22,34
2023-08-04,3,Bed Number 3,36,30,6
2023-08-05,1,Bed Number 1,45,29,16
2023-08-05,2,Bed Number 2,41,39,2
2023-08-05,3,Bed Number 3,40,33,7
2023-08-06,1,Bed Number 1,33,0,33
2023-08-06,2,Bed Number 2,80,23,57
2023-08-06,3,Bed Number 3,29,13,16
2023-08-07,1,Bed Number 1,17,2,15
2023-08-07,2,Bed Number 2,45,15,30
2023-08-07,3,Bed Number 3,80,42,38
2023-08-08,1,Bed Number 1,45,30,15
2023-08-08,2,Bed Number 2,91,74,17
2023-08-08,3,Bed Number 3,66,29,37
2023-08-09,1,Bed Number 1,57,17,40
2023-08-09,2,Bed Number 2,41,7,34
2023-08-09,3,Bed Number 3,80,21,59
2023-08-10,1,Bed Number 1,34,34,0
2023-08-10,2,Bed Number 2,14,10,4
2023-08-10,3,Bed Number 3,88,70,18
2023-08-11,1,Bed Number 1,60,18,42
2023-08-11,2,Bed Number 2,65,52,13
2023-08-11,3,Bed Number 3,38,4,34
2023-08-12,1,Bed Number 1,33,13,20
2023-08-12,2,Bed Number 2,78,9,69
2023-08-12,3,Bed Number 3,48,20,28
2023-08-13,1,Bed Number 1,16,16,0
2023-08-13,2,Bed Number 2,44,17,27
2023-08-13,3,Bed Number 3,63,53,10
2023-08-14,1,Bed Number 1,12,5,7
2023-08-14,2,Bed Number 2,77,74,3
2023-08-14,3,Bed Number 3,50,38,12
2023-08-15,1,Bed Number 1,85,82,3
2023-08-15,2,Bed Number 2,42,12,30
2023-08-15,3,Bed Number 3,16,2,14
2023-08-16,1,Bed Number 1,49,35,14
2023-08-16,2,Bed Number 2,47,19,28
2023-08-16,3,Bed Number 3,14,14,0
2023-08-17,1,Bed Number 1,86,45,41
2023-08-17,2,Bed Number 2,70,24,46
2023-08-17,3,Bed Number 3,61,13,48
2023-08-18,1,Bed Number 1,55,17,38
2023-08-18,2,Bed Number 2,11,11,0
2023-08-18,3,Bed Number 3,95,66,29
2023-08-19,1,Bed Number 1,71,15,56
2023-08-19,2,Bed Number 2,33,18,15
2023-08-19,3,Bed Number 3,24,16,8
2023-08-20,1,Bed Number 1,31,4,27
2023-08-20,2,Bed Number 2,60,26,34
2023-08-20,3,Bed Number 3,52,50,2
2023-08-21,1,Bed Number 1,89,1,88
2023-08-21,2,Bed Number 2,100,18,82
2023-08-21,3,Bed Number 3,35,29,6
2023-08-22,1,Bed Number 1,35,8,27
2023-08-22,2,Bed Number 2,39,7,32
2023-08-22,3,Bed Number 3,62,1,61
2023-08-23,1,Bed Number 1,78,35,43
2023-08-23,2,Bed Number 2,51,37,14
2023-08-23,3,Bed Number 3,90,75,15
2023-08-24,1,Bed Number 1,61,1,60
2023-08-24,2,Bed Number 2,29,0,29
2023-08-24,3,Bed Number 3,30,6,24
2023-08-25,1,Bed Number 1,45,30,15
2023-08-25,2,Bed Number 2,55,38,17
2023-08-25,3,Bed Number 3,48,21,27
2023-08-26,1,Bed Number 1,21,11,10
2023-08-26,2,Bed Number 2,44,10,34
2023-08-26,3,Bed Number 3,97,50,47
2023-08-27,1,Bed Number 1,44,1,43
2023-08-27,2,Bed Number 2,71,23,48
2023-08-27,3,Bed Number 3,97,86,11
2023-08-28,1,Bed Number 1,88,25,63
2023-08-28,2,Bed Number 2,11,3,8
2023-08-28,3,Bed Number 3,84,68,16
2023-08-29,1,Bed Number 1,32,21,11
2023-08-29,2,Bed Number 2,50,39,11
2023-08-29,3,Bed Number 3,35,22,13
2023-08-30,1,Bed Number 1,60,55,5
2023-08-30,2,Bed Number 2,62,56,6
2023-08-30,3,Bed Number 3,43,38,5
2023-08-31,1,Bed Number 1,82,61,21
2023-08-31,2,Bed Number 2,17,5,12
2023-08-31,3,Bed Number 3,58,13,45
2023-09-01,1,Bed Number 1,46,39,7
2023-09-01,2,Bed Number 2,10,7,3
2023-09-01,3,Bed Number 3,24,11,13
2023-09-02,1,Bed Number 1,51,15,36
2023-09-02,2,Bed Number 2,65,34,31
2023-09-02,3,Bed Number 3,56,14,42
2023-09-03,1,Bed Number 1,92,73,19
2023-09-03,2,Bed Number 2,19,16,3
2023-09-03,3,Bed Number 3,15,13,2
2023-09-04,1,Bed Number 1,65,12,53
2023-09-04,2,Bed Number 2,89,6,83
2023-09-04,3,Bed Number 3,85,84,1
2023-09-05,1,Bed Number 1,78,52,26
2023-09-05,2,Bed Number 2,59,57,2
2023-09-05,3,Bed Number 3,61,49,12
2023-09-06,1,Bed Number 1,31,19,12
2023-09-06,2,Bed Number 2,87,70,17
2023-09-06,3,Bed Number 3,54,7,47
2023-09-07,1,Bed Number 1,99,73,26
2023-09-07,2,Bed Number 2,71,44,27
2023-09-07,3,Bed Number 3,20,1,19
2023-09-08,1,Bed Number 1,35,19,16
2023-09-08,2,Bed Number 2,67,11,56
2023-09-08,3,Bed Number 3,16,14,2
2023-09-09,1,Bed Number 1,75,57,18
2023-09-09,2,Bed Number 2,66,26,40
2023-09-09,3,Bed Number 3,96,58,38
2023-09-10,1,Bed Number 1,45,26,19
2023-09-10,2,Bed Number 2,62,29,33
2023-09-10,3,Bed Number 3,56,47,9
2023-09-11,1,Bed Number 1,49,46,3
2023-09-11,2,Bed Number 2,17,14,3
2023-09-11,3,Bed Number 3,26,4,22
2023-09-12,1,Bed Number 1,15,14,1
2023-09-12,2,Bed Number 2,81,46,35
2023-09-12,3,Bed Number 3,60,12,48
2023-09-13,1,Bed Number 1,80,24,56
2023-09-13,2,Bed Number 2,17,3,14
2023-09-13,3,Bed Number 3,68,38,30
2023-09-14,1,Bed Number 1,66,55,11
2023-09-14,2,Bed Number 2,92,25,67
2023-09-14,3,Bed Number 3,98,42,56
2023-09-15,1,Bed Number 1,84,68,16
2023-09-15,2,Bed Number 2,22,22,0
2023-09-15,3,Bed Number 3,42,3,39
2023-09-16,1,Bed Number 1,26,8,18
2023-09-16,2,Bed Number 2,77,2,75
2023-09-16,3,Bed Number 3,70,61,9
2023-09-17,1,Bed Number 1,52,37,15
2023-09-17,2,Bed Number 2,26,11,15
2023-09-17,3,Bed Number 3,76,7,69
2023-09-18,1,Bed Number 1,36,30,6
2023-09-18,2,Bed Number 2,60,53,7
2023-09-18,3,Bed Number 3,94,52,42
2023-09-19,1,Bed Number 1,96,19,77
2023-09-19,2,Bed Number 2,42,35,7
2023-09-19,3,Bed Number 3,42,20,22
2023-09-20,1,Bed Number 1,98,26,72
2023-09-20,2,Bed Number 2,76,62,14
2023-09-20,3,Bed Number 3,82,6,76
2023-09-21,1,Bed Number 1,36,13,23
2023-09-21,2,Bed Number 2,75,28,47
2023-09-21,3,Bed Number 3,33,16,17
2023-09-22,1,Bed Number 1,26,3,23
2023-09-22,2,Bed Number 2,58,28,30
2023-09-22,3,Bed Number 3,34,3,31
2023-09-23,1,Bed Number 1,73,19,54
2023-09-23,2,Bed Number 2,86,29,57
2023-09-23,3,Bed Number 3,16,8,8
2023-09-24,1,Bed Number 1,59,38,21
2023-09-24,2,Bed Number 2,11,6,5
2023-09-24,3,Bed Number 3,60,14,46
2023-09-25,1,Bed Number 1,12,11,1
2023-09-25,2,Bed Number 2,40,40,0
2023-09-25,3,Bed Number 3,28,20,8
2023-09-26,1,Bed Number 1,78,17,61
2023-09-26,2,Bed Number 2,10,6,4
2023-09-26,3,Bed Number 3,87,41,46
2023-09-27,1,Bed Number 1,29,16,13
2023-09-27,2,Bed Number 2,48,19,29
2023-09-27,3,Bed Number 3,74,6,68
2023-09-28,1,Bed Number 1,22,4,18
2023-09-28,2,Bed Number 2,96,60,36
2023-09-28,3,Bed Number 3,84,69,15
2023-09-29,1,Bed Number 1,94,16,78
2023-09-29,2,Bed Number 2,32,24,8
2023-09-29,3,Bed Number 3,21,19,2
2023-09-30,1,Bed Number 1,95,21,74
2023-09-30,2,Bed Number 2,100,39,61
2023-09-30,3,Bed Number 3,34,16,18
2023-10-01,1,Bed Number 1,61,11,50
2023-10-01,2,Bed Number 2,14,1,13
2023-10-01,3,Bed Number 3,65,65,0
2023-10-02,1,Bed Number 1,20,13,7
2023-10-02,2,Bed Number 2,93,10,83
2023-10-02,3,Bed Number 3,89,25,64
2023-10-03,1,Bed Number 1,68,8,60
2023-10-03,2,Bed Number 2,17,1,16
2023-10-03,3,Bed Number 3,65,13,52
2023-10-04,1,Bed Number 1,92,52,40
2023-10-04,2,Bed Number 2,25,24,1
2023-10-04,3,Bed Number 3,31,0,31
2023-10-05,1,Bed Number 1,60,26,34
2023-10-05,2,Bed Number 2,80,10,70
2023-10-05,3,Bed Number 3,96,5,91
2023-10-06,1,Bed Number 1,49,0,49
2023-10-06,2,Bed Number 2,50,46,4
2023-10-06,3,Bed Number 3,89,82,7
2023-10-07,1,Bed Number 1,58,18,40
2023-10-07,2,Bed Number 2,12,5,7
2023-10-07,3,Bed Number 3,28,2,26
2023-10-08,1,Bed Number 1,54,53,1
2023-10-08,2,Bed Number 2,51,35,16
2023-10-08,3,Bed Number 3,41,4,37
2023-10-09,1,Bed Number 1,15,6,9
2023-10-09,2,Bed Number 2,74,51,23
2023-10-09,3,Bed Number 3,12,6,6
2023-10-10,1,Bed Number 1,90,56,34
2023-10-10,2,Bed Number 2,35,20,15
2023-10-10,3,Bed Number 3,46,34,12
2023-10-11,1,Bed Number 1,86,54,32
2023-10-11,2,Bed Number 2,19,4,15
2023-10-11,3,Bed Number 3,81,27,54
2023-10-12,1,Bed Number 1,19,2,17
2023-10-12,2,Bed Number 2,48,44,4
2023-10-12,3,Bed Number 3,51,42,9
2023-10-13,1,Bed Number 1,22,22,0
2023-10-13,2,Bed Number 2,92,36,56
2023-10-13,3,Bed Number 3,94,32,62
2023-10-14,1,Bed Number 1,87,44,43
2023-10-14,2,Bed Number 2,60,42,18
2023-10-14,3,Bed Number 3,25,22,3
2023-10-15,1,Bed Number 1,70,49,21
2023-10-15,2,Bed Number 2,21,15,6
2023-10-15,3,Bed Number 3,32,21,11
2023-10-16,1,Bed Number 1,78,5,73
2023-10-16,2,Bed Number 2,78,21,57
2023-10-16,3,Bed Number 3,100,10,90
2023-10-17,1,Bed Number 1,73,61,12
2023-10-17,2,Bed Number 2,100,7,93
2023-10-17,3,Bed Number 3,61,12,49
2023-10-18,1,Bed Number 1,18,13,5
2023-10-18,2,Bed Number 2,53,21,32
2023-10-18,3,Bed Number 3,87,29,58
2023-10-19,1,Bed Number 1,84,3,81
2023-10-19,2,Bed Number 2,53,10,43
2023-10-19,3,Bed Number 3,66,5,61
2023-10-20,1,Bed Number 1,17,16,1
2023-10-20,2,Bed Number 2,75,47,28
2023-10-20,3,Bed Number 3,47,31,16
2023-10-21,1,Bed Number 1,34,14,20
2023-10-21,2,Bed Number 2,91,51,40
2023-10-21,3,Bed Number 3,78,48,30
2023-10-22,1,Bed Number 1,26,3,23
2023-10-22,2,Bed Number 2,54,27,27
2023-10-22,3,Bed Number 3,32,18,14
2023-10-23,1,Bed Number 1,45,37,8
2023-10-23,2,Bed Number 2,43,36,7
2023-10-23,3,Bed Number 3,24,19,5
2023-10-24,1,Bed Number 1,33,25,8
2023-10-24,2,Bed Number 2,74,7,67
2023-10-24,3,Bed Number 3,65,20,45
2023-10-25,1,Bed Number 1,61,21,40
2023-10-25,2,Bed Number 2,80,38,42
2023-10-25,3,Bed Number 3,36,19,17
2023-10-26,1,Bed Number 1,98,3,95
2023-10-26,2,Bed Number 2,35,3,32
2023-10-26,3,Bed Number 3,62,30,32
2023-10-27,1,Bed Number 1,97,44,53
2023-10-27,2,Bed Number 2,89,37,52
2023-10-27,3,Bed Number 3,72,65,7
2023-10-28,1,Bed Number 1,21,6,15
2023-10-28,2,Bed Number 2,30,17,13
2023-10-28,3,Bed Number 3,20,1,19
2023-10-29,1,Bed Number 1,96,59,37
2023-10-29,2,Bed Number 2,24,13,11
2023-10-29,3,Bed Number 3,87,53,34
2023-10-30,1,Bed Number 1,75,30,45
2023-10-30,2,Bed Number 2,35,6,29
2023-10-30,3,Bed Number 3,50,1,49
2023-10-31,1,Bed Number 1,13,4,9
2023-10-31,2,Bed Number 2,77,12,65
2023-10-31,3,Bed Number 3,64,7,57
2023-11-01,1,Bed Number 1,38,22,16
2023-11-01,2,Bed Number 2,21,0,21
2023-11-01,3,Bed Number 3,21,18,3
2023-11-02,1,Bed Number 1,38,31,7
2023-11-02,2,Bed Number 2,40,28,12
2023-11-02,3,Bed Number 3,99,60,39
2023-11-03,1,Bed Number 1,89,35,54
2023-11-03,2,Bed Number 2,38,21,17
2023-11-03,3,Bed Number 3,18,15,3
2023-11-04,1,Bed Number 1,46,14,32
2023-11-04,2,Bed Number 2,81,11,70
2023-11-04,3,Bed Number 3,45,12,33
2023-11-05,1,Bed Number 1,10,7,3
2023-11-05,2,Bed Number 2,20,12,8
2023-11-05,3,Bed Number 3,17,12,5
2023-11-06,1,Bed Number 1,98,36,62
2023-11-06,2,Bed Number 2,39,19,20
2023-11-06,3,Bed Number 3,13,0,13
2023-11-07,1,Bed Number 1,75,59,16
2023-11-07,2,Bed Number 2,43,15,28
2023-11-07,3,Bed Number 3,88,68,20
2023-11-08,1,Bed Number 1,64,57,7
2023-11-08,2,Bed Number 2,35,28,7
2023-11-08,3,Bed Number 3,11,1,10
2023-11-09,1,Bed Number 1,75,64,11
2023-11-09,2,Bed Number 2,91,84,7
2023-11-09,3,Bed Number 3,70,53,17
2023-11-10,1,Bed Number 1,76,28,48
2023-11-10,2,Bed Number 2,94,43,51
2023-11-10,3,Bed Number 3,54,41,13
2023-11-11,1,Bed Number 1,36,2,34
2023-11-11,2,Bed Number 2,93,55,38
2023-11-11,3,Bed Number 3,36,21,15
2023-11-12,1,Bed Number 1,75,1,74
2023-11-12,2,Bed Number 2,56,42,14
2023-11-12,3,Bed Number 3,86,81,5
2023-11-13,1,Bed Number 1,71,6,65
2023-11-13,2,Bed Number 2,24,16,8
2023-11-13,3,Bed Number 3,77,65,12
2023-11-14,1,Bed Number 1,17,16,1
2023-11-14,2,Bed Number 2,70,22,48
2023-11-14,3,Bed Number 3,27,27,0
2023-11-15,1,Bed Number 1,69,15,54
2023-11-15,2,Bed Number 2,55,38,17
2023-11-15,3,Bed Number 3,76,21,55
2023-11-16,1,Bed Number 1,65,1,64
2023-11-16,2,Bed Number 2,23,1,22
2023-11-16,3,Bed Number 3,35,6,29
2023-11-17,1,Bed Number 1,43,42,1
2023-11-17,2,Bed Number 2,98,51,47
2023-11-17,3,Bed Number 3,80,44,36
2023-11-18,1,Bed Number 1,34,30,4
2023-11-18,2,Bed Number 2,15,3,12
2023-11-18,3,Bed Number 3,63,63,0
2023-11-19,1,Bed Number 1,64,4,60
2023-11-19,2,Bed Number 2,22,3,19
2023-11-19,3,Bed Number 3,98,55,43
2023-11-20,1,Bed Number 1,49,9,40
2023-11-20,2,Bed Number 2,100,73,27
2023-11-20,3,Bed Number 3,69,5,64
2023-11-21,1,Bed Number 1,23,14,9
2023-11-21,2,Bed Number 2,88,66,22
2023-11-21,3,Bed Number 3,12,6,6
2023-11-22,1,Bed Number 1,88,37,51
2023-11-22,2,Bed Number 2,91,30,61
2023-11-22,3,Bed Number 3,34,32,2
2023-11-23,1,Bed Number 1,50,48,2
2023-11-23,2,Bed Number 2,82,23,59
2023-11-23,3,Bed Number 3,45,35,10
2023-11-24,1,Bed Number 1,16,6,10
2023-11-24,2,Bed Number 2,65,16,49
2023-11-24,3,Bed Number 3,99,58,41
2023-11-25,1,Bed Number 1,72,0,72
2023-11-25,2,Bed Number 2,90,33,57
2023-11-25,3,Bed Number 3,16,4,12
2023-11-26,1,Bed Number 1,60,40,20
2023-11-26,2,Bed Number 2,46,43,3
2023-11-26,3,Bed Number 3,85,27,58
2023-11-27,1,Bed Number 1,76,43,33
2023-11-27,2,Bed Number 2,47,29,18
2023-11-27,3,Bed Number 3,96,24,72
2023-11-28,1,Bed Number 1,31,12,19
2023-11-28,2,Bed Number 2,30,2,28
2023-11-28,3,Bed Number 3,98,9,89
2023-11-29,1,Bed Number 1,91,30,61
2023-11-29,2,Bed Number 2,18,9,9
2023-11-29,3,Bed Number 3,61,39,22
2023-11-30,1,Bed Number 1,66,65,1
2023-11-30,2,Bed Number 2,73,13,60
2023-11-30,3,Bed Number 3,32,20,12
2023-12-01,1,Bed Number 1,24,0,24
2023-12-01,2,Bed Number 2,28,18,10
2023-12-01,3,Bed Number 3,19,12,7
2023-12-02,1,Bed Number 1,46,14,32
2023-12-02,2,Bed Number 2,44,42,2
2023-12-02,3,Bed Number 3,68,47,21
2023-12-03,1,Bed Number 1,56,33,23
2023-12-03,2,Bed Number 2,62,26,36
2023-12-03,3,Bed Number 3,96,77,19
2023-12-04,1,Bed Number 1,51,40,11
2023-12-04,2,Bed Number 2,72,10,62
2023-12-04,3,Bed Number 3,70,14,56
2023-12-05,1,Bed Number 1,31,15,16
2023-12-05,2,Bed Number 2,27,22,5
2023-12-05,3,Bed Number 3,74,8,66
2023-12-06,1,Bed Number 1,26,15,11
2023-12-06,2,Bed Number 2,20,16,4
2023-12-06,3,Bed Number 3,99,92,7
2023-12-07,1,Bed Number 1,31,15,16
2023-12-07,2,Bed Number 2,19,7,12
2023-12-07,3,Bed Number 3,61,19,42
2023-12-08,1,Bed Number 1,62,23,39
2023-12-08,2,Bed Number 2,25,11,14
2023-12-08,3,Bed Number 3,19,5,14
2023-12-09,1,Bed Number 1,92,36,56
2023-12-09,2,Bed Number 2,10,2,8
2023-12-09,3,Bed Number 3,64,60,4
2023-12-10,1,Bed Number 1,33,31,2
2023-12-10,2,Bed Number 2,36,7,29
2023-12-10,3,Bed Number 3,42,12,30
2023-12-11,1,Bed Number 1,24,22,2
2023-12-11,2,Bed Number 2,100,49,51
2023-12-11,3,Bed Number 3,87,45,42
2023-12-12,1,Bed Number 1,74,32,42
2023-12-12,2,Bed Number 2,21,17,4
2023-12-12,3,Bed Number 3,45,43,2
2023-12-13,1,Bed Number 1,89,20,69
2023-12-13,2,Bed Number 2,19,14,5
2023-12-13,3,Bed Number 3,70,59,11
2023-12-14,1,Bed Number 1,47,16,31
2023-12-14,2,Bed Number 2,73,31,42
2023-12-14,3,Bed Number 3,17,14,3
2023-12-15,1,Bed Number 1,72,67,5
2023-12-15,2,Bed Number 2,92,29,63
2023-12-15,3,Bed Number 3,86,24,62
2023-12-16,1,Bed Number 1,13,0,13
2023-12-16,2,Bed Number 2,79,52,27
2023-12-16,3,Bed Number 3,38,23,15
2023-12-17,1,Bed Number 1,93,38,55
2023-12-17,2,Bed Number 2,96,87,9
2023-12-17,3,Bed Number 3,27,11,16
2023-12-18,1,Bed Number 1,26,13,13
2023-12-18,2,Bed Number 2,60,58,2
2023-12-18,3,Bed Number 3,85,83,2
2023-12-19,1,Bed Number 1,82,1,81
2023-12-19,2,Bed Number 2,29,20,9
2023-12-19,3,Bed Number 3,91,30,61
2023-12-20,1,Bed Number 1,84,62,22
2023-12-20,2,Bed Number 2,38,10,28
2023-12-20,3,Bed Number 3,25,15,10
2023-12-21,1,Bed Number 1,59,58,1
2023-12-21,2,Bed Number 2,49,0,49
2023-12-21,3,Bed Number 3,73,52,21
2023-12-22,1,Bed Number 1,48,5,43
2023-12-22,2,Bed Number 2,97,47,50
2023-12-22,3,Bed Number 3,76,4,72
2023-12-23,1,Bed Number 1,64,4,60
2023-12-23,2,Bed Number 2,13,13,0
2023-12-23,3,Bed Number 3,25,8,17
2023-12-24,1,Bed Number 1,41,22,19
2023-12-24,2,Bed Number 2,69,8,61
2023-12-24,3,Bed Number 3,23,21,2
2023-12-25,1,Bed Number 1,51,22,29
2023-12-25,2,Bed Number 2,32,19,13
2023-12-25,3,Bed Number 3,60,31,29
2023-12-26,1,Bed Number 1,50,42,8
2023-12-26,2,Bed Number 2,59,40,19
2023-12-26,3,Bed Number 3,53,53,0
2023-12-27,1,Bed Number 1,54,39,15
2023-12-27,2,Bed Number 2,78,38,40
2023-12-27,3,Bed Number 3,42,0,42
2023-12-28,1,Bed Number 1,16,2,14
2023-12-28,2,Bed Number 2,86,7,79
2023-12-28,3,Bed Number 3,22,13,9
2023-12-29,1,Bed Number 1,97,79,18
2023-12-29,2,Bed Number 2,44,8,36
2023-12-29,3,Bed Number 3,11,7,4
2023-12-30,1,Bed Number 1,78,25,53
2023-12-30,2,Bed Number 2,52,22,30
2023-12-30,3,Bed Number 3,71,55,16
2023-12-31,1,Bed Number 1,72,55,17
2023-12-31,2,Bed Number 2,29,22,7
2023-12-31,3,Bed Number 3,55,41,14
2024-01-01,1,Bed Number 1,69,38,31
2024-01-01,2,Bed Number 2,41,4,37
2024-01-01,3,Bed Number 3,93,72,21
2024-01-02,1,Bed Number 1,38,34,4
2024-01-02,2,Bed Number 2,30,4,26
2024-01-02,3,Bed Number 3,64,59,5
2024-01-03,1,Bed Number 1,26,24,2
2024-01-03,2,Bed Number 2,98,35,63
2024-01-03,3,Bed Number 3,10,7,3
2024-01-04,1,Bed Number 1,53,33,20
2024-01-04,2,Bed Number 2,63,10,53
2024-01-04,3,Bed Number 3,52,43,9
2024-01-05,1,Bed Number 1,20,14,6
2024-01-05,2,Bed Number 2,43,36,7
2024-01-05,3,Bed Number 3,98,88,10
2024-01-06,1,Bed Number 1,22,5,17
2024-01-06,2,Bed Number 2,45,2,43
2024-01-06,3,Bed Number 3,35,9,26
2024-01-07,1,Bed Number 1,70,22,48
2024-01-07,2,Bed Number 2,60,49,11
2024-01-07,3,Bed Number 3,85,75,10
2024-01-08,1,Bed Number 1,78,24,54
2024-01-08,2,Bed Number 2,98,75,23
2024-01-08,3,Bed Number 3,57,40,17
2024-01-09,1,Bed Number 1,75,1,74
2024-01-09,2,Bed Number 2,47,30,17
2024-01-09,3,Bed Number 3,29,10,19
2024-01-10,1,Bed Number 1,38,25,13
2024-01-10,2,Bed Number 2,78,25,53
2024-01-10,3,Bed Number 3,59,15,44
2024-01-11,1,Bed Number 1,80,49,31
2024-01-11,2,Bed Number 2,100,70,30
2024-01-11,3,Bed Number 3,15,1,14
2024-01-12,1,Bed Number 1,59,45,14
2024-01-12,2,Bed Number 2,30,14,16
2024-01-12,3,Bed Number 3,59,11,48
2024-01-13,1,Bed Number 1,86,37,49
2024-01-13,2,Bed Number 2,88,2,86
2024-01-13,3,Bed Number 3,63,22,41
2024-01-14,1,Bed Number 1,51,28,23
2024-01-14,2,Bed Number 2,12,9,3
2024-01-14,3,Bed Number 3,77,2,75
2024-01-15,1,Bed Number 1,26,15,11
2024-01-15,2,Bed Number 2,29,9,20
2024-01-15,3,Bed Number 3,47,18,29
2024-01-16,1,Bed Number 1,27,2,25
2024-01-16,2,Bed Number 2,19,4,15
2024-01-16,3,Bed Number 3,98,2,96
2024-01-17,1,Bed Number 1,84,19,65
2024-01-17,2,Bed Number 2,29,10,19
2024-01-17,3,Bed Number 3,95,10,85
2024-01-18,1,Bed Number 1,43,13,30
2024-01-18,2,Bed Number 2,72,29,43
2024-01-18,3,Bed Number 3,97,37,60
2024-01-19,1,Bed Number 1,18,5,13
2024-01-19,2,Bed Number 2,90,7,83
2024-01-19,3,Bed Number 3,40,39,1
2024-01-20,1,Bed Number 1,37,30,7
2024-01-20,2,Bed Number 2,64,25,39
2024-01-20,3,Bed Number 3,76,29,47
2024-01-21,1,Bed Number 1,63,42,21
2024-01-21,2,Bed Number 2,49,25,24
2024-01-21,3,Bed Number 3,33,15,18
2024-01-22,1,Bed Number 1,42,42,0
2024-01-22,2,Bed Number 2,89,33,56
2024-01-22,3,Bed Number 3,68,50,18
2024-01-23,1,Bed Number 1,91,55,36
2024-01-23,2,Bed Number 2,75,72,3
2024-01-23,3,Bed Number 3,17,12,5
2024-01-24,1,Bed Number 1,90,42,48
2024-01-24,2,Bed Number 2,100,60,40
2024-01-24,3,Bed Number 3,57,53,4
2024-01-25,1,Bed Number 1,95,39,56
2024-01-25,2,Bed Number 2,28,8,20
2024-01-25,3,Bed Number 3,78,47,31
2024-01-26,1,Bed Number 1,15,11,4
2024-01-26,2,Bed Number 2,62,27,35
2024-01-26,3,Bed Number 3,73,50,23
2024-01-27,1,Bed Number 1,34,31,3
2024-01-27,2,Bed Number 2,48,10,38
2024-01-27,3,Bed Number 3,21,7,14
2024-01-28,1,Bed Number 1,85,56,29
2024-01-28,2,Bed Number 2,19,10,9
2024-01-28,3,Bed Number 3,100,50,50
2024-01-29,1,Bed Number 1,89,77,12
2024-01-29,2,Bed Number 2,45,36,9
2024-01-29,3,Bed Number 3,29,27,2
2024-01-30,1,Bed Number 1,12,6,6
2024-01-30,2,Bed Number 2,28,21,7
2024-01-30,3,Bed Number 3,97,90,7
2024-01-31,1,Bed Number 1,91,87,4
2024-01-31,2,Bed Number 2,38,7,31
2024-01-31,3,Bed Number 3,85,76,9
2024-02-01,1,Bed Number 1,23,10,13
2024-02-01,2,Bed Number 2,24,19,5
2024-02-01,3,Bed Number 3,66,26,40
2024-02-02,1,Bed Number 1,94,58,36
2024-02-02,2,Bed Number 2,87,20,67
2024-02-02,3,Bed Number 3,78,77,1
2024-02-03,1,Bed Number 1,59,35,24
2024-02-03,2,Bed Number 2,71,48,23
2024-02-03,3,Bed Number 3,10,9,1
2024-02-04,1,Bed Number 1,80,4,76
2024-02-04,2,Bed Number 2,24,3,21
2024-02-04,3,Bed Number 3,23,20,3
2024-02-05,1,Bed Number 1,40,27,13
2024-02-05,2,Bed Number 2,84,80,4
2024-02-05,3,Bed Number 3,63,38,25
2024-02-06,1,Bed Number 1,16,7,9
2024-02-06,2,Bed Number 2,22,1,21
2024-02-06,3,Bed Number 3,85,11,74
2024-02-07,1,Bed Number 1,52,39,13
2024-02-07,2,Bed Number 2,84,64,20
2024-02-07,3,Bed Number 3,71,35,36
2024-02-08,1,Bed Number 1,34,24,10
2024-02-08,2,Bed Number 2,39,34,5
2024-02-08,3,Bed Number 3,36,11,25
2024-02-09,1,Bed Number 1,12,5,7
2024-02-09,2,Bed Number 2,98,92,6
2024-02-09,3,Bed Number 3,94,39,55
2024-02-10,1,Bed Number 1,84,74,10
2024-02-10,2,Bed Number 2,97,44,53
2024-02-10,3,Bed Number 3,39,8,31
2024-02-11,1,Bed Number 1,59,32,27
2024-02-11,2,Bed Number 2,73,61,12
2024-02-11,3,Bed Number 3,68,64,4
2024-02-12,1,Bed Number 1,94,18,76
2024-02-12,2,Bed Number 2,74,15,59
2024-02-12,3,Bed Number 3,33,17,16
2024-02-13,1,Bed Number 1,73,29,44
2024-02-13,2,Bed Number 2,98,94,4
2024-02-13,3,Bed Number 3,66,57,9
2024-02-14,1,Bed Number 1,55,12,43
2024-02-14,2,Bed Number 2,51,33,18
2024-02-14,3,Bed Number 3,91,12,79
2024-02-15,1,Bed Number 1,55,38,17
2024-02-15,2,Bed Number 2,51,32,19
2024-02-15,3,Bed Number 3,40,12,28
2024-02-16,1,Bed Number 1,53,48,5
2024-02-16,2,Bed Number 2,55,15,40
2024-02-16,3,Bed Number 3,80,63,17
2024-02-17,1,Bed Number 1,17,12,5
2024-02-17,2,Bed Number 2,66,66,0
2024-02-17,3,Bed Number 3,17,16,1
2024-02-18,1,Bed Number 1,77,33,44
2024-02-18,2,Bed Number 2,25,4,21
2024-02-18,3,Bed Number 3,33,5,28
2024-02-19,1,Bed Number 1,48,20,28
2024-02-19,2,Bed Number 2,63,61,2
2024-02-19,3,Bed Number 3,28,26,2
2024-02-20,1,Bed Number 1,43,17,26
2024-02-20,2,Bed Number 2,24,9,15
2024-02-20,3,Bed Number 3,87,16,71
2024-02-21,1,Bed Number 1,48,15,33
2024-02-21,2,Bed Number 2,26,13,13
2024-02-21,3,Bed Number 3,97,20,77
2024-02-22,1,Bed Number 1,32,29,3
2024-02-22,2,Bed Number 2,97,97,0
2024-02-22,3,Bed Number 3,98,62,36
2024-02-23,1,Bed Number 1,97,73,24
2024-02-23,2,Bed Number 2,31,0,31
2024-02-23,3,Bed Number 3,99,39,60
2024-02-24,1,Bed Number 1,19,3,16
2024-02-24,2,Bed Number 2,90,54,36
2024-02-24,3,Bed Number 3,55,13,42
2024-02-25,1,Bed Number 1,58,0,58
2024-02-25,2,Bed Number 2,48,35,13
2024-02-25,3,Bed Number 3,96,65,31
2024-02-26,1,Bed Number 1,83,70,13
2024-02-26,2,Bed Number 2,77,56,21
2024-02-26,3,Bed Number 3,75,65,10
2024-02-27,1,Bed Number 1,94,6,88
2024-02-27,2,Bed Number 2,83,71,12
2024-02-27,3,Bed Number 3,67,4,63
2024-02-28,1,Bed Number 1,41,26,15
2024-02-28,2,Bed Number 2,18,3,15
2024-02-28,3,Bed Number 3,87,10,77
2024-02-29,1,Bed Number 1,46,4,42
2024-02-29,2,Bed Number 2,73,12,61
2024-02-29,3,Bed Number 3,65,27,38
2024-03-01,1,Bed Number 1,44,39,5
2024-03-01,2,Bed Number 2,16,7,9
2024-03-01,3,Bed Number 3,39,30,9
2024-03-02,1,Bed Number 1,22,6,16
2024-03-02,2,Bed Number 2,77,33,44
2024-03-02,3,Bed Number 3,90,75,15
2024-03-03,1,Bed Number 1,84,15,69
2024-03-03,2,Bed Number 2,30,3,27
2024-03-03,3,Bed Number 3,77,72,5
2024-03-04,1,Bed Number 1,41,25,16
2024-03-04,2,Bed Number 2,66,4,62
2024-03-04,3,Bed Number 3,49,43,6
2024-03-05,1,Bed Number 1,81,70,11
2024-03-05,2,Bed Number 2,12,11,1
2024-03-05,3,Bed Number 3,39,17,22
2024-03-06,1,Bed Number 1,36,18,18
2024-03-06,2,Bed Number 2,19,5,14
2024-03-06,3,Bed Number 3,84,43,41
2024-03-07,1,Bed Number 1,51,43,8
2024-03-07,2,Bed Number 2,69,18,51
2024-03-07,3,Bed Number 3,87,40,47
2024-03-08,1,Bed Number 1,14,14,0
2024-03-08,2,Bed Number 2,69,16,53
2024-03-08,3,Bed Number 3,37,12,25
2024-03-09,1,Bed Number 1,15,12,3
2024-03-09,2,Bed Number 2,47,33,14
2024-03-09,3,Bed Number 3,67,39,28
2024-03-10,1,Bed Number 1,12,0,12
2024-03-10,2,Bed Number 2,14,14,0
2024-03-10,3,Bed Number 3,38,31,7
2024-03-11,1,Bed Number 1,42,29,13
2024-03-11,2,Bed Number 2,56,39,17
2024-03-11,3,Bed Number 3,11,1,10
2024-03-12,1,Bed Number 1,19,10,9
2024-03-12,2,Bed Number 2,38,13,25
2024-03-12,3,Bed Number 3,62,33,29
2024-03-13,1,Bed Number 1,52,30,22
2024-03-13,2,Bed Number 2,77,32,45
2024-03-13,3,Bed Number 3,22,20,2
2024-03-14,1,Bed Number 1,52,18,34
2024-03-14,2,Bed Number 2,88,75,13
2024-03-14,3,Bed Number 3,76,37,39
2024-03-15,1,Bed Number 1,29,25,4
2024-03-15,2,Bed Number 2,80,3,77
2024-03-15,3,Bed Number 3,71,3,68
2024-03-16,1,Bed Number 1,52,3,49
2024-03-16,2,Bed Number 2,58,17,41
2024-03-16,3,Bed Number 3,100,9,91
2024-03-17,1,Bed Number 1,76,71,5
2024-03-17,2,Bed Number 2,14,13,1
2024-03-17,3,Bed Number 3,91,12,79
2024-03-18,1,Bed Number 1,85,42,43
2024-03-18,2,Bed Number 2,34,14,20
2024-03-18,3,Bed Number 3,41,29,12
2024-03-19,1,Bed Number 1,42,6,36
2024-03-19,2,Bed Number 2,16,0,16
2024-03-19,3,Bed Number 3,29,15,14
2024-03-20,1,Bed Number 1,75,39,36
2024-03-20,2,Bed Number 2,39,2,37
2024-03-20,3,Bed Number 3,49,37,12
2024-03-21,1,Bed Number 1,68,0,68
2024-03-21,2,Bed Number 2,28,15,13
2024-03-21,3,Bed Number 3,20,11,9
2024-03-22,1,Bed Number 1,12,12,0
2024-03-22,2,Bed Number 2,95,79,16
2024-03-22,3,Bed Number 3,14,9,5
2024-03-23,1,Bed Number 1,22,4,18
2024-03-23,2,Bed Number 2,45,20,25
2024-03-23,3,Bed Number 3,47,13,34
2024-03-24,1,Bed Number 1,59,52,7
2024-03-24,2,Bed Number 2,46,3,43
2024-03-24,3,Bed Number 3,20,20,0
2024-03-25,1,Bed Number 1,64,42,22
2024-03-25,2,Bed Number 2,50,30,20
2024-03-25,3,Bed Number 3,36,34,2
2024-03-26,1,Bed Number 1,28,22,6
2024-03-26,2,Bed Number 2,98,88,10
2024-03-26,3,Bed Number 3,13,9,4
2024-03-27,1,Bed Number 1,23,2,21
2024-03-27,2,Bed Number 2,57,51,6
2024-03-27,3,Bed Number 3,28,18,10
2024-03-28,1,Bed Number 1,72,6,66
2024-03-28,2,Bed Number 2,36,27,9
2024-03-28,3,Bed Number 3,23,22,1
2024-03-29,1,Bed Number 1,38,6,32
2024-03-29,2,Bed Number 2,94,2,92
2024-03-29,3,Bed Number 3,76,42,34
2024-03-30,1,Bed Number 1,50,2,48
2024-03-30,2,Bed Number 2,24,0,24
2024-03-30,3,Bed Number 3,26,21,5
2024-03-31,1,Bed Number 1,41,41,0
2024-03-31,2,Bed Number 2,44,15,29
2024-03-31,3,Bed Number 3,96,63,33
2024-04-01,1,Bed Number 1,44,21,23
2024-04-01,2,Bed Number 2,16,6,10
2024-04-01,3,Bed Number 3,62,25,37
2024-04-02,1,Bed Number 1,19,1,18
2024-04-02,2,Bed Number 2,82,31,51
2024-04-02,3,Bed Number 3,41,37,4
2024-04-03,1,Bed Number 1,70,19,51
2024-04-03,2,Bed Number 2,75,59,16
2024-04-03,3,Bed Number 3,20,7,13
2024-04-04,1,Bed Number 1,36,21,15
2024-04-04,2,Bed Number 2,33,32,1
2024-04-04,3,Bed Number 3,31,18,13
2024-04-05,1,Bed Number 1,69,52,17
2024-04-05,2,Bed Number 2,22,22,0
2024-04-05,3,Bed Number 3,34,13,21
2024-04-06,1,Bed Number 1,74,17,57
2024-04-06,2,Bed Number 2,90,58,32
2024-04-06,3,Bed Number 3,62,10,52
2024-04-07,1,Bed Number 1,29,22,7
2024-04-07,2,Bed Number 2,21,10,11
2024-04-07,3,Bed Number 3,35,12,23
2024-04-08,1,Bed Number 1,99,89,10
2024-04-08,2,Bed Number 2,26,11,15
2024-04-08,3,Bed Number 3,81,21,60
2024-04-09,1,Bed Number 1,84,52,32
2024-04-09,2,Bed Number 2,86,72,14
2024-04-09,3,Bed Number 3,73,69,4
2024-04-10,1,Bed Number 1,33,26,7
2024-04-10,2,Bed Number 2,50,46,4
2024-04-10,3,Bed Number 3,22,10,12
2024-04-11,1,Bed Number 1,14,0,14
2024-04-11,2,Bed Number 2,100,14,86
2024-04-11,3,Bed Number 3,83,65,18
2024-04-12,1,Bed Number 1,76,24,52
2024-04-12,2,Bed Number 2,47,4,43
2024-04-12,3,Bed Number 3,62,11,51
2024-04-13,1,Bed Number 1,46,24,22
2024-04-13,2,Bed Number 2,46,21,25
2024-04-13,3,Bed Number 3,91,17,74
2024-04-14,1,Bed Number 1,28,15,13
2024-04-14,2,Bed Number 2,28,21,7
2024-04-14,3,Bed Number 3,97,77,20
2024-04-15,1,Bed Number 1,46,37,9
2024-04-15,2,Bed Number 2,92,69,23
2024-04-15,3,Bed Number 3,68,47,21
2024-04-16,1,Bed Number 1,94,16,78
2024-04-16,2,Bed Number 2,86,49,37
2024-04-16,3,Bed Number 3,22,19,3
2024-04-17,1,Bed Number 1,15,3,12
2024-04-17,2,Bed Number 2,82,53,29
2024-04-17,3,Bed Number 3,51,19,32
2024-04-18,1,Bed Number 1,90,64,26
2024-04-18,2,Bed Number 2,52,38,14
2024-04-18,3,Bed Number 3,40,37,3
2024-04-19,1,Bed Number 1,22,15,7
2024-04-19,2,Bed Number 2,84,30,54
2024-04-19,3,Bed Number 3,92,43,49
2024-04-20,1,Bed Number 1,61,41,20
2024-04-20,2,Bed Number 2,88,48,40
2024-04-20,3,Bed Number 3,24,3,21
2024-04-21,1,Bed Number 1,33,27,6
2024-04-21,2,Bed Number 2,32,23,9
2024-04-21,3,Bed Number 3,62,0,62
2024-04-22,1,Bed Number 1,76,35,41
2024-04-22,2,Bed Number 2,12,1,11
2024-04-22,3,Bed Number 3,20,18,2
2024-04-23,1,Bed Number 1,67,19,48
2024-04-23,2,Bed Number 2,84,12,72
2024-04-23,3,Bed Number 3,66,42,24
2024-04-24,1,Bed Number 1,98,49,49
2024-04-24,2,Bed Number 2,82,63,19
2024-04-24,3,Bed Number 3,43,21,22
2024-04-25,1,Bed Number 1,62,24,38
2024-04-25,2,Bed Number 2,37,6,31
2024-04-25,3,Bed Number 3,79,18,61
2024-04-26,1,Bed Number 1,83,58,25
2024-04-26,2,Bed Number 2,43,28,15
2024-04-26,3,Bed Number 3,55,0,55
2024-04-27,1,Bed Number 1,85,51,34
2024-04-27,2,Bed Number 2,54,33,21
2024-04-27,3,Bed Number 3,14,0,14
2024-04-28,1,Bed Number 1,32,29,3
2024-04-28,2,Bed Number 2,70,48,22
2024-04-28,3,Bed Number 3,81,54,27
2024-04-29,1,Bed Number 1,37,17,20
2024-04-29,2,Bed Number 2,54,0,54
2024-04-29,3,Bed Number 3,31,17,14
2024-04-30,1,Bed Number 1,60,54,6
2024-04-30,2,Bed Number 2,51,4,47
2024-04-30,3,Bed Number 3,32,18,14
2024-05-01,1,Bed Number 1,64,60,4
2024-05-01,2,Bed Number 2,81,70,11
2024-05-01,3,Bed Number 3,23,23,0
2024-05-02,1,Bed Number 1,80,16,64
2024-05-02,2,Bed Number 2,37,3,34
2024-05-02,3,Bed Number 3,53,40,13
2024-05-03,1,Bed Number 1,63,21,42
2024-05-03,2,Bed Number 2,25,10,15
2024-05-03,3,Bed Number 3,39,24,15
2024-05-04,1,Bed Number 1,56,16,40
2024-05-04,2,Bed Number 2,89,15,74
2024-05-04,3,Bed Number 3,18,18,0
2024-05-05,1,Bed Number 1,67,49,18
2024-05-05,2,Bed Number 2,81,29,52
2024-05-05,3,Bed Number 3,80,48,32
2024-05-06,1,Bed Number 1,19,17,2
2024-05-06,2,Bed Number 2,83,38,45
2024-05-06,3,Bed Number 3,16,16,0
2024-05-07,1,Bed Number 1,41,36,5
2024-05-07,2,Bed Number 2,56,45,11
2024-05-07,3,Bed Number 3,47,40,7
2024-05-08,1,Bed Number 1,87,24,63
2024-05-08,2,Bed Number 2,99,16,83
2024-05-08,3,Bed Number 3,58,56,2
2024-05-09,1,Bed Number 1,28,25,3
2024-05-09,2,Bed Number 2,71,29,42
2024-05-09,3,Bed Number 3,51,19,32
2024-05-10,1,Bed Number 1,64,44,20
2024-05-10,2,Bed Number 2,25,23,2
2024-05-10,3,Bed Number 3,34,27,7
2024-05-11,1,Bed Number 1,40,5,35
2024-05-11,2,Bed Number 2,17,4,13
2024-05-11,3,Bed Number 3,67,16,51
2024-05-12,1,Bed Number 1,21,20,1
2024-05-12,2,Bed Number 2,39,10,29
2024-05-12,3,Bed Number 3,34,26,8
2024-05-13,1,Bed Number 1,66,65,1
2024-05-13,2,Bed Number 2,51,5,46
2024-05-13,3,Bed Number 3,40,3,37
2024-05-14,1,Bed Number 1,41,2,39
2024-05-14,2,Bed Number 2,43,28,15
2024-05-14,3,Bed Number 3,29,29,0
2024-05-15,1,Bed Number 1,80,7,73
2024-05-15,2,Bed Number 2,34,23,11
2024-05-15,3,Bed Number 3,55,54,1
2024-05-16,1,Bed Number 1,86,29,57
2024-05-16,2,Bed Number 2,97,76,21
2024-05-16,3,Bed Number 3,91,61,30
2024-05-17,1,Bed Number 1,19,6,13
2024-05-17,2,Bed Number 2,48,2,46
2024-05-17,3,Bed Number 3,55,29,26
2024-05-18,1,Bed Number 1,77,0,77
2024-05-18,2,Bed Number 2,58,48,10
2024-05-18,3,Bed Number 3,37,13,24
2024-05-19,1,Bed Number 1,90,51,39
2024-05-19,2,Bed Number 2,11,10,1
2024-05-19,3,Bed Number 3,73,11,62
2024-05-20,1,Bed Number 1,21,10,11
2024-05-20,2,Bed Number 2,31,28,3
2024-05-20,3,Bed Number 3,26,18,8
2024-05-21,1,Bed Number 1,62,23,39
2024-05-21,2,Bed Number 2,26,21,5
2024-05-21,3,Bed Number 3,56,39,17
2024-05-22,1,Bed Number 1,22,17,5
2024-05-22,2,Bed Number 2,71,11,60
2024-05-22,3,Bed Number 3,22,18,4
2024-05-23,1,Bed Number 1,89,46,43
2024-05-23,2,Bed Number 2,52,39,13
2024-05-23,3,Bed Number 3,43,39,4
2024-05-24,1,Bed Number 1,63,20,43
2024-05-24,2,Bed Number 2,54,38,16
2024-05-24,3,Bed Number 3,53,42,11
2024-05-25,1,Bed Number 1,75,13,62
2024-05-25,2,Bed Number 2,11,11,0
2024-05-25,3,Bed Number 3,11,6,5
2024-05-26,1,Bed Number 1,32,19,13
2024-05-26,2,Bed Number 2,82,67,15
2024-05-26,3,Bed Number 3,69,20,49
2024-05-27,1,Bed Number 1,32,30,2
2024-05-27,2,Bed Number 2,91,79,12
2024-05-27,3,Bed Number 3,69,29,40
2024-05-28,1,Bed Number 1,57,14,43
2024-05-28,2,Bed Number 2,90,34,56
2024-05-28,3,Bed Number 3,90,18,72
2024-05-29,1,Bed Number 1,28,5,23
2024-05-29,2,Bed Number 2,17,11,6
2024-05-29,3,Bed Number 3,70,25,45
2024-05-30,1,Bed Number 1,15,7,8
2024-05-30,2,Bed Number 2,42,3,39
2024-05-30,3,Bed Number 3,50,14,36
2024-05-31,1,Bed Number 1,34,18,16
2024-05-31,2,Bed Number 2,94,75,19
2024-05-31,3,Bed Number 3,84,43,41
2024-06-01,1,Bed Number 1,64,55,9
2024-06-01,2,Bed Number 2,43,26,17
2024-06-01,3,Bed Number 3,73,50,23
2024-06-02,1,Bed Number 1,71,48,23
2024-06-02,2,Bed Number 2,62,16,46
2024-06-02,3,Bed Number 3,40,27,13
2024-06-03,1,Bed Number 1,73,67,6
2024-06-03,2,Bed Number 2,10,5,5
2024-06-03,3,Bed Number 3,74,5,69
2024-06-04,1,Bed Number 1,51,19,32
2024-06-04,2,Bed Number 2,50,18,32
2024-06-04,3,Bed Number 3,33,14,19
2024-06-05,1,Bed Number 1,40,11,29
2024-06-05,2,Bed Number 2,94,21,73
2024-06-05,3,Bed Number 3,48,17,31
2024-06-06,1,Bed Number 1,79,75,4
2024-06-06,2,Bed Number 2,13,12,1
2024-06-06,3,Bed Number 3,23,3,20
2024-06-07,1,Bed Number 1,92,72,20
2024-06-07,2,Bed Number 2,76,41,35
2024-06-07,3,Bed Number 3,47,38,9
2024-06-08,1,Bed Number 1,48,38,10
2024-06-08,2,Bed Number 2,18,4,14
2024-06-08,3,Bed Number 3,26,21,5
2024-06-09,1,Bed Number 1,58,16,42
2024-06-09,2,Bed Number 2,100,0,100
2024-06-09,3,Bed Number 3,69,61,8
2024-06-10,1,Bed Number 1,70,43,27
2024-06-10,2,Bed Number 2,13,0,13
2024-06-10,3,Bed Number 3,27,13,14
2024-06-11,1,Bed Number 1,32,32,0
2024-06-11,2,Bed Number 2,30,29,1
2024-06-11,3,Bed Number 3,97,85,12
2024-06-12,1,Bed Number 1,79,59,20
2024-06-12,2,Bed Number 2,86,24,62
2024-06-12,3,Bed Number 3,24,24,0
2024-06-13,1,Bed Number 1,88,50,38
2024-06-13,2,Bed Number 2,51,16,35
2024-06-13,3,Bed Number 3,100,83,17
2024-06-14,1,Bed Number 1,51,42,9
2024-06-14,2,Bed Number 2,45,30,15
2024-06-14,3,Bed Number 3,15,7,8
2024-06-15,1,Bed Number 1,40,15,25
2024-06-15,2,Bed Number 2,71,32,39
2024-06-15,3,Bed Number 3,42,15,27
2024-06-16,1,Bed Number 1,66,14,52
2024-06-16,2,Bed Number 2,56,28,28
2024-06-16,3,Bed Number 3,24,6,18
2024-06-17,1,Bed Number 1,10,8,2
2024-06-17,2,Bed Number 2,68,25,43
2024-06-17,3,Bed Number 3,35,0,35
2024-06-18,1,Bed Number 1,71,67,4
2024-06-18,2,Bed Number 2,14,6,8
2024-06-18,3,Bed Number 3,17,16,1
2024-06-19,1,Bed Number 1,87,25,62
2024-06-19,2,Bed Number 2,27,7,20
2024-06-19,3,Bed Number 3,88,50,38
2024-06-20,1,Bed Number 1,70,4,66
2024-06-20,2,Bed Number 2,85,51,34
2024-06-20,3,Bed Number 3,83,4,79
2024-06-21,1,Bed Number 1,16,16,0
2024-06-21,2,Bed Number 2,21,2,19
2024-06-21,3,Bed Number 3,22,21,1
2024-06-22,1,Bed Number 1,94,43,51
2024-06-22,2,Bed Number 2,33,31,2
2024-06-22,3,Bed Number 3,92,49,43
2024-06-23,1,Bed Number 1,35,9,26
2024-06-23,2,Bed Number 2,33,2,31
2024-06-23,3,Bed Number 3,59,58,1
2024-06-24,1,Bed Number 1,34,16,18
2024-06-24,2,Bed Number 2,20,4,16
2024-06-24,3,Bed Number 3,69,27,42
2024-06-25,1,Bed Number 1,58,25,33
2024-06-25,2,Bed Number 2,67,60,7
2024-06-25,3,Bed Number 3,50,49,1
2024-06-26,1,Bed Number 1,43,39,4
2024-06-26,2,Bed Number 2,51,35,16
2024-06-26,3,Bed Number 3,31,4,27
2024-06-27,1,Bed Number 1,22,20,2
2024-06-27,2,Bed Number 2,22,19,3
2024-06-27,3,Bed Number 3,85,7,78
2024-06-28,1,Bed Number 1,16,0,16
2024-06-28,2,Bed Number 2,23,8,15
2024-06-28,3,Bed Number 3,54,2,52
2024-06-29,1,Bed Number 1,10,8,2
2024-06-29,2,Bed Number 2,85,2,83
2024-06-29,3,Bed Number 3,39,10,29
2024-06-30,1,Bed Number 1,16,13,3
2024-06-30,2,Bed Number 2,69,11,58
2024-06-30,3,Bed Number 3,88,37,51
2024-07-01,1,Bed Number 1,49,9,40
2024-07-01,2,Bed Number 2,73,33,40
2024-07-01,3,Bed Number 3,60,37,23
2024-07-02,1,Bed Number 1,43,5,38
2024-07-02,2,Bed Number 2,40,30,10
2024-07-02,3,Bed Number 3,84,10,74
2024-07-03,1,Bed Number 1,28,6,22
2024-07-03,2,Bed Number 2,67,66,1
2024-07-03,3,Bed Number 3,80,71,9
2024-07-04,1,Bed Number 1,10,6,4
2024-07-04,2,Bed Number 2,55,36,19
2024-07-04,3,Bed Number 3,40,26,14
2024-07-05,1,Bed Number 1,96,25,71
2024-07-05,2,Bed Number 2,95,4,91
2024-07-05,3,Bed Number 3,19,7,12
2024-07-06,1,Bed Number 1,57,20,37
2024-07-06,2,Bed Number 2,64,9,55
2024-07-06,3,Bed Number 3,88,39,49
2024-07-07,1,Bed Number 1,86,14,72
2024-07-07,2,Bed Number 2,50,48,2
2024-07-07,3,Bed Number 3,33,21,12
2024-07-08,1,Bed Number 1,51,16,35
2024-07-08,2,Bed Number 2,84,2,82
2024-07-08,3,Bed Number 3,86,32,54
2024-07-09,1,Bed Number 1,35,4,31
2024-07-09,2,Bed Number 2,49,28,21
2024-07-09,3,Bed Number 3,77,69,8
2024-07-10,1,Bed Number 1,71,4,67
2024-07-10,2,Bed Number 2,43,42,1
2024-07-10,3,Bed Number 3,39,34,5
2024-07-11,1,Bed Number 1,20,18,2
2024-07-11,2,Bed Number 2,47,33,14
2024-07-11,3,Bed Number 3,21,10,11
2024-07-12,1,Bed Number 1,100,0,100
2024-07-12,2,Bed Number 2,81,6,75
2024-07-12,3,Bed Number 3,53,9,44
2024-07-13,1,Bed Number 1,68,53,15
2024-07-13,2,Bed Number 2,69,8,61
2024-07-13,3,Bed Number 3,14,0,14
2024-07-14,1,Bed Number 1,53,7,46
2024-07-14,2,Bed Number 2,94,43,51
2024-07-14,3,Bed Number 3,73,39,34
2024-07-15,1,Bed Number 1,63,4,59
2024-07-15,2,Bed Number 2,87,23,64
2024-07-15,3,Bed Number 3,90,69,21
2024-07-16,1,Bed Number 1,20,12,8
2024-07-16,2,Bed Number 2,45,0,45
2024-07-16,3,Bed Number 3,16,11,5
2024-07-17,1,Bed Number 1,88,65,23
2024-07-17,2,Bed Number 2,55,32,23
2024-07-17,3,Bed Number 3,93,39,54
2024-07-18,1,Bed Number 1,53,5,48
2024-07-18,2,Bed Number 2,54,40,14
2024-07-18,3,Bed Number 3,38,29,9
2024-07-19,1,Bed Number 1,48,15,33
2024-07-19,2,Bed Number 2,92,32,60
2024-07-19,3,Bed Number 3,92,44,48
2024-07-20,1,Bed Number 1,65,58,7
2024-07-20,2,Bed Number 2,47,43,4
2024-07-20,3,Bed Number 3,20,13,7
2024-07-21,1,Bed Number 1,57,43,14
2024-07-21,2,Bed Number 2,93,10,83
2024-07-21,3,Bed Number 3,75,27,48
2024-07-22,1,Bed Number 1,47,21,26
2024-07-22,2,Bed Number 2,24,22,2
2024-07-22,3,Bed Number 3,24,9,15
2024-07-23,1,Bed Number 1,93,90,3
2024-07-23,2,Bed Number 2,87,79,8
2024-07-23,3,Bed Number 3,36,0,36
2024-07-24,1,Bed Number 1,73,71,2
2024-07-24,2,Bed Number 2,27,8,19
2024-07-24,3,Bed Number 3,91,58,33
2024-07-25,1,Bed Number 1,100,18,82
2024-07-25,2,Bed Number 2,57,6,51
2024-07-25,3,Bed Number 3,44,10,34
2024-07-26,1,Bed Number 1,74,19,55
2024-07-26,2,Bed Number 2,97,41,56
2024-07-26,3,Bed Number 3,87,38,49
2024-07-27,1,Bed Number 1,56,4,52
2024-07-27,2,Bed Number 2,36,12,24
2024-07-27,3,Bed Number 3,19,18,1
2024-07-28,1,Bed Number 1,88,10,78
2024-07-28,2,Bed Number 2,18,16,2
2024-07-28,3,Bed Number 3,93,79,14
2024-07-29,1,Bed Number 1,89,62,27
2024-07-29,2,Bed Number 2,65,57,8
2024-07-29,3,Bed Number 3,93,9,84
2024-07-30,1,Bed Number 1,86,66,20
2024-07-30,2,Bed Number 2,22,20,2
2024-07-30,3,Bed Number 3,46,16,30
2024-07-31,1,Bed Number 1,73,54,19
2024-07-31,2,Bed Number 2,88,22,66
2024-07-31,3,Bed Number 3,37,9,28
2024-08-01,1,Bed Number 1,97,30,67
2024-08-01,2,Bed Number 2,83,34,49
2024-08-01,3,Bed Number 3,28,4,24
2024-08-02,1,Bed Number 1,63,8,55
2024-08-02,2,Bed Number 2,83,25,58
2024-08-02,3,Bed Number 3,15,13,2
2024-08-03,1,Bed Number 1,97,17,80
2024-08-03,2,Bed Number 2,18,14,4
2024-08-03,3,Bed Number 3,48,46,2
2024-08-04,1,Bed Number 1,42,28,14
2024-08-04,2,Bed Number 2,34,21,13
2024-08-04,3,Bed Number 3,25,12,13
2024-08-05,1,Bed Number 1,12,0,12
2024-08-05,2,Bed Number 2,84,59,25
2024-08-05,3,Bed Number 3,94,56,38
2024-08-06,1,Bed Number 1,92,34,58
2024-08-06,2,Bed Number 2,50,27,23
2024-08-06,3,Bed Number 3,91,89,2
2024-08-07,1,Bed Number 1,39,3,36
2024-08-07,2,Bed Number 2,28,23,5
2024-08-07,3,Bed Number 3,13,4,9
2024-08-08,1,Bed Number 1,82,42,40
2024-08-08,2,Bed Number 2,59,18,41
2024-08-08,3,Bed Number 3,60,20,40
2024-08-09,1,Bed Number 1,36,17,19
2024-08-09,2,Bed Number 2,10,2,8
2024-08-09,3,Bed Number 3,32,32,0
2024-08-10,1,Bed Number 1,33,15,18
2024-08-10,2,Bed Number 2,40,38,2
2024-08-10,3,Bed Number 3,18,8,10
2024-08-11,1,Bed Number 1,32,3,29
2024-08-11,2,Bed Number 2,90,58,32
2024-08-11,3,Bed Number 3,87,14,73
2024-08-12,1,Bed Number 1,96,25,71
2024-08-12,2,Bed Number 2,69,7,62
2024-08-12,3,Bed Number 3,33,31,2
2024-08-13,1,Bed Number 1,65,47,18
2024-08-13,2,Bed Number 2,55,36,19
2024-08-13,3,Bed Number 3,81,17,64
2024-08-14,1,Bed Number 1,65,46,19
2024-08-14,2,Bed Number 2,69,32,37
2024-08-14,3,Bed Number 3,96,34,62
2024-08-15,1,Bed Number 1,52,22,30
2024-08-15,2,Bed Number 2,74,33,41
2024-08-15,3,Bed Number 3,27,20,7
2024-08-16,1,Bed Number 1,75,64,11
2024-08-16,2,Bed Number 2,81,12,69
2024-08-16,3,Bed Number 3,20,19,1
2024-08-17,1,Bed Number 1,60,6,54
2024-08-17,2,Bed Number 2,39,32,7
2024-08-17,3,Bed Number 3,85,51,34
2024-08-18,1,Bed Number 1,39,14,25
2024-08-18,2,Bed Number 2,68,49,19
2024-08-18,3,Bed Number 3,29,7,22
2024-08-19,1,Bed Number 1,98,5,93
2024-08-19,2,Bed Number 2,61,12,49
2024-08-19,3,Bed Number 3,35,21,14
2024-08-20,1,Bed Number 1,64,64,0
2024-08-20,2,Bed Number 2,14,1,13
2024-08-20,3,Bed Number 3,65,9,56
2024-08-21,1,Bed Number 1,80,50,30
2024-08-21,2,Bed Number 2,26,12,14
2024-08-21,3,Bed Number 3,18,10,8
2024-08-22,1,Bed Number 1,55,6,49
2024-08-22,2,Bed Number 2,50,26,24
2024-08-22,3,Bed Number 3,10,6,4
2024-08-23,1,Bed Number 1,60,25,35
2024-08-23,2,Bed Number 2,14,0,14
2024-08-23,3,Bed Number 3,83,17,66
2024-08-24,1,Bed Number 1,32,4,28
2024-08-24,2,Bed Number 2,39,19,20
2024-08-24,3,Bed Number 3,84,17,67
2024-08-25,1,Bed Number 1,61,48,13
2024-08-25,2,Bed Number 2,27,4,23
2024-08-25,3,Bed Number 3,87,79,8
2024-08-26,1,Bed Number 1,85,65,20
2024-08-26,2,Bed Number 2,92,16,76
2024-08-26,3,Bed Number 3,85,23,62
2024-08-27,1,Bed Number 1,48,6,42
2024-08-27,2,Bed Number 2,48,10,38
2024-08-27,3,Bed Number 3,63,63,0
2024-08-28,1,Bed Number 1,93,40,53
2024-08-28,2,Bed Number 2,60,45,15
2024-08-28,3,Bed Number 3,65,3,62
2024-08-29,1,Bed Number 1,29,10,19
2024-08-29,2,Bed Number 2,74,32,42
2024-08-29,3,Bed Number 3,48,15,33
2024-08-30,1,Bed Number 1,45,23,22
2024-08-30,2,Bed Number 2,23,11,12
2024-08-30,3,Bed Number 3,33,9,24
2024-08-31,1,Bed Number 1,42,38,4
2024-08-31,2,Bed Number 2,26,4,22
2024-08-31,3,Bed Number 3,69,39,30
2024-09-01,1,Bed Number 1,35,9,26
2024-09-01,2,Bed Number 2,52,48,4
2024-09-01,3,Bed Number 3,47,47,0
2024-09-02,1,Bed Number 1,21,14,7
2024-09-02,2,Bed Number 2,73,27,46
2024-09-02,3,Bed Number 3,30,18,12
2024-09-03,1,Bed Number 1,76,8,68
2024-09-03,2,Bed Number 2,54,8,46
2024-09-03,3,Bed Number 3,52,7,45
2024-09-04,1,Bed Number 1,67,43,24
2024-09-04,2,Bed Number 2,94,93,1
2024-09-04,3,Bed Number 3,72,32,40
2024-09-05,1,Bed Number 1,14,10,4
2024-09-05,2,Bed Number 2,41,15,26
2024-09-05,3,Bed Number 3,100,43,57
2024-09-06,1,Bed Number 1,52,10,42
2024-09-06,2,Bed Number 2,53,27,26
2024-09-06,3,Bed Number 3,64,21,43
2024-09-07,1,Bed Number 1,15,1,14
2024-09-07,2,Bed Number 2,17,7,10
2024-09-07,3,Bed Number 3,61,9,52
2024-09-08,1,Bed Number 1,43,19,24
2024-09-08,2,Bed Number 2,84,57,27
2024-09-08,3,Bed Number 3,20,7,13
2024-09-09,1,Bed Number 1,75,6,69
2024-09-09,2,Bed Number 2,32,16,16
2024-09-09,3,Bed Number 3,30,18,12
2024-09-10,1,Bed Number 1,73,67,6
2024-09-10,2,Bed Number 2,43,24,19
2024-09-10,3,Bed Number 3,37,3,34
2024-09-11,1,Bed Number 1,63,43,20
2024-09-11,2,Bed Number 2,28,25,3
2024-09-11,3,Bed Number 3,75,40,35
2024-09-12,1,Bed Number 1,25,0,25
2024-09-12,2,Bed Number 2,84,30,54
2024-09-12,3,Bed Number 3,26,21,5
2024-09-13,1,Bed Number 1,43,41,2
2024-09-13,2,Bed Number 2,35,23,12
2024-09-13,3,Bed Number 3,89,75,14
2024-09-14,1,Bed Number 1,22,19,3
2024-09-14,2,Bed Number 2,55,21,34
2024-09-14,3,Bed Number 3,57,13,44
2024-09-15,1,Bed Number 1,30,22,8
2024-09-15,2,Bed Number 2,69,14,55
2024-09-15,3,Bed Number 3,75,37,38
2024-09-16,1,Bed Number 1,49,40,9
2024-09-16,2,Bed Number 2,36,4,32
2024-09-16,3,Bed Number 3,50,23,27
2024-09-17,1,Bed Number 1,69,6,63
2024-09-17,2,Bed Number 2,74,4,70
2024-09-17,3,Bed Number 3,34,4,30
2024-09-18,1,Bed Number 1,74,25,49
2024-09-18,2,Bed Number 2,11,11,0
2024-09-18,3,Bed Number 3,57,38,19
2024-09-19,1,Bed Number 1,64,0,64
2024-09-19,2,Bed Number 2,46,39,7
2024-09-19,3,Bed Number 3,26,13,13
2024-09-20,1,Bed Number 1,28,11,17
2024-09-20,2,Bed Number 2,100,75,25
2024-09-20,3,Bed Number 3,97,95,2
2024-09-21,1,Bed Number 1,27,5,22
2024-09-21,2,Bed Number 2,43,28,15
2024-09-21,3,Bed Number 3,93,28,65
2024-09-22,1,Bed Number 1,31,0,31
2024-09-22,2,Bed Number 2,24,8,16
2024-09-22,3,Bed Number 3,59,4,55
2024-09-23,1,Bed Number 1,46,19,27
2024-09-23,2,Bed Number 2,62,1,61
2024-09-23,3,Bed Number 3,38,20,18
2024-09-24,1,Bed Number 1,25,25,0
2024-09-24,2,Bed Number 2,36,33,3
2024-09-24,3,Bed Number 3,21,15,6
2024-09-25,1,Bed Number 1,34,4,30
2024-09-25,2,Bed Number 2,72,39,33
2024-09-25,3,Bed Number 3,66,23,43
2024-09-26,1,Bed Number 1,79,42,37
2024-09-26,2,Bed Number 2,86,26,60
2024-09-26,3,Bed Number 3,99,76,23
2024-09-27,1,Bed Number 1,48,17,31
2024-09-27,2,Bed Number 2,26,18,8
2024-09-27,3,Bed Number 3,55,44,11
2024-09-28,1,Bed Number 1,59,26,33
2024-09-28,2,Bed Number 2,45,9,36
2024-09-28,3,Bed Number 3,55,2,53
2024-09-29,1,Bed Number 1,85,39,46
2024-09-29,2,Bed Number 2,20,14,6
2024-09-29,3,Bed Number 3,63,7,56
2024-09-30,1,Bed Number 1,97,27,70
2024-09-30,2,Bed Number 2,49,37,12
2024-09-30,3,Bed Number 3,81,19,62
2024-10-01,1,Bed Number 1,22,8,14
2024-10-01,2,Bed Number 2,46,27,19
2024-10-01,3,Bed Number 3,73,66,7
2024-10-02,1,Bed Number 1,47,8,39
2024-10-02,2,Bed Number 2,15,7,8
2024-10-02,3,Bed Number 3,98,47,51
2024-10-03,1,Bed Number 1,35,30,5
2024-10-03,2,Bed Number 2,84,80,4
2024-10-03,3,Bed Number 3,43,26,17
2024-10-04,1,Bed Number 1,98,82,16
2024-10-04,2,Bed Number 2,26,0,26
2024-10-04,3,Bed Number 3,70,65,5
2024-10-05,1,Bed Number 1,35,5,30
2024-10-05,2,Bed Number 2,14,6,8
2024-10-05,3,Bed Number 3,90,82,8
2024-10-06,1,Bed Number 1,54,24,30
2024-10-06,2,Bed Number 2,44,42,2
2024-10-06,3,Bed Number 3,64,16,48
2024-10-07,1,Bed Number 1,85,77,8
2024-10-07,2,Bed Number 2,60,30,30
2024-10-07,3,Bed Number 3,21,0,21
2024-10-08,1,Bed Number 1,10,3,7
2024-10-08,2,Bed Number 2,86,32,54
2024-10-08,3,Bed Number 3,95,44,51
2024-10-09,1,Bed Number 1,36,15,21
2024-10-09,2,Bed Number 2,27,15,12
2024-10-09,3,Bed Number 3,92,12,80
2024-10-10,1,Bed Number 1,46,42,4
2024-10-10,2,Bed Number 2,19,6,13
2024-10-10,3,Bed Number 3,14,3,11
2024-10-11,1,Bed Number 1,50,10,40
2024-10-11,2,Bed Number 2,34,0,34
2024-10-11,3,Bed Number 3,77,1,76
2024-10-12,1,Bed Number 1,57,25,32
2024-10-12,2,Bed Number 2,12,0,12
2024-10-12,3,Bed Number 3,14,0,14
2024-10-13,1,Bed Number 1,21,1,20
2024-10-13,2,Bed Number 2,44,35,9
2024-10-13,3,Bed Number 3,27,18,9
2024-10-14,1,Bed Number 1,95,43,52
2024-10-14,2,Bed Number 2,24,4,20
2024-10-14,3,Bed Number 3,98,67,31
2024-10-15,1,Bed Number 1,55,36,19
2024-10-15,2,Bed Number 2,71,18,53
2024-10-15,3,Bed Number 3,76,27,49
2024-10-16,1,Bed Number 1,93,84,9
2024-10-16,2,Bed Number 2,70,9,61
2024-10-16,3,Bed Number 3,53,49,4
2024-10-17,1,Bed Number 1,25,8,17
2024-10-17,2,Bed Number 2,23,3,20
2024-10-17,3,Bed Number 3,11,5,6
2024-10-18,1,Bed Number 1,69,17,52
2024-10-18,2,Bed Number 2,32,18,14
2024-10-18,3,Bed Number 3,34,23,11
2024-10-19,1,Bed Number 1,72,29,43
2024-10-19,2,Bed Number 2,46,15,31
2024-10-19,3,Bed Number 3,87,39,48
2024-10-20,1,Bed Number 1,93,45,48
2024-10-20,2,Bed Number 2,21,19,2
2024-10-20,3,Bed Number 3,56,53,3
2024-10-21,1,Bed Number 1,79,9,70
2024-10-21,2,Bed Number 2,59,33,26
2024-10-21,3,Bed Number 3,33,30,3
2024-10-22,1,Bed Number 1,51,48,3
2024-10-22,2,Bed Number 2,65,32,33
2024-10-22,3,Bed Number 3,65,59,6
2024-10-23,1,Bed Number 1,46,4,42
2024-10-23,2,Bed Number 2,20,6,14
2024-10-23,3,Bed Number 3,79,35,44
2024-10-24,1,Bed Number 1,62,25,37
2024-10-24,2,Bed Number 2,70,36,34
2024-10-24,3,Bed Number 3,62,5,57
2024-10-25,1,Bed Number 1,65,63,2
2024-10-25,2,Bed Number 2,28,0,28
2024-10-25,3,Bed Number 3,21,1,20
2024-10-26,1,Bed Number 1,52,10,42
2024-10-26,2,Bed Number 2,63,32,31
2024-10-26,3,Bed Number 3,78,0,78
2024-10-27,1,Bed Number 1,83,19,64
2024-10-27,2,Bed Number 2,20,5,15
2024-10-27,3,Bed Number 3,94,1,93
2024-10-28,1,Bed Number 1,25,6,19
2024-10-28,2,Bed Number 2,17,9,8
2024-10-28,3,Bed Number 3,77,72,5
2024-10-29,1,Bed Number 1,18,18,0
2024-10-29,2,Bed Number 2,74,53,21
2024-10-29,3,Bed Number 3,88,46,42
2024-10-30,1,Bed Number 1,72,15,57
2024-10-30,2,Bed Number 2,59,25,34
2024-10-30,3,Bed Number 3,19,3,16
2024-10-31,1,Bed Number 1,78,47,31
2024-10-31,2,Bed Number 2,32,0,32
2024-10-31,3,Bed Number 3,60,28,32
2024-11-01,1,Bed Number 1,49,19,30
2024-11-01,2,Bed Number 2,20,10,10
2024-11-01,3,Bed Number 3,38,34,4
2024-11-02,1,Bed Number 1,20,12,8
2024-11-02,2,Bed Number 2,39,12,27
2024-11-02,3,Bed Number 3,17,17,0
2024-11-03,1,Bed Number 1,69,7,62
2024-11-03,2,Bed Number 2,67,26,41
2024-11-03,3,Bed Number 3,21,14,7
2024-11-04,1,Bed Number 1,54,41,13
2024-11-04,2,Bed Number 2,35,32,3
2024-11-04,3,Bed Number 3,51,7,44
2024-11-05,1,Bed Number 1,86,41,45
2024-11-05,2,Bed Number 2,39,10,29
2024-11-05,3,Bed Number 3,84,51,33
2024-11-06,1,Bed Number 1,74,51,23
2024-11-06,2,Bed Number 2,33,22,11
2024-11-06,3,Bed Number 3,22,17,5
2024-11-07,1,Bed Number 1,45,19,26
2024-11-07,2,Bed Number 2,52,21,31
2024-11-07,3,Bed Number 3,19,19,0
2024-11-08,1,Bed Number 1,98,6,92
2024-11-08,2,Bed Number 2,22,3,19
2024-11-08,3,Bed Number 3,28,11,17
2024-11-09,1,Bed Number 1,39,17,22
2024-11-09,2,Bed Number 2,92,60,32
2024-11-09,3,Bed Number 3,49,35,14
2024-11-10,1,Bed Number 1,58,42,16
2024-11-10,2,Bed Number 2,36,14,22
2024-11-10,3,Bed Number 3,71,2,69
2024-11-11,1,Bed Number 1,84,74,10
2024-11-11,2,Bed Number 2,80,24,56
2024-11-11,3,Bed Number 3,13,12,1
2024-11-12,1,Bed Number 1,58,21,37
2024-11-12,2,Bed Number 2,64,46,18
2024-11-12,3,Bed Number 3,97,24,73
2024-11-13,1,Bed Number 1,93,60,33
2024-11-13,2,Bed Number 2,19,18,1
2024-11-13,3,Bed Number 3,97,22,75
2024-11-14,1,Bed Number 1,30,13,17
2024-11-14,2,Bed Number 2,25,10,15
2024-11-14,3,Bed Number 3,79,53,26
2024-11-15,1,Bed Number 1,43,22,21
2024-11-15,2,Bed Number 2,67,38,29
2024-11-15,3,Bed Number 3,26,4,22
2024-11-16,1,Bed Number 1,57,29,28
2024-11-16,2,Bed Number 2,17,8,9
2024-11-16,3,Bed Number 3,38,33,5
2024-11-17,1,Bed Number 1,26,12,14
2024-11-17,2,Bed Number 2,67,22,45
2024-11-17,3,Bed Number 3,17,2,15
2024-11-18,1,Bed Number 1,21,4,17
2024-11-18,2,Bed Number 2,67,16,51
2024-11-18,3,Bed Number 3,51,30,21
2024-11-19,1,Bed Number 1,42,3,39
2024-11-19,2,Bed Number 2,69,37,32
2024-11-19,3,Bed Number 3,62,0,62
2024-11-20,1,Bed Number 1,62,10,52
2024-11-20,2,Bed Number 2,46,28,18
2024-11-20,3,Bed Number 3,12,7,5
2024-11-21,1,Bed Number 1,66,24,42
2024-11-21,2,Bed Number 2,45,39,6
2024-11-21,3,Bed Number 3,69,53,16
2024-11-22,1,Bed Number 1,26,7,19
2024-11-22,2,Bed Number 2,78,19,59
2024-11-22,3,Bed Number 3,72,60,12
2024-11-23,1,Bed Number 1,13,3,10
2024-11-23,2,Bed Number 2,56,15,41
2024-11-23,3,Bed Number 3,31,15,16
2024-11-24,1,Bed Number 1,24,7,17
2024-11-24,2,Bed Number 2,83,14,69
2024-11-24,3,Bed Number 3,71,50,21
2024-11-25,1,Bed Number 1,88,88,0
2024-11-25,2,Bed Number 2,47,32,15
2024-11-25,3,Bed Number 3,20,9,11
2024-11-26,1,Bed Number 1,98,57,41
2024-11-26,2,Bed Number 2,84,21,63
2024-11-26,3,Bed Number 3,60,60,0
2024-11-27,1,Bed Number 1,75,62,13
2024-11-27,2,Bed Number 2,76,62,14
2024-11-27,3,Bed Number 3,96,78,18
2024-11-28,1,Bed Number 1,59,32,27
2024-11-28,2,Bed Number 2,51,19,32
2024-11-28,3,Bed Number 3,55,21,34
2024-11-29,1,Bed Number 1,89,20,69
2024-11-29,2,Bed Number 2,65,57,8
2024-11-29,3,Bed Number 3,22,19,3
2024-11-30,1,Bed Number 1,59,51,8
2024-11-30,2,Bed Number 2,24,23,1
2024-11-30,3,Bed Number 3,22,11,11
2024-12-01,1,Bed Number 1,99,76,23
2024-12-01,2,Bed Number 2,30,22,8
2024-12-01,3,Bed Number 3,56,52,4
2024-12-02,1,Bed Number 1,98,43,55
2024-12-02,2,Bed Number 2,75,65,10
2024-12-02,3,Bed Number 3,38,37,1
2024-12-03,1,Bed Number 1,67,57,10
2024-12-03,2,Bed Number 2,62,61,1
2024-12-03,3,Bed Number 3,43,13,30
2024-12-04,1,Bed Number 1,10,4,6
2024-12-04,2,Bed Number 2,79,66,13
2024-12-04,3,Bed Number 3,22,2,20
2024-12-05,1,Bed Number 1,67,43,24
2024-12-05,2,Bed Number 2,28,17,11
2024-12-05,3,Bed Number 3,72,12,60
2024-12-06,1,Bed Number 1,59,47,12
2024-12-06,2,Bed Number 2,21,12,9
2024-12-06,3,Bed Number 3,71,37,34
2024-12-07,1,Bed Number 1,66,42,24
2024-12-07,2,Bed Number 2,34,18,16
2024-12-07,3,Bed Number 3,80,58,22
2024-12-08,1,Bed Number 1,35,9,26
2024-12-08,2,Bed Number 2,10,1,9
2024-12-08,3,Bed Number 3,95,42,53
2024-12-09,1,Bed Number 1,52,41,11
2024-12-09,2,Bed Number 2,99,62,37
2024-12-09,3,Bed Number 3,44,27,17
2024-12-10,1,Bed Number 1,53,50,3
2024-12-10,2,Bed Number 2,39,20,19
2024-12-10,3,Bed Number 3,14,12,2
2024-12-11,1,Bed Number 1,88,77,11
2024-12-11,2,Bed Number 2,62,28,34
2024-12-11,3,Bed Number 3,95,6,89
2024-12-12,1,Bed Number 1,46,22,24
2024-12-12,2,Bed Number 2,48,15,33
2024-12-12,3,Bed Number 3,39,24,15
2024-12-13,1,Bed Number 1,13,12,1
2024-12-13,2,Bed Number 2,42,29,13
2024-12-13,3,Bed Number 3,49,13,36
2024-12-14,1,Bed Number 1,76,52,24
2024-12-14,2,Bed Number 2,95,51,44
2024-12-14,3,Bed Number 3,50,6,44
2024-12-15,1,Bed Number 1,98,82,16
2024-12-15,2,Bed Number 2,44,42,2
2024-12-15,3,Bed Number 3,65,49,16
2024-12-16,1,Bed Number 1,52,36,16
2024-12-16,2,Bed Number 2,11,5,6
2024-12-16,3,Bed Number 3,13,5,8
2024-12-17,1,Bed Number 1,39,11,28
2024-12-17,2,Bed Number 2,83,81,2
2024-12-17,3,Bed Number 3,69,58,11
2024-12-18,1,Bed Number 1,49,5,44
2024-12-18,2,Bed Number 2,95,64,31
2024-12-18,3,Bed Number 3,32,19,13
2024-12-19,1,Bed Number 1,96,59,37
2024-12-19,2,Bed Number 2,45,15,30
2024-12-19,3,Bed Number 3,27,16,11
2024-12-20,1,Bed Number 1,63,36,27
2024-12-20,2,Bed Number 2,37,21,16
2024-12-20,3,Bed Number 3,14,5,9
2024-12-21,1,Bed Number 1,21,1,20
2024-12-21,2,Bed Number 2,63,53,10
2024-12-21,3,Bed Number 3,59,56,3
2024-12-22,1,Bed Number 1,41,35,6
2024-12-22,2,Bed Number 2,44,35,9
2024-12-22,3,Bed Number 3,95,78,17
2024-12-23,1,Bed Number 1,100,92,8
2024-12-23,2,Bed Number 2,67,41,26
2024-12-23,3,Bed Number 3,74,49,25
2024-12-24,1,Bed Number 1,70,9,61
2024-12-24,2,Bed Number 2,89,81,8
2024-12-24,3,Bed Number 3,66,62,4
2024-12-25,1,Bed Number 1,12,11,1
2024-12-25,2,Bed Number 2,64,4,60
2024-12-25,3,Bed Number 3,84,39,45
2024-12-26,1,Bed Number 1,70,55,15
2024-12-26,2,Bed Number 2,26,5,21
2024-12-26,3,Bed Number 3,37,12,25
2024-12-27,1,Bed Number 1,25,20,5
2024-12-27,2,Bed Number 2,89,56,33
2024-12-27,3,Bed Number 3,82,69,13
2024-12-28,1,Bed Number 1,59,15,44
2024-12-28,2,Bed Number 2,76,20,56
2024-12-28,3,Bed Number 3,71,11,60
2024-12-29,1,Bed Number 1,86,68,18
2024-12-29,2,Bed Number 2,89,47,42
2024-12-29,3,Bed Number 3,98,0,98
2024-12-30,1,Bed Number 1,65,58,7
2024-12-30,2,Bed Number 2,12,1,11
2024-12-30,3,Bed Number 3,56,35,21
